100
100
----------------------------------------------------------------------------------------------------
-  -      -   --  --   -  -          ------            -   - -     --   -    -      -   -----    - -
--   ----   --   -    -  -   - --    -  -   - - - - -  - --    -      - - - - -   -   -       -  - -
-   -          -   - -  - -      -   -     -- - -     - --  --       --  - -- - --- --   - - - - - -
-- - ----    --- -     - --    --  -   --     -   -   -   -    -          --           -        -  -
-- -      ---  - - -       -     -      -     -   -   -- - - -        -         -     - - - -    - -
-- - - --           -  -- - -  ---  ---  ---   -    -   -    -----   --  --- --     -- ----        -
--  -  - ---   -  -    --       --  -  --   -     -- -  --           - - - -   ----  --    - -- -- -
-          -  -    -      -       --  -   -   -     -    - --    -  -    - -- ----   ---   - -   - -
- - - ---     -   ---  -  - -   -     -    - -   -  -  -  -   -      --   -            - - -    -  -
-     -  - - -   -- -      - -    --    - - --   -   -- - - - --  -     --    - - -- -----     -  --
- -    --   - -    - - ----  --- --   -       -          -   -   -  - --- --  - -- - - -    --  -  -
- -  -   -  -      --      -        - -- -   --- - -- -       -- -   -  -  --    -   -  ---        -
-       --- -            -  -     - --  - -     - -    -              -       - -  --  -     -    --
- -  - -       - -   -     -  --   -  - -   - --- -   - --        - -  --         --  - -  -      --
-      -  - -    -   - -  -  -   -  - -  -       -   --    -       -   - --     -         ---   -- -
-   - -    -  ---        -        - -  -  -  - -   --- -   -  -  -      -        - -  -  -         -
-      - -      --  -  -     -  --  - -  --    -       -  -   - -  -  --- - -  -   - -         - - -
- -    - -   -    - -- --  --- -           -  -    --   - -- -    - -   -      - -    -     --- -  -
-    -   --           -   --    --    ----        -    - --        -  -    - -     -  -       -  - -
--          -- - --  -  --  ---      -    -   -      -  -     -  - - -   -            --   -   -   -
-         -      -   --   -  - ---  -    ---  -   - -   -  - -  -- -    ----      -  -  -        - -
-   -  --      - --     - --    -- -    -       -     -- -      -  -  -   - -     -     --     - - -
-    - -    --   -  -     -   - - - --    -   - ---     -  - -   -   -           -  - --   -  - - --
-- --       -  -     -- -  - - -  -    - -  -  -         - -- - --   -  - --  - -     - - - -   - --
-- -    - -   - -- -   --   - -  -   - -- --- -  -     - -        -         -    -  -        --  ---
-  -     -    --  ---    --- - -     -     - - - --     --     - -   - -  -  --  - - - - -      -- -
-   -    - --      -   -         ---   -    --  -   --   - -    -    -     -    - -- -   - -      --
-     -          -   -  -        -    - -     -  -   -   - -   ----   --- -  - -  - ---     -    - -
-         - --  --    - -   --      - --  -- --   -   -  - -  -     - -- -    -  -  - -            -
-  --      -       - --    -    -    -       -        -   --    -  -- -   -- - --      - - - --   --
-      - -  -    -   -- - --    --    - -  -     - - -  -- - -   -    -           --     -     -  --
- -- --    -  - ---   ---  -  - -   -  -   -  ---    -      -      -  --  -  -  - -- --    ---- -  -
- -   - - --   - -      -     - - -        -             --  -  -  -  -       -   - -   -     - -- -
- -   -      - -   -      - -        - -   - - -   -  -     -- - - -   - --- -  - -  --- -  - -   --
--  -  -   - - -     - - -   -     -  -      -- -- -  -      - -     -   - - --                - - -
- ---  - - - -         - --- - -   --   - -   -- -  -- ---- -  -- -    - -   - -  - - -    - -     -
-   - - -   - ---  -   --  -  - -      -  -    -         -  ---  -  -       -       - - -   -   - --
-     -  ---   -     -   -  -- -   -    ----   - -  -     -  -          -   -   -              -   -
--  - -        - -   -      -   -    --- -   -- --      -     -             ---       -  --       --
-      -  ---    - - -     -  - - ---  -   -- --   -      -        --   -    -  --- -      -   -   -
--- - --  -    -       --  ---     -   --    - - ---   -     - - - -- - -  -- -    -  -  - --  -- --
-           --       -    -       --         -  --  -     -  --   - -   -   --           ---       -
-     -  - - --  - --  -  - --    --  --     -  -  -   -   -    --    -       -- --     -  -  --   -
-          --   -    -      -    ----     - - -- -  -       - --    -- -     --  -      - -        -
- -  - - -   -- -     -   - - --  -   - - -   -        --      --    -    ---              - -   - -
-  - -- ---            - -   -     --- -- ---       - -   -   -     -  -     -- - - --   ---     - -
--      -        - - -           - -              - -  -    - --   - - --     -- -  -     -     -  -
--              -  - - -- -   -     - ---- - -  -   -     -               -- -            - - -   --
- -  - -   -- --  -  -   --   - -  - ---    --  -  -  --      --  -----    -     - -          -    -
-   -       -  --  -    -    -     - - -  --    - - -     -  -  - - - -    - -  -  --   - -  --    -
-- -- --   - - -   --  ----  ---           --     -  -  -    -    - - - --      - - -- - - - -  -  -
--      -     --  -     - ---       ---       - -  ---  - -    ---     -       -     -  - - -   - --
-  - -  - -         --  -  -    -  -     --   - -     -  -   -  - -   -     -   -       -- --      -
-    --     -   - -      - - - -           - - -   -        - - -         -  - -  -  - - -   -     -
-   - - - -  - - -- --  -       - -  - -  -      - --  -    -  -   -   -   -- -   --   --     -   --
-  - - -   -      --        -   -   -   ---   - -- -  ---       -       --      - -      -  - -  - -
- -- -  -      - -   --     -   -  -   -- -   -  - ----     -  --  -   -  -- - -   - --   --   --  -
-  -           --              ---  -    --   -       -      -   -  ---  -  ----   -   -  ---     --
-       --   -   -  --   -  -  --- -  - - -   - - -- -  -    -    -   -  -     -   -   - ---     - -
-      --   - - -  ---  -  -   -        - - -  -       ---- -  --    -  - -  -  -    -     -    - --
-  -    - - --              --- --  -     -   - -       -    - - -- -  --  - -  -   -  -        -  -
-    -     -    -   -   -      -       - --  --     - --      -      --  ---   -    -  - -  -- -  --
--            -    - - -    -     - ----   - - ----         - ---  -  -     -   --- -   -       -  -
-  -      --  -  --   --  - -       -      -        --  ---   -  - - - - -   -     --  -  - -      -
---   -  - -        - ---      ---- - - - - - --- -       --   -   -- --  --   -  -   -   - -  -   -
-     - - - -- -  -  --  -   -       -      - -    - -    -   - - -          -- -- -      - -      -
-   -   - --  -         ---- - -   - --      ---   -       - -- --    -        -    -   -    --  ---
-- --    -        - ---      -   -    -- --   --  -  -----    -   -         --  -    -    -  -     -
-  - - -   - -   -- --  - --   -    -   - --    --         - - -        - -   -   -   -  --    --  -
-   - -  -  -   -  - - -  --   --      ---    -    - - - - -  -  -   -  --  -  -  --- --    ---   --
-  - -  -- -        -               --- - -       -    - -         -       -  - -    - - --   ---- -
-    ---   - -  -   --  -  -   -     - ---   --     - -   -             -    --  --   --           -
--   -   -   -            - -      -- --   --       -   - --  -  -  -   -           --- --  -  -  --
---  - -      ----  -- - -     -  ---    --   -    - -  -    -     - - -   - -  - -  -       --    -
-   -   --   -  ---      - -   -      - - - --   - -   -          -  ---   -    -   -- -      -    -
-- -- -    -  -    -      -  -    - -  -- -   -  -   -  - -- --  -         --- -  --  -  -  --     -
- -- -  -  ---    -- -- -  -    - --       -- -  -  -  -        -    - -   - -- --     -     -   ---
--- - -    - -      -   -  -  -   -  - - -   -     -        -  -       - -  - -    - -  -  - -  ----
-   --       -    -      --  -    - --    --  - -    -   --  -    -  --  -    --    - - -  - - --  -
--   -    - -- ---   -   - - -  - -     --  - -   --   -  -  -       - --          -   --      -   -
-    -  -         - -   -  - -            -   -      -     -  -  ----  - -  -     -  - -------   ---
- -     -         --- -   -     - - - - --     -    - -               -        --   - -   --    -  -
- -  --   -       -    -     -       - -         -    -  -  -  -   --  --    ---   -   - -- --     -
-  - -   -   - - --      --  - --  -    -     -   -       --    - -  ---        -   -- -       -   -
--- -        -  -  --    - ---   -   - -   --  -  -       ---  -  - -     -- --- - - - --     - -- -
- - -      -  -     -         -          -   - --   --  -     -- - -      --   -   -  -   -- -- -- -
--    -  -- - - --- --         --   - -  -   -  -         -   ---- - --   -     - -  --   --   -- --
- -        -  - -- -   -        - - - - -       -   -      -     --  - --  -  - -  -    ---        -
--- -  -  -- -     -    -- -    -  -       -     -    -     - -         - -          --    - -  - --
-   - - -- - - - - -  -   -      -     -       --    -- - -       -  -    ---  -           -- -  - -
-       -  --    -  -- -    -  - - -- -  - -  -     - - --  -    -   - -      - ---   -     -   - --
-       - -  -     -   - -    -     - -    - -      -     --  -- --  -   -   --- -      - -        -
-      -  ---  -     - -  -  - -  -   -  -      - - -- --  --     -   -- --    - -    - -  - -     -
- -   -   -   -         - -  - ---  -- - -            -- --    --  --     - - -  - - -    -- --- - -
-   -   -  -- -  -    - -   - -   - ------- --  --       -  -    -  -- - -- -    -   -       -    --
-  -      -  -    --      -- - - -          ----  --  -    -   --    ---       -  -    -     - --  -
---   -  - --    -            - --  - -   - ---       --     -  --       -    ---  --  --   -      -
-   --   -     -   -  -     - -     -            - -   --  --        -  --               -    --   -
----------------------------------------------------------------------------------------------------
