100
100
----------------------------------------------------------------------------------------------------
-   - -          - -    -- -  -        - -   -   -    -         --     -    -   - -   --         - -
- -    - - - -        --    - -   - -- -      - -  -    -   --- - -   -   -      -      --   - -   -
-  ---       -  -       --      -        -  - -         - -      -   - - -  ----  -  -             -
- -     -     - -          -    --   -- - --    --  --- -  -  -      -   -         -    -  -    -  -
-   -  - --   -   ---   -               -- --     - -   --  -  --  ---     --      -- -     -  -  --
- -- - -  -         --    -   -   -  -           - --  -  - ---  -   - -   --      -   -   -  -- - -
-    - -- -   - --  - - - -    - - --    --  -   - -- -   --    -     -  - -     --  --     -   -  -
- -   - --   -        -- - - --       -     --  - -  --  -   --   -   -  -- - -       --     --    -
-   ----    - -   --    -   -        ---  --   -   -- --  --   ----  --- -     -      -  -      - --
-  -    - - - --    -- -  -  -   -      -   -              -  ---   - -    -  - - -        --  -   -
- -  ---                   -    -- -   -   -    -   -    -- - -  -- -- -        -       --         -
-   - - -- -    -  - ----- - -  - -     --   -  -   ----         --   -    -     --  -        -    -
- - - -      - -  -       -        - -   -  --                - -  -   -  -- -       -    - -  - - -
-- - -    --    --    - --  ----  -      -      - - ---     - -- - --       ---- - -        - - - --
- -  ---   -   -   --      -   --  -   -     -   -       - - - --  - -    -     - - -    - - -   - -
- -  -      - - - -        ---        ---  --   - - - --- - - --         -- - - -   - -  -     - - -
-       - --- -      -  -    - -  - -      -- - -- - -     -- -  - -- -       -       -  -    -  ---
---   -  -     ----       --- - - --  - --   -      -     -  -- - -   -        --  - -    -- -   - -
-  -       -    ---     -  -  -        -         -   -  -  ---   -   -       -      - --          --
---        -- -       -- -  -             -   -    -- - -    --   -   -      - - -   -  - ---    - -
-   -         -- -   -  - -      -- -  -  -  - ---    -  - - -      -  --  -  --        -     - -  -
-  - -   - -    -   -   -   -      - -  --- -                    -  ---         -    -   -  -  --  -
- -      -    -   -   -        - -     -  - -  - - ---  -- -       -     ---   --- -     - -- -   --
- -   - -   --      -   - - -    - --   -    -   - -  - -     -               -   - -  - -      -  -
-    -   -  - -  --   - - -    -   -  ---  --    - - - --     -       -  --   ---      - --- --    -
-  -      -             -- - - --  ----  -             --    - - -- -    -- --       -  -  - -     -
- -        - - - -  -  - ---           ---       -       -   - - -  -- -     ---        -  -    -- -
-- -     ---  -       -  -  - --     --      ----        - -       --      -   --   -  ---   --  - -
-- --  -      - -   -  -       - --        -        --- -   -  -   ----  --    - --       - - -  - -
-  -     - --  - -- -   --    -    --     - -----   -    -  -   --            - - -    - - - -  -  -
-    -- - -   -    - -    -       -    -   --      - -   - -     - -- - -   -- -    - - -     -  ---
- -       ---   - --    -    - -    -          ----     -   -     - -           -  -     -- -  -   -
-  -  --   - - -  - -  - -   -  -    - - -- -      -  -   - -    ---             -  - -           --
- -     -   -  ---      - -  --    -  ---       --   -- -    -      -    -    - -- --  -     -     -
-    --   - -     - -     -              --   - - - -          - --- -   -        -    -    -   -  -
- -           -   -  --   --  --   ---      - -         -     -         -  -   --- -     -   - -   -
-   ----   -     --- -     --    -     - -  -  -   -  -    --  --  --        - -   - -  -    - -   -
- -         -  -    -----  -- - - --   - - --   -   -   -- - -    -  - -       - -       --      - -
-   -  -   -  - ---     --   ---    - --  - -  -    - -  -    - -   -      ---- - ------           -
--       - --  -     - -   -     -   - -   - -  -  - -   - --  --    - -     -  - -  -           - -
-      -- - -      -  -- --    -   -  -    - --   -    -   - - -   -     - - - - ---  ---  - - -   -
-         -   ---- ---  -     - - -   - -    --    -  --   - -   -    --  -       - --    -     -  -
-    - -  -   - -  -      -   -   --  - -     -- -       -   -     -   -     -- -  -- - --  -      -
- -  - -    --    -  -     -  - --  -  - ---         -      - -- -  - - -   -    ---       -    ----
--      -     --   -     -        -- -  -    - -   -   -   -   --      -    -- -- - -      - -- -- -
-   - -- --     -    -     -   ---  - -     - ---   -   -   -     -   -  -  - -  - -   -  -  -    --
--   -   -   -   -  - --      --    - - ---          -  - -     -  -   ---   - -- --       -   - - -
-     - - - - -  - - - ---    -  -     - -   - - -     --   -- - -    -  --       ---  -      -    -
-      -      - - ---      - -    -  --    -- -- - - -  -  --        - --- -- -- -  --   --  - -   -
-  -- --   ----   -    ----   - - - -  - ---      -    -          -  -          ---- ---  --   --- -
-  - -    -       -- -  -      - - -  -    - -   - --   -  --  --  - - -- - - - -   -   -  -     - -
- - --       -  -      --- --  - --              - -     --     -- ----  -- -   -     --   -- -    -
--       -  - -  - --         -  -        - -  --    - -   --  -  -     -     - -  --    -   -  -- -
- -  -    --   - -    - -  --  -  -      --   --   - -   -- --  -- --   -   -  -  -      -         -
--  -      -  - - --       --- -  ---  -   -     -     - - --   -   -  - - -        -- --    --    -
-   - -  -- -   - -- - -  -    -        -- -- -   -  -  -  -- -        - -- -  -  -      --- ---   -
-  --  -         -- -- - - --       --       -     -   - --   -   -    -        -   - - -   -  - - -
-   - -   - -   -  -   -   -  -       -       -  -  ---  -  --       -  -   -   -    -   --  -  - --
-         - -     - --  -           -       - --      - -   -  -- -  --  -  -    -   -         -   -
-     -- -  -     - -    - - -  - -  -   -  -   -  --  --       -  - -  -   -   -  - -     --      -
-        -      -   -   --   -      -   -     - - -  --  -  - -- -    -- --  -  --  - - - -     ----
--   -  --    -   ---   -  -   - -- - -  -  -  -  - -  - -       -  -      -- --    -    - -       -
-  -     - -  - -         - -      - - - ----  --  - -       - -   -   -  - -      -    - - ---   --
- ---      -   - -   - -  - -   -             -- -          - -                 -  -  -            -
--- - - --     -     -     -         -  - --     - - - --  -    -   --   -  -  -      -  -     -  --
-    -   -- --  - -   ----     --     - -   - --          -   -- -    -  -    - -   --  --- -  -   -
-  ---  - -   - -----     -    -    -    - -    --      --  - -          ---    - -    -     - --- -
-   ---- - - ---   - --    - -    - - - -   - ----   - - -     -- - - - -            -  -     -  - -
-   ----    -  -    -- - -   - -  ---  - ----  -  -   -  -   -   -   -  -   -- - ---  ---  --   - --
--      -     -     -  -   -- - --  - -  - -  -  -----            --  - --  -- --    --     - -   --
-    -  -     -         -  -       -    -  -     -- - -      - -  -  -   -  - -  --     ----    -  -
--- - -- --         - - - -        -      -   -              - -      - -  - - -- ---     -     -  -
-    -    -  - -   ----  --   - --     -  --       -- -   -      - -- - -       -         - -  - - -
-        - -- - - - -   - - -- --    -  -  -   --  - -  - -- -- - - -- -  -----   -   - -   -  -  --
--      -     -        - -   --   --  -  -- -- -  - --            -- - -    -          - -   -   - -
- - -   -  -    -    - -  --- --       -   -    -- -    --  - -    --    -  --     -  --  --  --   -
-     --  - -        --    - -  -  -    - - -    - -      --      - -  --  -  --  - -           - --
-       -    --            -  -          --        -- -     --    -     - - -  -  -  -- -   - -    -
- -   - -         --            - - - - -     -         --     - -  -       -  - - ---  -  -  -  - -
-   -      - -    -        - --   -  -            -- -----  ---    --   -       -    -- - -   -    -
--- -    ---  - --  -  -  -    - - --- -   -  - -- - -   -      - --    -    -      -  - -   -   - -
-  -     -   - -         -  --    -  -  -  --     --   -       - -      --   - -     - -      -- - -
- - ----  - -         - -      -   -- -   --      -   - - - -    -  - - -     -     -    -    - - --
-    - - --   - - - - -   ---  -        -   - -      -        -        -        -   -    -- -- -  --
-  -        --       ---   - -   - --   - -   -- -    -    -  -  -  -  --     --            - - -  -
-      -    -- - -                      - -   -   -       -       -     - -  --     -  -- -       --
--       - -    -  -      -      --  -- -        - - - -   - --  - -- - - --  --    -    ----- - - -
-  - --  -  -        - -                 -   -       -  -- --  - - -  -  -  --  -   -  -        - --
--- --     --   -  - - - -        -       -                -  -  -- - - - -  -  -- -- -  --     -- -
--   - ---          -  - -     -  - - ---     -   - - - ---    -  - - -  -  - - ---  --   -  --    -
- - -   --    - - -  -   -   - --   -    --   --- -  --   --           ---- -    - -  - --  -  -----
--        -       - --- - - -    -  -   -        -         --- -  -          -   -   -  - - --     -
--  - -- -     -- -    -     --   --      --- -   -   -  --   ----    -    ---     -   - --      - -
-    - -   - - - -     -   -- -     -  -- -     -  -   - -   - - -   - -         -  --         -   -
-   --   - - - ----       --- - -      -  -- --    - -- - -- -  -    - -   -  -  ---      - --- ----
--  - -  --   -    - -   -   - --  --     - -- - -  -      -   -  -    -     -  -    -  - -   -    -
-  -    -  - - -   -   -  - -   -  --                 - -          - -     - -- -    -  -    -  -  -
-   - - -  -----         -   - --    - -     -   - -     -     - -      -      -    -  -      -    -
----------------------------------------------------------------------------------------------------
