100
100
----------------------------------------------------------------------------------------------------
-   -    -  ---   - - -   -      -  ----      -       ---   -    - - -    - -  -  -        - -  -  -
-     - -   -  -        -- -  -  - ----- -- -     ----        -  -  -      -    -    -     -   -   -
-      -      --   - -- -       - -   -    -  ---     -  - -   -- -  - -            --- --- -- - - -
-     - -  - -   -  -      - - -  -  -  -         ---      -  --  -   -  -  -  -       --   -- -   -
- -  -   ---       ---      -    -  -   -- --    - - - -              ---   -  -      -            -
- --- -       -     - - -      - -- -  -  -     --  -   - - ----   -- --   -  - -      -  - --   - -
--  - -    -     - - --   -  -   -    - -  -  -     - -                 ---    ---  -   - - -  --- -
-- -- -         ----   -  - -   -  ----  - --- --- -   -   - -  - -  -    -- --    - -     -  -   --
- - -      - -       -          -  - -    -  -- -    -   --      --  -  --  - - -   -     - -  -   -
- -     -    -  --  ------ -   --  - -      -     -   -  -  -  -    -  - -  -   -  - -   - - --    -
- -  -   - -  -   -  -    -   -   -   -        -- -- -- ---       -- - -                   -  ---- -
-      --- - -    -         -  -   -   - -       - ---       -   -- -     -  -    - -   -   -    - -
- -- -   -  -  --- --- --- - --  -   -    ----       -         -- - --   ---     - -   -  -    -   -
-       -  --  -  -- -  -- - --    -              -       -- - - -          --       --     -     --
-      - -  --      - ---- -  -   --  -  -   -   --  -- -    - - -  - -  - -   --  -- - - - -      -
--   -  -  - - - -  ---           -  -   -     - ---          -  - - -   -         -             - -
--       --  - - -- -  -      -  -- -   -- -    -    - - --  -   - - - --  - -   ---  -   -   - -  -
- ---  -  -  -   -   --- -  --           -  ---- - ---          --- --    -  - -  -   - --    -  - -
-      -  - -   -  -  -  --     -  - -  - --        -   -  ---      --  - -             - ---  -   -
- - --          --     --  --     --  -     --    --   -     -  -   - -      -  -- -  -  -  - -    -
- -   - -       -     -- -     -     -   ---    - -     ---    -   -  - ---  -  - -       -- -     -
-- - -- -       ----    -  -   -- -  - - -    - -- --      -  - ---  -- - -  --     -----    --  - -
-   -    -  --- -   -       -  -       -  -- - -  -  -   -      - - - - --      -- -  -   -  -   - -
--   -  -     --  -     -   ---  - - - - -  -   -- -   --   - - --    --  -  -   -   -  -     --   -
--       - ---       -         - -     --   - -     -   ---     - - -    -      - -  --   ---  --  -
-  -  -  -      - -- --    -   - --          -  ---  -    --   - ---    -  -             -        --
- ----       --     -     -     - -     -- --   -  - --  - -  - - - -   -   -    -     -   - - - - -
-     --           - -  - -   -   -  - -             --- - -   -  - - --  -     - --       --  -   -
-   --     --    -   - - -  - -      --   ----     -- -     -   ---   -  -   -   - -    ---        -
- -    -         --   -    --      -           -        --     -   ---  -      -         - - -   ---
- --  -     -   - - -   -   - -   - -   -   --       -      -  - --     - - -       - - -- -   - - -
-       --- -   -    -    --  --     -- - -----  -  -    --   -       -    -   --   -    -       - -
- -  - -    - -    -             --      -         - --- -     ---   -     -   --  - -  - --   --  -
- - -   -   -     -  ------ -   - -       -    - ----  -      -   -  - -  - -    --     -    --    -
-    -     -  -   - -    -   -    - - -    - -  -      - --     ---  - -    -   -    -  -  - -  -  -
--- -     - -- - -     -- - - - -    -- --      - -     -   -          -    -   - -- - -  -     -  -
-    -  -  -     - --       -     - - -   -            --          - - -    --       - -    --     -
-----    -  - - -    --   -            -             - - -    -       - -  --            -    --   -
-      -   -       --     -       - -   --        -    -       --   -   - -- -- --  - - ---      - -
-- - -   -   -       -   - -        --     -   -   -- - --- --    -      -  -  -    --      --     -
-   -  - -- --- ----       - -  --- -  - - -  - - -        - --      --   -     -    -   - -   - - -
-                   -    --       -  -   -      -   -- ---       -      -    -- -   -    -- --  - --
- -   -   -    - - - - -      -     -    --  - -       ---  - -  -  - -   --    -         -- ---   -
- - -     -    - -   -    -  -  - - -   -   - -- - --  ---  -  - -   - -     --      -   -  --  -  -
--   - - - -  -  -   -   -    - -- -   - -       -    ----- -      -- -      ---   -    -       -  -
-  -    - --   --      - - -- --  - - -            - --  -- -- -  - -- ---   -     --        -     -
-  -- - -   ---  - --  -    - -  - -     ---   -    -           -- -      --    - -  -     -  -    -
-     -  --          ---  - ----  -    -   - -   -- - -  - -  -           - -    -     - - -    -  -
-   - - -  ----  -    -  -        -  -- -    - -   -       -- -  - ----  -      -   --     -  ---  -
---    -  -    -       --- - - - -  -    - --   -     --  -- -              ----  -      - -      --
-- - -   - -     - - --   --- -       -      --    -  -  -   - ----- ---- --     --  -   --        -
-   --  -      -        - -  ---- -- -   -            - -  -    -           -    -- - -  -    --  --
--    --    - -- -- -   -   - --  -- --  -    -     -    -- ---      -    - -   --     -   -     - -
-     -  - -   - - -  -- -  -   -   - -- - ---  --   -        - - --      - -      -    -  -   - - -
- -   - -    -  -  ---              --    --   -   -  -   - -- -         -      --     -     -     -
-  - - --      -  - - - -   -  ----  -      --   -   -   -    - - --  - -     -           -  - -   -
- -  -      -     -- --  ------   -         --  -    -  - - -  -- - -     - -  --- - ---- -    -   -
- - - -  - -    --   - - - - -  - -  -  --      --  -   - -    -            -  -          -- -     -
-    - -  - -  -     - --       -           - -  - --   -- --   --   -      - - -    -- -      -----
- - -- -  -  - -  - -  --  -   - -   -     -    -  -    -  --   --  - --   --   --  -      -- -    -
- -      -  -- -         -  - -       --   -  - -  -    -- - -     ---  - -   ---    - -     -  -- -
-   -      -  --    --  -  --  - -  -  -        -  - --    --    -  -   -  -- -   - - -        -- --
-  -     -  -  - - --   - --   -   - -- -- -  --   -   --   -  -      -  - -   - -  - --     ---   -
--  -    -       -   -  -   - --    - -    - -     -    ---  - - --   -      - -   -      - - - -  -
-   -  ---  -   -   -   ----     -  - -- -       --  - -         -         ---             - -     -
-   - -      ---    -     - --      -   -        -     - -  -    - - -         -  --     - -     - -
-   - --          -   --- - - -   ---    -  -- --     -  -- -   - -     - -- -    - -  - - - --    -
-    -       -   -- -   -  - --- -- -     - - -    - -      - - -       - -   -        --  - - -   -
- ---  - -  ----         ---     -      -  -  -   --     - -     --- - - -    -    --   -- -       -
-     -        - -  --       - -- - -   --  -  -   - -        --      -   -     -  --        - -  --
-  ---   - -  --    --  -                  --    - --   - ---   -     -   -   -       - -  --      -
- -    - --     -            -    -  -- -  -    - -     - -- ----  --   -          -     -   - - - -
- -  -  --    -  -  -- -   -- -     - - - -     --    -     -        ---   -- -  -     ----      - -
- -       -  -    - - -           --    -       -        - - - -  --    --   - - --     -       -  -
- -    -     -   -  - ---   - ---- -   -  - -     -     -  -  - --           - ----      -- -   -  -
- - -       - --  -   - --     -      - - -  - - ---  - -  - --  --  -    -     - -              - -
-  -           -     -      --         -   -       -  - -          --   -    -   -   -   -- - --   -
-  -- - -    -   --    - -    -   -            -         - - -----   -   --     -  --   -    - -   -
- -    -         - --           -- -  -  -    --  ---      -   - -      -  - -          -- - --  ---
- -     - -      -    -   - ---  -    -    -  - - -          - -             -    -   - -- -       -
--    ---  - -    -     --     - -  -   -      --  - - - ---      -   -      -      --  -  - -   - -
-  - -- -  -   -  -      - --- -- --      -     --- - --         -  -   -          -   -  -- -     -
-   -  - -    - -   --     --    -  -  --    -  -  --     -  - --  - - -- -  - - -   -  --  -      -
-   -  - - -- -   -  -   -     - -  - -- - -     -- -   -    -    -   -       - -             --  --
-   - -       -   -        -      -   --               -   -     -  --- - - --   - -  --  -   - -  -
-          -  -   -   -  -   -    -- -   -    -     --  - - - -- - -  -     - - - -  -       - -  --
--- - -- -      - -  --   -----      --    - -   -   -   -  -  -- -  -    --         --- -       - -
-      -   -     -    -    -  - - -  -  -- ---  - - --        -- --   - --   -     -    -- - -  -  -
-   -   - - -                  -   - -    --     - -  -    - - - -  - - -   -           -    --- - -
--    - - --       --     - -    --- -  - -   - -  - -  -  -    - - - - - -  -  - -      -- --  - --
-   --    -    --     -- -- ---         ---   --  -        --  -     - -   -     -  --    - -  -   -
- --           - ---    - -     -    -    - -  - - - --  -       -       -    -   -    - - - --  - -
-      -     -  - ----   -----    --  -        - -  - -          -     -   -  -  - --- - --        -
------          -  --     -    --  -  -  - -        -- - - - -          -    -  -   - --- -  --  - -
--    -    -- - - - -    - - -    -  - ---- -  --   --  -  - - --   --- -  -       -    -          -
- --  - --            -   -   -  --  - -  -- -  -  -  --  ---  - -    -    -       - --  -         -
-- -     --        --      --  --- - -  - -- --   ---   ---   -   -   --        -    - -   ---  -  -
- - -    -- --    -    - -   -          -       - -   -         -       -     -- -- -    -         -
----------------------------------------------------------------------------------------------------
