100
100
----------------------------------------------------------------------------------------------------
-  -  -- -    -          - --    -- -        -- - -    --  - -     -  --  -           -   -   --   -
- - --- -      ------ -       --   ---             -  -   - --       -   -          ---  -   -  ----
-- -   - -    -  --- - ---  ---         -    --       - - - - -     - --    - - --      -  -      --
-          - ---   -    - --  --    - -             - - -    -   - - -    -  -            -    -   -
- - --     -    -         -     -        --- ---     -   -     - -- - ---   -- -  - -        -- -  -
- - -  -     --- --    --     -         -      - --    --          -  -    --        --            -
- --       -  - -  - -     - - -  --   ---        - -- -    -  -- -  --     -   --     -  -- -   ---
- - -     -      --       --  - --   -  -     -   - -    - -     -       -    -           -  -  -- -
--      - -      -- -       -  -    - -    -      -  - -   -      -- -  -- -  -  -     ---  -      -
-- --       -   --    - ---     - -   - -    - --   - -             - ---           --- -- -  ---  -
-    --       -     -  -  - --    -   -    - -  -      - - --  - - -  -   -  -   -  - --- -    -   -
-   -    --        --      - -     - -     -  --      -        - -  --     -   ---       -   -     -
-     - -  -    --  - --   -  -     --     -  - -   ---   -  - - - -     --- - -    ---    -   --- -
---       -  -      --- - -   - -      -- - --  -   -          - -   -  -   - --   -      - - --   -
-   -     - ---- - - -         -  - - - - - -               -  - ---     ---     -   - -- -    -   -
-   - --      -        -  -       -    -  - -- -      -  --         - --     -    --       ----- - -
- - --     - - --- -     - --  -  --- --       -         -- - ---         -- - -  ------ - --      -
-  --   ----       - - - --  -  - --     - -     ---   --  -   -    -  -- -  -  -  -  -- - -  --- --
-    ------  --    -     -  --        -               -  - -   --  - -   -   -- -- - -- -    - --  -
-  -  -     -    --        - -     -        - -  -  -- -                  --   --   -  -- --  -- - -
- -  - --   --    - -- - -         -- ---   -     -- -- - -  -       -   -   -   -    --    -   -  -
-      -     -     - - -   ---   -  - -     --  - -     -      --  -   -   -  -  -     -     --    -
-   -      -  -  - -        - --      ---  -      -   -  -   -----  -  - - -     --    --   --  -- -
- - -  -  -- -  ---  -     -  -   - -    ---- ---      - -  -    -  - - -    --  --   -    -- -    -
- -- -  --     -      --  - ----  -  -  -  -   -       -     - -     -    --      -     -          -
-- - -- --      -   -   ----   - -  -  - -    - -  -   --  -  --      -    -  -    - - -   ---     -
-  - -  -    -    -- - -       - ---    - -   - -            -  -    - - -  - - --   ---   -      --
- - - ----        -   -  -  -  - - -  -  --  --        ---  -   - - -- -  -                 - - -  -
-   -     - --  -  - -- --   --             -         --   -- - ---   -    -   --  -      -       --
---- ----- -   --- -   -    -- --    -   ---  -     --     - - -    -- -     ----    ---   --      -
-    --   - ---   -     - - - -   -    --          -   - ---   - - - -   - -     --     -       - --
--  -  --  - --  -  - --- - - ---  - -- -          - -   -  - -  -     - --                 - -  - -
-   --      --   -              - --   - --    -   - --   - - -   ---           -----  --  - - -   -
-- -    --   -    -   -     -   -- - - - -       - -  - -        - -  -      -           -   -  ----
-      - --       -     -- -  --  -  - ---  -   - -   -      --          - - -  -   -      --- -   -
-    -  ---  -- -        - -   --   --        --  - - -         - - ----   - - -     -   --        -
-   -- -   --  -  - -   -   --   -    -      - -  -    -    - -   -    ------    -     - - - -  - --
-      --      -  -   -             - - -- -           -    --  -   -   - -  -   -      - - - - -- -
-    - -   ---    -     -- --   -  -       -               - --  - -   --       -  -    -     --   -
-   -  --        -   - -  -           - -  ---- - ---  --- -- - -  --        -  ---   - - --- -    -
-  -  -     --          -       -        --     - -  - - - --- - -   -  -    -  - --- -       -- ---
- - --  -    ----   --         -   -- --   -       --    -     -     --- - - -    -    - -         -
-      - -  -  - -   -  -   ---  ----    -     -   -        -  -   -            -  -  -  -    - -  -
-      -   -- ---       -  -         -            - -   -     - - - -   --   - -  -- - -  -    -   -
-        -   - -       - - --     ---   --- -  -   -  -- -- -    - - -  - ---    -     - - -   - - -
- - -    -    --      -  -        ---         - - - - -    -- - -      - ----        -  -   --  -- -
-   -  - - -     -- ---  - - --  -    --  ---     --           -            -     -    -    -- -   -
- -- -  -  -       -  - -- -      -   -   --  -   - - -   -     -  -      --  -     -- -   -   -   -
-- --   -     --          --  - -  ---  - ---  -   -- --    - -- -- ------     -       -   --  -   -
-     --   -   -        ---    - -      -   -- -     -  -     -  - -   -- -      - - -   --    -   -
-   -- -   - -  - -   - -   - - -  --  - ---         - -- - -    - -   - - -     -- - -     - -- - -
- -- -    -  - -   - -    -  -   -  -    -    --     --  -        -  - -- -     - -    -  -- -   - -
--     -   -          -    -   - -  - - -   ---                   - -   --   --  --     -     --   -
-   -- --    -  - --          -  - -      -    --  -  -  - - --      ----   -    - -  ---   -  - - -
--  -     - -  --     -       -- -   ----   - -- -       - -    --            -   -     -- -     ---
----- -  --   --  -  -  -   --  -   - -    ---        -  -   - -    -      - - - -     -    --     -
--    --  - --    -       -    - -   -  - --         - -- --    - - --    -- -    --    --         -
- ---    --    -    -   - -  ---       - - -  ---  ---  - -       -  ---              -      -     -
--        - - -    - - -  ---   - - -   - -  -   --   --      -     -   -  --- - ---- ---   - -    -
-       - -             --   --      -  -  --- - -- --   --- - -       - --  - - - - -   --  -  -  -
- -     -        --  -     --  -   -  --   -    -      -   - - -   -    -  - --   -      - -   -  --
-     - - --      - -     -  -- - - -    -       - - -    -     - -  - ---  -  - -       -    -  - -
--   --  -          -- -- -   -   -  -  --  -   -  -        - - - ---  - -     -        --    -    -
-        -  --   -- -   -       - -- - - -  -   -     --      -- --     -- --  -  - --    - - -  - -
-- -  -  --     - -     -        - -- --    -        -     -   --    -         -        -  -    -  -
-  --         - -         - --   -   -  -  -  -- - -   -   -  -     ---      -  -    - - -    -    -
-      -         - -        -   -     --    -   -          - -- --   -  - -- --   -   --- --   --  -
-   -   - ----      - - -  - - -  - -  -- --- -  -   -   --      - --      ------ -- -  - - -  -  --
- - - -       -  -   -     -  -   -  --         -   -   -- --     - - -  -           --      -     -
- --     -  - - - -- -- -    - --  --     -  -   -  -    -   -- - -     -   ---   - --      -      -
-   - - - - -  -   -     -     ---   ---      -    - -   -  -    -   -     -      -     - - -    - -
-    - -   -- --             -     -  -  ----       -     -  -      - -  -- -    -  - - -      -   -
-  -      - -   -  -   --- -   - -   -  - -   --   - - --    -  --     --      - -   -    -  -  -  -
- -  - -  -    --   -  -  -  - -----      -  -       -     --       -   - -- --  - -   -  -        -
-  --   - --  --     -      -          -    - -  - -        - -       -   -- --   -   -       -    -
--   --         -  - --    -    -    -  --   -     -  -  ----- - - -  -     -      -  -- -    -- - -
-  --  -- -  -    -      -  - - ----  -       ---   -   -  -        --  -      - -  -       -      -
-   - -        -    - ---     -  -    -   -        --     -   - -  -         -  -- -  -       -    -
-     -  -   -       -  - -- -   --  --         --- - -           --   -      --  -  - - -    -- - -
-   -  -   - --  -    -- - -   -   -  --  -      -      - -     -- ---  - -- -   --   - ----   -   -
- - - -  -  -  -- -    - - -  -  - - -   -   --  - - - --  -- -     -        --- - --  --     -  ---
-- - -   -  ---   -  -    -  --- -    --  -    --- -      - - -  - - - -   --   - - ---    -  -    -
-- - - - - --   - -    -- - - --    - ---  -  -   - -     -     - -     --  --  -----   -          -
-   -   -  -    --         -     --   -   -        - --  -- -   - -   -    -  -- -   -- -      --- -
-   - --   -  -    - -     -  -      - -   - -        -- -  -     -   -  -   --  -- -              -
-   --  -  -- -  --         - -     -    --   --  --  -          -  -  -   -        -- -- - - --- --
-        --    -     -- -  --       -- --  -  ---   --      -    - -       -  ---   -      -  -    -
- -     -   -- ---          -            -             --    -- -    -  -    -     - -  -  --  -   -
---             -  - ---  -- -            -     -  -         -   - -         --     --- - -   - -- -
-  -    -  -             -   - -- -  -  --       -  - - - - - -    -       -    - -  -         --  -
--   --      --     - --   - - -   - -   - -   -          -  -- -  -          - -   -  -        - --
-      --     - ------     -          -- - -  -- -  - - --    -      - -     -  ----   - -- - - -- -
-  - --     -    -     -     -- -  - --      -  -   - -   -    - -       --        - - --   - -  - -
--     -   -  -     -     - -  -     -   -   --     -  --    -     -    -   -  - --- -   ----   -  -
-    --     -  -  -        - --  -         -    -  - -     ---  -    -- - -       --      -     - --
-    -  -  -- - - -   ---  -        -- - - -- -  -     -  -  --  --- --    ---  -       -  - - - - -
-  -    -     -  -     - - - ------       -- -      -   -  --     -- -            - -     - - - -  -
-       -- -    - -     -   -        - - -  -    -    -  --          - - - -          -      - -   -
----------------------------------------------------------------------------------------------------
