100
100
----------------------------------------------------------------------------------------------------
-   -  -- --          - -- -         --        - -  -   - -  --       --  ---   -      -           -
- -  --  --    --  --  -  --   - --     --    -  -   --- ---    -  -- -  - - --   --   --  ---- - --
--   - --  -- -     -   -   -     - ---    - --    -    --  - -        -   -  -   -           -    -
-     - -- ---        - -      -   ---   -          --        - - -   - ---     - -  -  - -   - -- -
-   -   -          -     ----      -  --   --   --   -  -   - --    -         --   --          --  -
-  -     -  -  - - --           ---  - -      - -- -  - -   --- -    -    - -   -  -  -     - -    -
- -   -    -     ---    -      -     - --- -  --  -   - --   -  -       -  -   -     -  - -  -    --
--- -     -  --- -   --- -  -   -  - --  -  -   --            -         -  -  -    -  -   -  -  -  -
-- - -   - -  -    -  -- --- --     -  --   -   -  --- -     -  -- -      -   -  --   - -     -   --
-- -  -    -   --  - - -    -- --   --- - -    -  --   -      -  -     --   -   -  -   -    ---  - -
-    --      -   - - -    -    - --  --   -      -    -  -     - - -  -   --     --   -        - - -
-  -  - ----  --   -- --      -   -  - -      ---- -   - - - -   - -    -  --     -       - -- -  --
-  --- -  -       - -               --   -  - -        - - - - -     - -     -- -      -   --      -
--    - ----   --    -  - -- --  -    -- -       --     -  - -   - --  -  --- -  -- -  --   -- -- --
-  --- -  -     - -- --  -  ---   -  -    - - -  -       - --    -       -   -          -  -- --   -
--         --    -           -  -  --  --  -       -  -      -  - --   -     -     --            - -
- -  -   -- -   --   -      - - - -      - -  -  -- - -  -            -  -        -- -- - - -    - -
-        -    - - -   -       - -   -   -- --      - -          -     -   -  -   -  -  --      --- -
--       - --           -     - -   --- -  --- -    - - - ----   -- -      -- -- -   -- -     -  - -
-  -- - -   -- -   -      -   - - -   -- - -   -  --  -         -   - --- -   - -       -  -  - - --
--    --- -- --   --    - -    -    -          - -    -   --      -   -- -        -    -    -      -
--  -  -- - -       ---  -  ---   -   -- -   - -    -  -   - ----   --     --- -     -         -- --
-  - --  - - -- --        --   --        - -     -- ---  -      -- -         - -          - --     -
--  - - -  -  -      -  -    -         - -      -     -     -   -  -  - -  -    -    --  ---    - --
--   -- -  -  - -  - -- -     -   ---  --         - -   --     -        --  - -         -          -
-     -  - -    - - -    - --   --       --    -- --                 -    -- -        -   -  -     -
-  -- --    -  -- - ----       -    --- -    -    -- -- --   - --- -   --   -      -     - - -- - --
-    - -      -  -    - -     -           -- -     -    -  - -  -            -  ----- -- ---  -   --
-        - -   -  - -       -  -  - --    -- -  -      -  - --      - -  -  -                 - -  -
- - -  - - --- - -   - - -   - -      --  --   -- - -  -       -    -- -   -      - -     --  - -  -
-   -- -      -  -------- -     -   -   -      -      - -   --     -      - ---  --  -             -
- - -   -  -  -   -      -    - - -  ---     -  - -     -  -  -     -   --           --    -    -  -
--  -   -   --     -        -           --    -       -  -    - -  -     -  - -  -           --    -
-      - --     -       -  --  --  - - -   - - -   -     -- -      --- -   --         - - --- ---  -
-                - ---   -  -     -   -  - - - -  -  -   -  - -  - -  -- -  -          -       -   -
-   -        -  ---    --  -- --- -- ---   -     - - - ----              - - - - -   -   - --      -
-     -  ----   -   --  - --- -  -- -- -  -    -    - -   ---- -      -     -    - - - -- -    --- -
---      - - ---  -    ------   -     - -   --      --         --- - -  - - - -    ----     -- --  -
-    -  - --     - -    -      -  - -  ----   -- - - -  --     -  -- -    -  ---  --  ------ --  - -
-  - -             -  -  ----  - ---  - -           - ----  -   --  -   - ---     - --   --        -
-  - - -   - -    -    -- --    - -   -  -       - -    - --  --      - --     --- - - --    ----  -
- -  -    -  - -- -  -- -    - -- -  -  -   --   - -  - -      -  -      -   -      - -  -         -
- - -    -  - ---      -   --   -            - - -      --   -       -  ---   - ---  ---  -  -    --
-  -  -  -   -     - -   -    --   -  -  --  - -        -      --- -         -    - -   -- -   - - -
--   -       -    -  -- -  -- -    -  -     - --  - --   -           -- - --     --  ----      --  -
-   --   - --               - --   - --        -                             -   -             --- -
---     -   --  --- ---  -  -    - --     - --       - -              -        - --  --      --   --
- - - -   -      -            - -  - -- -    -- -- -     -          -   -   --   --      - -    -- -
- - -   -    -- -   ----   -  - - -  -  - --  - -   - --   - -     - --   -   --      -   -   - -  -
-   --   --       -   -   -   - -    -   -    - -       -  -          -- --     -  -  --  - -  -   -
-  - -       -  -  -  -  -   -  -     -- -  - - -  - -     -     - - -  - --    -   -   - -  -     -
--- -- -- - - -  -- -- - -    --       -  -  - - -      -    -     -  -  -      -      -- - ---    -
- - --- - - -   - - -     -    -              - -  ---  -         - -   -  - -   -  -     --  -   --
-  -              - - - --  ---        - -  -  -       - -- --          -  --   -  -  - -   -   -  -
-     -       - - -    -   --            -      -     - - -- -     - - -  -  --  ---   - -   --   --
- -             --   -    -    - - -- -  -    --- --    - -   --  -    --- --   - - ---  -   - --  -
-   - -    -   -               -   - -  -         -    - - -    - -   - -    -     -    - - - -   --
-     - --- -  -   -  -    -- - -- - - - -  --- -     - -       -  -   -    -      - --- -    -  - -
-     -        ---     -     -       ---- -- -    -   --           - - -  -   ---  ---- -   -      -
-      -   -     - -  -         - -   -  - - -- --    -- --    -   -         -      -    -        --
-   --       --        - --         -        -- -  -  --       -     - -  - ---   --  - -- - --   --
- --     -              -   --   -- -- - -   -   -- -  -  -  --      -- -      -   --  -  -    -- --
- - -  -      - -       --       -  -   --- -  --   -   -  - -  -          - -       ---   -     - -
- --      --      -    ----   -     -     -  -  - - -   --    -   -  -            -       -        -
-     -- -    -      -       -   -   -  -     -     -     - --       -  -   --- --      - --   - - -
-  -    -- - -  -       -    -        -     --  --      -   - -     --     -- -   -          - -   -
-          -   --  --         - --- - - --    -    - --   - -    - -  -   - -  -    - -    -  --   -
- - ---  -   --   -   --  - -- -    -- -- - - --  - ---   -- -  -- - -   -    -  - -   - -  -      -
-  -    -   ---   - --  - - --   - -                     -  -     - -  - - - - -- --  --- - ---    -
- - ---   --      --- - - -- - -- --           --- -           -           -           - -        --
-    -      - --  -   -  - --- -  -      - - - - -     ---  -   -    -  - --  -    --     - - -- - -
- -  -   - --   -   - -  --  - --  -      -     -   -     -     --         -  - -    --        --- -
- - - -        -   -    -- ---  - -  - - -    -- --   - -  -  -   -   - ---            - - -     - -
- -      --   -  ----      -   -  -    -  -  -        -   -  -  - -     -  -  -- --  - -      -    -
-   - - -   -   -   - -  -  -   -              - -- -     - --           -- -     - - ---     -  - -
-  -  -   -  --- - -- -      - -    ---     -      -        - - - -   -- - - -  - -   --- - --  - --
-    - - -- - -    -- -  - - --    -  -    --- - -- -    --    -- - -  - - --  -    -   - -    -   -
-    --     --  -- - ---    -   - - --- ---   -  -   - - -   - - - -      -          --     -    ---
-  -       --     -    - --    ---- -  -   - - -     -   - -       - -    - -   -  -      --       -
-   ---      --  - -   --   --  -    -- -     -- --      --  - -  - - -    - --- -           -     -
---- -   - -    -  -   -  -   -  -      -  ---    - -   -- - --- -- -- ---           -  -    - --  -
- - - -  --   -           - -  -     -- -      -    -       - -  -     --  --      -   -  -       --
--         -   - - -      -         -- --       -   -    - -    -      - - -- -   - -  -   -    -- -
- --     -       -   -  -  -- -- -    - -    -- -     -   ---   -  -    -  - - -     -  - - -  --- -
- -- - -  -   --     - -     - -    --- -   -   --   -  -  -   -     - - - -   -        ---- -    --
-    -     -    -        -   -     -       - --   -   -     -  - - -     - -   - ----  -   - --    -
--   -       - ----    - - - - -    -  --- -       - -        -   -     -     - --       -- -      -
-          -  -  -- - --        --      - - -- -  - - - ---    -- -- --  --              -  -- --  -
-  -     --     -   -       --  - --        -  -    - --   -        - --     -    -    -   -   -   -
-    - -    -  -  --  - --   -    - --    -  -        ---  - - - ---      - - -     --     -       -
- -     -      -         - -   -  -  ---- - -      - -    - - -  --        - -    --  -          - -
--   -   -  -     --   -- - -      -- -       -       -     - -   ----  --    -   -     --- - -    -
-     -   --- -     - - -  --  - -  - - -  - --  - ---           - -        - -   -              - -
- -  -   -       - ---    - -        - -- ---   - -    -   -     --   -                 - -- -    --
- - -- --  ----          -   - -   -    -  - -         -  -     - - -      ---         --- - -   - -
-    - -- -    - - -   -   - -           - - -  - -    - -  -   -  - --   -          --   -   -    -
--          -       -          - --  -      -  - - -   -   -          -- -   -   -     -   -       -
- -  -   ---  -   --- --  ---              -     -  -  -    - -        -        - --   -         - -
----------------------------------------------------------------------------------------------------
