100
100
----------------------------------------------------------------------------------------------------
- -  -   -    --    -            -  - -    -        - -   --     - -  -   - -         --     -   - -
-   -  -    --   ---  --  - -  -- --     -  -   - -         -     -      -  ----   --   -  -  -   --
--    -  --   ----        --   - -  - - --     ---    --  - - - - --        -  -    - -       -   --
- -  -     -           -- --  -- -  -    -  --     --  -   - -  - - -   -    --    -    -    - --  -
-   -  -  -     ---       - -    -   -  -      --  -    -- -   --   - - -  --  -    -     -    --- -
-         -  -- -  -    - --       -  - -     -    --       - -  --   -       -  - -    - --       -
--  -  --       -- -   -   - -   -   -  -   --       -  -           --    - - - -   -    -  -  - - -
-          - --   -  -        ---   - -  -  -   - - -- -  -  - -- -     -   --    -    -   - - -   -
- --- -       -  -    -  --   -  -   -- ---  - - -   - -    -   -  -   - -   - -  -    -  -  --    -
- -  -   -      -         --   - -   -      -- -  - -   -        --  -  -  -  -    -         - -  --
-   -   - -   --         --   - - ---  - - -- - -   -      - -       -   -     ---       -   -   - -
- -    --        ---  -    -  -- - - -       --  - --- ---    -   ----      - -         - -- -    --
- -- --       --  - -   - -     - -  -  --        -  - - -    -     -  -- -    - -    -        - - -
-  -   - - - -  --  - --- - - -   --   --    - - -         - -   ---  -       -    -       - -  -  -
-   -     -     - - -  - -    ---   -      -        --   -  -   ------ - --   -      -   --   --- --
- -   -          - --      --      -   - --  --      - -       -    - -    - ---- ---        -   - -
- --     -           -   -- - -   -  -   -      -           -  - --    -    -     -    --  -  -    -
-- -   -- -- -  ----   -   --  - - ---  - -   -       -      -     --      - -        - -       ----
-                -  --      -    - -      -  --- ---   -  -           -  - -     - -      -  -   - -
- -    --     -   -    -   -   - -  -  -     -       --    -   -    -      -     -    - - --     - -
- - -  - -    -- -  --  --    -    -- -  -      - --   -   - -       --  -  -  - - -  -      -  - --
-  -    - -   -  - - - -  -    ---- -    ------        --- -  - -   ---      - -      -- --        -
----   -  - --     -- -   - --     - -    -  -  -     -        ----  - --  -   - --       --  -   --
- -  -      --     - -  -       -   ---     - -  -     -    -  -   - -    - -  - - - -   -- -      -
-         -    - --  -      - --        -         --  -  --   - -- -    --   -- -       --  -     --
--  -   - -    - -    - - - - -    -   - - -       -         -  --- - -  --   - --    --     - -   -
-   - - -     --            ---          - - - - -- --     -   -    -    - -   - --    - - -     ---
- -     -    -           - -             - -    - -- - - -  -     -    -     -       - -     ----  -
- --      -     - -    - -  ---       -    - ---   --    -  -  ---      -      --   - - -   --   - -
-          -  - - - -     --     ---- -- --- - - --  - - -  - - -   - -     -      -  -        -  --
- -   - - -   - - --   --  --    --  -        -    -     -        --     - --  --  - -   - - -- -- -
- --   -    -  -  - ---  -- -      - -   - -   -    -    -    -  -   --  -   -  -   -- --   ---    -
-   -   --- --    -  -    -      --   -      --- --    -    --        --  -      --  ---  -  -   - -
- -- -   --     -  --     -   --  ---  ---- -     - - ----  - -- --- -        -    --       --     -
-     --    --  --         - -    -         -- -- -  -   - - -  -              - ---    -     - -  -
-   -- --   -     - -        -     -  -- -     --    -    -   -- -           -  --        -   -  - -
-  - -    -  --    - - --- -- -   -- --   -  -  -  --- - -   -  - -   -            --   -  ---     -
--    -  -  -   - -           - -    - --  -  --       -   - -    --     --      -  -  -           -
-  -      - - - -  - -- -  -      - -  --- - -    - -   -  -   --- -- -       - -      -- -- - --  -
--  -   --     -  --  - ---   --      -  -     -       -              -  ---             -- - - -  -
-  -       -    --         ---    --        -- - - - -- -   -  -   --    -            -  -   - - ---
- -       --    -      - -    -  --  ---         -            --      --      - --     -      -- - -
-- ------    -    - -       --  -  -    - - --      --  -             -      -  -      -        -- -
-  --      ---  -  -  -     -    -   - -- -- -  -        --   -    -   - - ---   -      -    --    -
-     -- -   -      -     -    -   -- -- - -         -  -              -     - -   -     -     -   -
-     -   -   -          - --    - -- -- -  -   --- -  -- - --  - -  -       - --   -  -    -  --- -
-     -      -- -  -   - -- -        -  - --  - - ---- -  --     -  -  - --      -   --    --   -  -
- -       -- -  -  - -      -     - --  --    -     -        - -   -  -      -  - --          - -  -
-  -- -    - - ---     -- - - - -        - --  -  -     -   -   --  -    -    -  -   - -    -  --  -
----   -  --           - -  -  -   -             - -    -    --   - -            ---     -  -      -
-   -   --     -   -- - -   -   -     --- --   --   -- -            --- - - - -   -- -         --- -
---  -  - ----      -    -      -   -             -  -  --   -        -    -     - - -      -      -
--    -   --     -    --      - --  --    -    -- -  -  -      -  ---  -  - -  - -       -    -    -
-  --        -  - -       --  -   - - ---    -      -- -   -   -      -     - ---  -       - --- - -
- -  -  - --  --- --  -       -     --  -   -   - -     -  - -     - - ---       ---  - -   -   -  -
-  -  -    --   -   -      -- -      -   -   -      -           --- ---      - -   -- -- -   - --- -
-     -   -  - -        -- -    - -  - --  -- -  - -    --- -   -  -       - -   -    -  - - -  - --
--     ----   --  -----  -       - --- - -       - -  - -   -     -- -- -    ---    -  -     --  - -
--  - -           - -  -    -- -- -  - - - -       -  - ---  - -   -  - -   -    -       --  - - ---
- - - -  - -  -- - -   -             -   - --- - -         - - - -  ---    -  - -  --- -  ---      -
-  ---   -    --    --   -- - -- - --       - -      - -- -  --    -- - -    -- -- - --  -    -  - -
--  - ---  - - -- -   --- -    -  -- -  --     -  ----  ---- - ---  - -    --    -    -    - - -- --
-    -       ---     -  --  --   - - -     -       - -  ----   -    --         -- -   --  -   -   --
-  -       - -  -   -  - -   - -- -    -     -  -     - --- -  - --  -   ---     --   -    ---   - -
-    - -   - - -  - - --  --        -   -   -   -   -- -- --  ---- - - -    -    ---    -   --     -
-       - -- -    - -- --- - -  -  - --          -           -   - -  - -    -  --   -       -   - -
--  --      - ---     -       -    -      -  --    ---     --  -- --  -   -- - -     -     -   -  --
-  - -----  -         -- --  -     -    -  -         -                -- -   - -         --      - -
-- --   -   -  ---   - --  --    -    --- - -    -  -    - - -- -   -   - --      --  --    -  -  --
- -  - - -         -     ----      --          -  -- -   - -  -   --- -  -   -  -   -     -  --    -
-    - -   -   -    -  -        - -       -  -        - -        -  - --         - -     - --  - - -
-  - --      -- ---     -  -      --       --- - -- --  --   -  - --    --   -   - -   -- --     ---
-  -    -- -  -  -    ---    ----  -     --  -- -        - --         -   -- -  -    -   -   -     -
--  -           -  -  -  -      - - -       -    --         ---- - -    -       -  - - -        -- -
- -- - -  - -       - --     -       - -  ---  -    -      -  --    --- --  -   -      ---    -    -
-        -     -- - - -  -    -  -      - -  -         -- -  -    -       -   -  -  -     - - -   --
-  - - -      -       -  -   -   -   - - -      - - --- - ---    - - -- - -    ---     - --     -  -
- --- --      - -  - -   -  --       -  -- -- -- -  -  --  -      --  -  -   -       - -   - --   --
-  --  --  -- --      --                  --  - -  -  -     ---- -    -    -    -   --  --  -  -   -
- - -         -  -    - --     - - -- - -- -  --   ----   -     ---       -           -  - -     - -
-       - - - ---    - - -     -  - - - -        - -  -     -- --   -   - - --       ----     - -  -
-   -  - - - - -  -  -  - -    -    - - --- -- - -    -     - -  -     -          -  -       -- - --
--  -   -        -- -    -  -  -            -     ---  -  --       -       -    --     - -   -     -
- -      -     - --   --      - -  --    - - -  -     -       -    -    -   --          -      - - -
-            -  -     --   - - - -                -   ---   -  - -  --- - -   -       -     --     -
- -  --        -    - - --    -- - -   ---   - --  - -        -  -     - -- - -     ---       - - --
-- -       --- -  --  -     -   - -   -- - - -      ---   -- --     -    -   - -   --  -       --  -
- --        - - -   -    -- ----  --    -            - -    -   - -        - - -        - - -   - --
-  -   -- -  -  - ---    - -   --        -       -  -        -   -    --- - -   -        -    --   -
--    - - - -  -- --    -  -   -   -     -- -        - ---   -      --    -    -  --- -    - - - - -
--  - --     -  -  - ---          -    - -  - -  - --      -  -- --            - - -      - -    - -
- -   - -     -- --     -  -     -     -    --      - --- -  - -  --- -      --    -   -    -  -   -
-   -  -  - -             - -     -  --     -   -       -  --    --   -  - -   ---  -      -    - --
-       --  -    -   --- --   -- -- - --    --      ---      --   ---  --  - --       - -        - -
-  -     - -   --   --       -   -  --  -  -    -     -     - -----      --    --- - -  ---      - -
- -  -- -- ---  - - - --  -         -- -  -        ---- -  -    -   - -   -       -         -- -  --
- -- --   -     --             ---     -         -          --   ---    - -      --   ---- -       -
-  -    -   -    -     --        --  -  -  -       -      --                -      - - -     --  - -
----------------------------------------------------------------------------------------------------
