100
100
----------------------------------------------------------------------------------------------------
-     -   -   -        --   --      ---  -   -   - --             --   - - -   -  --   - -- -      -
------ -    -  -  - -      -     --    - - - -          -- - --   -    -   -   --      - -  - - -- -
-   - - -           -  - --     --      - -    - -  - - -                        ----   -   -- - - -
-       -  ----  -     - -     - -  -- -  -   - --   - -     --  -  - -  - -- - -- - --- --        -
-  -      --   -     -   -        -      -            -     -  - -  - --     -   -  --  ---- -     -
--- - -  - --       - --  -   -- ----   -  - - - -  --  - -    -      - --  -         -     - - -  -
--  - -- -     -     - -  -           - --  --     --      -    -  --    - -     -   - -  -   -   --
-   -- -  - -     --          -       --  -- -  -- -  -  --   -  - -  -  -     -- - - - - -      ---
-  --    -         -  -  -      -     - -   - -    --        -  - -    -  --        ---   -        -
- -    -  -     -  - -  -      -    -     -- -  -    - ---     -- -    -     -         - -   - --- -
-  -  --    -- -- -  ---   -  - - - ---   -  --      -      --   -   -   -   --    -- -          - -
-   ---   -  -  --  --  -   -  -       -   -    --   -  -- - -        - -- -      -       - -      -
-  -   -      -     - - -     -  - - -- -- ---     --- -   --    --  - -    -   - -   - - ---  -   -
- - ---  - -     -- -     - -          -  --  -- -  -   -   - - - - --  -        --    -    - -  - -
-  -     -  -  - -   --  -         -       --    -   -   --     -  - --  -  --   -  -- -  -       --
--  --            -- --    -- -  --  - -    -   -    --   -         -- -     -  -    - - -     - - -
- - -- - -   --     -     -              - ---           - -  -  -    - --  -  - --    -  -- -   - -
-   -- -   --   - -   - --  -    --  - -               -- - --  - --  -    -  -  -       - - -     -
---      - ----      -    -   - -  -     -     -   --  -    --- -   -       ----  - -        -- -  -
-   - -       ---  -   -   -                - ---   - -   - - -       -     -      - - - --   -    -
-      ---       - -- -     - -  --     -          -       -          -  -     - -  - -  -  -- --  -
-  - -        ---  -     -      - --  -    --- --    - -      -   -   -     - -    - - -  -  - --  -
-    -  ------   -  -  -  - --  -  - - ---  -         -        -- -  -    --  -    - -       --  - -
--    -    - -   - -  - - -      -    -    - -    -- -    -   --   -       -- -- -  -   -- - -  -  -
--   - - - -  --  -          --        --  --     - --  ---    --  -- -  --   -  --   - -     --  --
-  -         --           - -  --     -   -- -  --          ---          -            -  --        -
- - -    --   - -  -   --   -     -  -      -- --   --  -  -        - -    - --  --   -      ---  --
-   - --  -- - - -    -   -   -    - -- -     -  -   -     -- -    -  -- -   -  -    -  - - -      -
-  -    -  - - -   - --  - --- -       -    --     -  -     -- -    - - - -      -      -   -      -
-   -       -    -    - -      - - -     --- -     -    --   -  - -       ------ -     -    -     --
--     -    - -- - - - -     -  --    - -     -- -- - -    -  -    ---    --  -  -- -    -- -  - - -
-      - --   --   - -   --      -        - -          --  -  --  -   --    --         -   -    -  -
---      -   - - ----   - -               -  -  - - --  -    -   - ---  --   - ----  - --- -     ---
- -   --      -     -   -     ---- - --  - - - -    -   -      -  ---     - --  -    -   - - -     -
-  -    --     -  - - -       -      -  -    -         -    -- -  --  -   -  -   ---   -  -        -
- -   -  --   --- - -       -  --   --  --    -       -  -      --  -     --  -     -       -  --  -
-   - - -  -- -     -  - --   -         - -    -       --    -- - --    --       - -     - -- -   --
- -   -  - -   - --   - -    -  -- --  - -   --    --- -  -   - --- -- --- - -   ----  -  -        -
- - -    -      -- -   --     - -  -  - -   -- ----   --- -     -  -    - -  --         -  -     ---
- -- -   -    - -- - -  --    - --  - - -    - -   - - - -  -  -  -  -    - -     --- ---   -      -
-          -    -     - - -    -   --    - - - -      -       - - -  -   -    -       -    - ----- -
- - - -  -- - - --- -    -- -    -  -  -    - -  -    - -   - -    - - - -      -- ---  -  --   - --
- - -  --   -    -        -  --      -  - -   -          -  -  -        -  -   --       - -   --   -
- --  -  -   - - -    - - -  ----      - -    -   -   - -- -  -     -  --- ----- -    - -   ---    -
-               --      -       - -  - -            --   --     - ----- - -       - -  -  -       --
--  - -    - -    - - --    -        -        -  - -       - -  ---  --- -   -   --       -- --- - -
-   - - --   - -               - -   -      -     -  -   ------ -     ---   -              - --  - -
-- -   -    -     -- --  -   -   - -  ---  -   -      -  - -            -----    ---       - - -   -
-    - -  --    -   - - - -   -               - - - -  -  -  - - - --  - --  -- -    -     -      --
- -  --- -- -     - - -         ---  - -          - -    -       - - -   -  -  -- - -  -         - -
-   -  --   - --       -    ---    -      -  -   -    -- -- -    - - ---- --  -               --  --
--- ---  ----          --- --- --  --  --- - ---    --       -        -  - -  -- -      -  -  -  - -
-         --    --  -- - - -     -            -- -  -  -  -     -    - --     - ---             -  -
-  -- -    -  -   -   -  - -  -      -- -  -           - -  - -   -    -  - -        --  -   --   --
-    -                   -    --      -   -     - - - - ---   --      --- -   -  ---     -   -- -  -
--   - --  - -  -    -  - --     -      -  - - -   -   - -- -- -   -- - -    -  -     --  --     - -
-    -   -    -     -----   --  -- -  -    - --  -    -     - -   --   -    -    -   -   -   -- -  -
-- -  --       - -       - -  -    ----     -  --   -  -     -  -  - -  ---- - -    -      -    - --
-    -         - --     - -  - -     - -          -   -- -  -    --  - - -   -   - -  -     ---    -
-    - -     - -          --      - -  -     - - -   --- - -  - -  - -  -  --   - -  - -   -       -
-- --          --  -           -- -- --        -  -          -    --- -  -  ---       --- - -      -
- - --      -    - - -------     ---      -     -  - -   - - - -    -   --      - - --   -  --  ----
-   -                    -       -    ---  - - -   - -      - - ---  ---   -  -     -  - -  - --   -
-      --        -- --- -   ---     -  -  -   - --  -  -  -     -    -- ---    -     -   -   -- ----
- -  -    - - -     -   --    --   -       - - -    -       - -  -    -         -- -    --         -
- --      -  ----- - -  - -     -  -             ---     -- --     -  --- -- --      ---   -  - ----
-   -- -   -      -           -  --       -  - -     - - -    ---     --      - - - -  - - -       -
-   - -  -       --      --   -    - - - -    -  -- -             -  - -       -   -    -   - - -  -
-  - -  - - --  -   -  - -----  -  -     --    ---        --   -   - - --  -    -- -    - -    - - -
- - -        -  - -    - ------       ---       -  - --   -     -  -- - ---  -- -    -- - -    - - -
-     -- -   - -- -  - -  -  -- -      -    -    -    -  - - ---  -      - ----- -     -  -- -  -  -
- - -   -     -  -   -       - - -    -          -     -- - - - -  -   - -  --   -   -  -- -  - -  -
-    --    -  --  -       ---  -   --      -     - -          -  -     --  -   --          -    -  -
-- -     - -  -      -           - -    -    --   - -  -   ---   -      - -    - -   -             -
-  -  - --- -  --   -  - --  -    -         -  -       -  -       - -   -      --  --     - --------
- --  -     -   -   - -    --   -  --- -  -  -    -     -  -   -  -        -     --     -   -      -
-  -     --  -   -    - - - - -  - -  - -- - ---      -     -   -    -  --    - -   -     -    --  -
-       -      ---- -  -    --    -       --- -    -         - - -  - -         -       -    --    -
-       -   --  -    --           - --    -   - -- -   -    -     - -  -  --       - -    --  --   -
-   --                  -      -       -- -  -      --       --  -  - -  --   -- -      -  -     - -
-   - -- -    -  -    - -   --     -    - -  -   -- -- -      --     -   - --          --- -    ----
-      -          -    -  - - -    - -        -         - - - -   -   - -   - -     -       --     -
- -- - - -  -   -    - ---   -  -- -          - -- - -    -  -       --  -     -    - -  -- -    - -
-       - ----        - -  ------            - --  -   -       -      - --   - --  - -  -        - -
- -  -  --  -  ----   - -       - - -    -  -   -   -- -- - -    - --    -----   --   -  -- ---    -
-    - -    -  ---- -- -- -    -  -      -- --             -   - -       -        --  --  -       --
-    - - - -  -----      -        -  -            -    -  -     -  -      - - - --  -   -  - -     -
-     --      ----  --     -   -      -          - -  -   -- - - ---   - -   -    - -  --     -  - -
- - --   -- - -- -- -  - -   - -  - -     -  -   - -  -    - -       -- - --          - ---   -  ---
- - -  -    - -  -  ---      -    - --   --    - -   -  -   -   -     - -  -    ---  - -     -  ----
-    - - -      - -- -  --      -  - - -   -  -       - - - ---    -  -     - --  - -   --- -- -   -
-       --      --    -      -    --       -   -  -  - -     -   -    --   - -     -  -          ---
- -  --    -            -   --   --      -   -   -- -- - - -  --     --       ----   - - - - -   - -
--  -  -  - -    - - -    --      ---  -   - -        -  - - -- -    -  - - - -  -      - -        -
- -    -   -  -  -  - -   --          --  -     -  ---     -  - --   -      -  -    -          - - -
-- -       - - - - -    -    --   - - -  - -   --           -      -  -    - -   -   -  --    -    -
- --   -  -     -   -  -- -  -  -   --       -   -   -  -- - ---- -- -      -   - --   -    --     -
- -   -    - --                    -  -      - -  --          -    -   -    - -     -  --     -- - -
----------------------------------------------------------------------------------------------------
