100
100
----------------------------------------------------------------------------------------------------
- -  -- --                -        - -         -             -   -  -- -- -- - -        -  -     - -
-     -     -     -  --     -  - -     -- - -          - -  - --   - -   -   -  ---  -       --- - -
--  -  -     - -    -   - -  --    ----     - --        -     -    -  --  --- -    -- -   --- -- - -
-  -  - -   - --        -- - - -      -   -- --  -   -  --  ---  ----   -  -  -- -  -  -        - --
-    ---    - -  -  - -      -       --  -       ---    -- --    --  --  - - -  -   -- -- -     -- -
-  -- -  -   -          -      - --  - --       -   --      -      --       -     -   -   --       -
--  - - -   - -- --   -     --  -   - - -   -  - - -- -  --   - -     -          - - -  -       -  -
-     -     --  -        -- -- -      -- -    -     - - - - -      -  -  -  - - ---      -  -   -  -
-    -        -    -       -  --  -   -      --  -   -   -   -- --  -  -  -      -    -   -  --  ---
- -    - -       -- --    ---      -   -- -     - -- -- -    - - --  - --          -            - --
--        - -          -- -           - -   -- -   -    - -        -  -       -- --          ---   -
--  -- -     --  -  ---      -  -  -    - -   -      -     -   -              - --   -   ---       -
- - - -   - -     -- --  -  - - -     --     --  --   --        --         - -       --       - - --
- -         - -   --   -  -   - -     -    -   -   - -- - --  -      --- ---            - -   -    -
-  -    - -     -     -       -   -      -  - - - -           - -   -         -  - --  --    - -  --
---   - -    -   -  - -         -   --  --    - - ----    - --        - --  -             - -  - - -
-- - -    -- -- -            -       - - -     ---  -   -  -   - - -   -  -  - -  -    -- -        -
-  -          - - -    -       --- - - - -   -   -    -      -     ----     -     - - --   -  -  - -
- -       -     -  - - -     -  - --      -      ---- --      -  --         - - -    -   -     -   -
-    -  -      - --       --    -- - -     --  - --- -   -  -      ---   -   --    - - -        - --
-    - -- -           -- -    - - -     -               - - -          -   -        -   -   - - -- -
- - - -    -- -----  -       --  -  --     -  -          -      -- ---   -- ---- --    -    - -    -
-- -- -  --   --    -   - -  -   -   --  -- -  -  --  -  -   -       -     - -       -  - -  -- - --
- - --     - -            -  -     -  -- -   -   -   -         --- -     --        -   -       - - -
- -   - - -  --  -- -     -  -   --- --- ---   - -- - -- --  -      -    -    -    -    -  --      -
-          - -  - -  -  -   -  -    - - -   -      -     - -      -  --- -  - -  -  -           ----
- -  - -   -- -   -  -  ---      - --- --- -   - -    --  - ---  --     -    -     -   -------- - --
--              --   -  --   ----   ----  -  --    -     -      -       -            --       - -  -
-     -   -- -       - - -        - - ------- - -   - --                    - - -   -        -   - -
-   -- -     - --  - - -  -- -            -  -       --  -  -  - -- -  -- -      -      -   -    - -
-     -  - --            - -    -  - -  -   - -   --     --  -    -  - -  -     --   -    -   - -  -
-       - -    --    - -  - --   ---   - - --     -  --   - -   -- ---  --  - -- - -- - - -       --
-       -  --  -   -- - -    -      - -     --       - - -- ----- -     -        --  -     -  --   -
- ---    -  --    -   --  -  ---  -  - -     --        -  --      ----- - -  -   - -  -- -- - -  - -
-     --  --   -- -  -   -     - -- - -- ------ -   -  -     - - -  - - -    -           -         -
-   -            -   - - ----       -    -- -- -    -  -   --   -  -    - -           - - -- - -   -
- --    ---    -    -         -   -- - -           --            -  -      -    ----   - -        --
-    --  -  -    -    --   - -  --    - - -- -- -   -   -          -      - -   -   -  --     -    -
--     - - -  - - --            - -- ---   -     --- -      ---      - -      --  - - -  -   -     -
-  -   --  - -- --     -  -            -    -- --   ----- -        - - -   -- --- -        -     - -
-- -        -  - - -  --    - --    --  --  - -   -         -  --   -  --     - -   - -  -   - --- -
-      -     - -   --   -   -   -  -    -   -      -    --        -- - -  - -    --- - ---   -     -
--- - - -    - -  -  ---  - -            --   - - -   -      ---       ---  -  -   - -  -      -  --
-- -- -    --  - -    -  -       -   -      -      -       -           - - - -   - -  -       - -  -
--         - --  - --       - -- -   - - ---       -   -    --      -   - ---     - - -      --  - -
--   -   --  -  -    - - --  -- -          - - -  - - -   -   -  - - --    -  -  -- --        ---  -
- -    -    - - - -  - ---     - - -   -  -- -  - - -    - --   -   -       --      -- -- - --  -  -
-     -          -- -  -     -    -  - -   --       --  --- - -  - - -  -  - --   -   - - -    - - -
- ---   --   -    - --  -- -- -  -  --   --      ---    --   - --    -       --- - -  - -- - -- - --
-    --  -  --       -   -- --  --   -     -  -             -- --   -       -  -    - -       --   -
- -    ----   --   -  -      -   --         - --- -  --   ---     -  - -      --     -     ---  -- -
--        ----     -     - -       -    - --     - -    --  -- -      -           ---     -   -  - -
-  - - --  -      - ---  -  --   -     -  -          ---  --           --  - ----     - -   - - -  -
---  -   -- -  --              -    -  - - - -   --      -    -    -             ----  - --  - -- --
-    - -  -         -     - - -  ---- - -          - -    --                  --     -  -    -     -
--          -  ---  - -  -  -      - -    --  -  -   -  -     --  - -    --  -      -  -  --     - -
-  -       - --    -    -  -- - --  - -  -  -     - -- - - -        - -        -- ----             -
-- -     -   -    - --      - -   -     --   --     - -    -    - -   - -     -  --    -     -     -
- -     -  -   - - -    - -    - -     -   --  -   -  -     -     --  - ---      -             --  -
-   - -- -            -  -----       -    -   -     - - - --   -     -            -- - - -  -    - -
-  -- -- ---     - -  -  -    -    -- - --  ---- -- -      --        -      -  - --   --   --      -
-  -    -  -     - -       -- -  -      -     -- -   --  - --- -  - - -   - --         - - -   - - -
-   --  --- -- - -      -          -- -- -  --  -  -- -   -  -   -              --   -- - - - -    -
- -             -        ---    --  -    -   --  -  -- - -       -    -   -   - -  - -         -   -
- -- - -   - -    - - --       -  -          - -    --     --     - -    -     - -- -       -  - - -
-- --  --   -  -      - - -     -     - - -     -  -  - -  - - --   -    -           -----   -- -  -
-         -     - -         -   ---      - -   -      -  -   -  --- -   - ---  --- -            -  -
- --    -     -    --   - --- - -      --  -  --        -- -   - --    -  --  --     - - --   -    -
-  -  - --    --    -         --      -       - -         --    -  --  ---   -- --   - --  -  ---  -
--  -   -  -       - -   -   - -   --- -   -    -  -        - - -   - -  - -   -- - - -  -       - -
-  -  -     -  -     -  - -  -   -      - - --  - -       - - --  -   - -     - -  - -   -    -- - -
--   -    - - -     --  - --   -    - -   ---- - - - -    - -        -     -           - - -  -   --
--     -   --      --    -   -- -  - -        --   --- - - -- -    - -- - -     -    -   --  -  -  -
-   -       -   - -       --   -     --    -- ---   -  -     -  ----       ----   -  -      --  ----
-   -     - -               - -   - -       ---  -   -      -            -       - -  - - - -  --  -
-  - -- -  - -   -      -   - - - -- -- --      --  -     -- -  - -   -   -  ----- -      -  -    --
- - -  --   -  -      -      --- - -  ---  - - -               -  -      - --  -  -    - - -     - -
-- - -     --      -     --   -  --  -----        - - -  - ---   - -  --  -     ---        --- - - -
-  -   -    - -- -  --  - - -    -  - - -  -  -  --  - -    -  -- - - -    -   ---        - -     --
-   - -            -       -    - -         --  ---    -    -     -           -      - -   -  -  ---
-      -   - - -  --- -  -        -   -  ---  -  -    - -   -         -  -- -  -  -   - -- -      --
- - -   -  -     - -  -  -   --- -  - -   - --   - --  - -- -      -   - - -  -  --   --    - - - --
-   - -- -    - -- -    -  -    -  -     - -   --   -       ---   ---      ----     -   - --     ---
- -      -- -- -         - -  - --     --  - - - -     -- -  -  - -  -   -   -    -  -  --    - - --
-     -- - -  - -    --  -       - -   -     --   -     -      -- --       -     -  -  -  -  -   - -
---   --    --  -   - -  -  - -- --   - -    -    -   -   -  -  - - -  --   -- -      -     -      -
-- --      -- - - -   -     --  --   -- -      -   - - ---     - -     -          - - - -- - -  -  -
--      -    -   -- - -      ---  - -   -  -  -- -        --    -       -   --   - - ---   - -   - -
- -   -  ---   --     -  -  -   - --- - -  - -       -----  --      -  -     --  --    -  --   -   -
--     - -  -      -- ---   - -    -   - - -   --  -    -         - - -  -  - --    -  - - -       -
--  -     -   -     -        - -   -   - -   -  - -    - -      -- -- --   - --- --   - -- - -- -- -
-  -     --    - - -    -  -      -  -    --     ---  --        - -   - -     -   -      --  - -  --
-    - -    - -   -   - -     -  --          -              -   -   -   -   -    - -  -       -    -
- -   -    -   -  - - -        ---   -  -       - - ----     -   -   -       --- -   -- -  --    - -
-   -      -           -     --  -  - -      -- -  -  - --  --   - -            --  -- - - -   - ---
-  --   - --    -   - - -  -    -                -   --  --  -   -    -  - -  -    -   --  --      -
--    -- -   ---    -   - ---  --  ---- -  --     -       -  - -   -  -         -- - ---  -- -    --
-  -- -   --    --       ----  - ---   -      - --     -  - -    -        - -        -             -
----------------------------------------------------------------------------------------------------
