100
100
----------------------------------------------------------------------------------------------------
-  -   -        - - --             - -  - -       -     - -           -  -       -      -    -     -
-    -    -    --   - -   -        - -      - --    --         --   --        --- - -  --  -     - -
--   -  -- - -   -        --   -    -  -      -  -         --           - -   - ---  -  - -  --  - -
-  - - --     --    -  --  -   -  -    -  - - --- - ----  - - -  -- ---  --  -  -     -  - -       -
- -  - ---       - ----         -            -    - - - --   - -  -         -  -                -  -
-      -  -  - - - -- - -     -  --      -- - - --  -  -  -       - -         -- --      -   - --  -
-  -    - - - - -        -  - -   ---   -  -   - --    -  --              --    -    --   -  -  -  -
- -- -- -  --- -     - - -    -  -   --- - - - -    -  -  -- -    - --   -     -      ----  - ---- -
---    -- -  ---       -      -  -  -    -   --      -- -       - -        - - - -   - -    -      -
-  -       - -- - -     -          ---- -   -- --  -    -  - -     --  - -  -   - ---      -    -- -
--  -    ---    -        -       --      -     -    - - - -  ---   -          --   - -     --      -
-   - -     --   -  -   -      --  -- -     --             --     -  -     -     --  - - -    -    -
-      -  -     - -   ----- -    -  -  -   -     --- --   -       -                --      -   - - -
-   -- -  -   -  - - -    -        ----  -   -       ---   -  -      --      ---            -  -- --
---          -  -   ---    -  -  -- -  - - -   --- -    ---   --   -    - - -         -- -- -   -  -
- ---      - -    -       --         - - -- -             -       -- - -  -- --  - --- -     --    -
--      --   -    --  - -  ---  --    -   -   -- -  -  -- -   - - - -- -  -    ---  - --    -  - - -
-     - -  --   -   -        - --  -  --  ----    -          -   -   - -  -  -              --  -- -
-- - -  -    -- --  -   -  - --  --   - -      -  --  -- -- -       -            -       -     -  --
-  -- - -  -     -       - --  --  --- -      -     - - - -- -     -  - -   -  -  --      ---      -
- -    -               --    -  -- -   - -         - --- --  - - -  -- -- -  --       -  --    - - -
-  - -     -- -  - ---     --    -   -       --    -       - --  - -  -      -  -            -  -  -
-   ---- - - -         -    - - -  - -  ---   -       -  - -   - -  -    - - - - -      -    -- -- -
-  - -  -- -  --  -  - - - --    -   -- ---    -   -  -   - - --- ---   -      -- --  -   -   -  - -
-     --  - - -        --  - -- -    - -   ---- ---   - -     ---        -----    -    -     -     -
-  - --  - --     -   ----   - -       -    -- -       -  --    -   -  -     - -       -   -   - - -
--     -- - -     -  -  -   - -             -   ---    -       -   -   - -- -  - -    -     -    ---
--   - ----  -- -  -        - - -    - -      -          -  - -  -- -    -  ---- - -  -        -   -
--     -   -      -- - --     -  -  -  -      -- - --  - -   -         -  --     --   -- --  -  -  -
-        -    - -    --  -   -   -- -- -     - -- -        -  -   ---   - -   ---    -    --    - --
---  -       -         ---   - - - - ---      -     - - -   - -      -- - -      - -  -- --  --  - -
-       - -        -      -      -  -       -      -         -  -- -- - -- - - -  - ---    --    - -
- -  - - -  -    --- ---      -  - -   --   -- -       --- ----      -          -  -     -      -- -
--- -- -   - -    -   -   -- --      -    - -- -   -- -  -         -   --    -   - -   -- --       -
-    -     -  ---      -  - -   -      - -  -    --  - -   -   -    - -     -       - -- --   -- - -
-      -        -  - -        -- --  -        -     -     -- - -    - ---    -  - --    -       -  -
--  - -   --- -- -- -        - --        - -  ---- -   - -       -      - -    -      ----  --   - -
-   -- ---      - -       - - --  -    -   --        -      -- -  -  -   -- ------   -         - - -
--         -    -  - ---     - -          -  ----     -   ---  --  -             -  --  - -      ---
-   - - --      - --    - ---  -- --  -    -   -    -- -   -   - - -   -        -   --  -  -     - -
--- -  --  - -- -     -        -- - -   - -  --   --- -             -- -  -  --       -         - --
---       -    -    -      - -   - - -      -  -    --    ---  -      -    --  -     --  --   -  - -
-  - -            -  -     --     - --- -       -- - - -   - -         - -     -   - -   --     -  -
--- -- -  --   ----  -   -    -- --        --  --  -     -   - ---- -        -  -- -   -           -
--   -      -      - ---  - - -     ---  -     -   ---   -  --  ---      -   -       -   --        -
- -  - - -    ---     --  - -     --  -  -- -- - -     - --    --  -   -  -  - --       -    -  - --
-  -           -           - --          --       - - --   -           --      -            - - -- -
-    - - - - -    -  - -   -   - --     --   --- --   - -  -    -- - -        --      -   ---   -  -
- - - -  --  -  -- --     --   - -     -  - - -       --    - -         - - --    -- - --     -    -
- - -  - -   --   -                     ---  - -     -      -  - -    -  -  - -    -  --    --  -  -
-             - -     -- -           -  -- -     -  -  -  - ---- -    -- - --      -           -  --
-        -   -   --  - --      - -        --   --   -   -  -   ---   -  -    -- -  --  -  - -   - --
-    -  --    - -           -        - -  -     - -- -      ---        -    -      -   - ---   -   -
- -      - -  -  --  --  -    ------ -  -   ---     -- --      -   -     -  --  ---- -    -   - ----
- ---  --  -  ---     -   -        -    -       - -- -   --- -    -  - -- - -   - - -- -   -  -    -
--         -     - --    -- -  -- - -    -  --  -     --  -----           -  -   -   - -       - - -
-  -      -   -      - -      -    - - -      -  ---     -   ----    --  -     --  - -  --    -    -
--    - -   -   -   --    --   - - - - -   -   - - ---   -   -  -  -  --   -    -   - -  - -- -  - -
-        - -    -  --  -        -    -  ---   - --- -   -   -  -     -  -       -            -  -  -
- -  -  -     -   -  - -     -    --   --     - -    -----         -   --- -  -         - -   -    -
-    -      - - -  - -   -   - -   - -  --       -- -      -   --        -- -   - -  -  -  -  --  --
--       --  -- -      --    -- --    -     -- -   -  ----    -     -   - -  -  -  --  --- - -  -- -
-     -   - --     -   -     -  -   -- - --      - --   - - --    -       - - - - - -  -     ---- --
-       -   -  - --- -             --     -  - -     -   ---  -- -    - - - - --     -  -   - -  ---
-  -- -      -       - --   -   -   -   -  -  --- -  -    - --- --   - -    --   -- -  -  - - - - --
-  - ----    -     - -   -     -  -- -   -   - -  -   - -             -        --          -  - - --
-  - -     - -             -        -  -   - -   - -   - -    ---   -       --    -  -- -     - - --
-   -  --  -  -- -  -- --   ---  -- --  --   -- --       - --     -  -  --       - - -   -   -- -  -
--- -    --  -   --    -   -   -  --  -- -   -    -  -- -  -      -  --             -  - --- - --  -
--  --  -     ---  - ---  - - -         --- - -        -   -   --     -             --    -  -    --
-      - ---  -    -    -       - - -      - --- -  - -        -  -    -- -  -       -          -- -
-           - --      -  - - -    -    ---- - -            - -      - -   - - - --- -   - -    -   -
-- ---   -  --               - -- -    -  -     -- -   -   - - - -  -  -   -   -   - -   -  -   -  -
--         -  ---  -  -----    - -  -     -- ---  --      - - -  -  -  -  -   - --   -  --     - - -
-    --- -   -  ----   -    -           -   -        -    -  -  -       -  -   -      -   -- -     -
- - -        - --    --   -- -  --    -  -   - - --  -    - --   --  - -           - -             -
-    -  -    -      - -      --              -  -   - - -- -  -        -  - -    -     -           -
--  -  - ---         -  -      -  ---  - -     - - -- -   -   -    -       -  ---  -   -   -       -
-     -- -  -   --      -- -    - -  - -- -  -  --  - -- - -    - -   --    -  -  --  --     --    -
- - ---   --  --  -- --   -      -   - -   -   -   --   -    - -     - - --    -  - - -  -  -      -
--               -       ----  - -    -  -     --       -     - --         -   - -           ---   -
- --  - - --       --           -       -   -  ---     -- -    -  ---        -   ----  --  -   - ---
-   -  -  --    --   -- - -- -   -- - -     --   --- -           -        ---   ---- -     ----    -
-    -  -      -    -   ---     --  -         ---   - ---- --      --   -              - -  -  --  -
- - - -         -     --   - - -   -   --   - -   - -  --   -    -  - -- --- - --            -   - -
-     -    -        - -  - -         -   --  - - --      - -- -- -       -       -  -        - -   -
- --- -      - -   -  - -    - -- - -    - - -    --   - -  -  -  -      -  - - - --   -   -      --
--  - -- - - --- -  - - --                     -    -     -  -     ---             -    --    - -  -
- --   -    -   - -             ---  -- -       -        -  - -- - -      --   -  -       --   - ---
- --    --        -    --   -   -     - ---    -  -   -  -         ----- -   - --  ---  --      -- -
-    -   -  - -  -    -  - -- -    --- -     -  -  -    ---  -  -  -   -  -      -  - -     -- -   -
- - -     -  - - --    -  -  - --       - ---      -    -   -- --      -    --     - - -  -    -   -
--- -     --      ---    -   -- -  ---  -  --  -   -  -         -   -      -   --  -- -            -
-  -  --   - -  - -          -       - - -     -   --  - -    - - -    -- -      -  -   -     --   -
- -- -   - -  - -  - - -- - - --   -  -   -- -   - ---- -- -   -- -          -   --             -- -
-  -  --    -   -        -----    -     - - -- -  -      -- -   -   - -     -  --   --- -----      -
--    -  --   -  --  - --            -----    - - -             -- -   --       -  --  - -     -- --
-      -       - --   -       -     -      -  -   -         -  -   ---   - - -          -  - -     -
----------------------------------------------------------------------------------------------------
