100
100
----------------------------------------------------------------------------------------------------
-             -  -      -              -       --               -      ---       -  -   -     - -  -
--       -   -- -   - -   -  -   -  - -  - -   -        - -  -             --- -   -  -     -    - -
- - ---   ----  - -  -      -  - - -  -     --      -  - --  -- - - --  -   - -  --- -    --  --  --
-      -     - -   --   -   --- - - -    --   ---     --   -         -       -----       -         -
- --    -  --- - -    --- - -  -  -    -     -    -   - -- - - -  - --    - - -  - -   -  - -- - - -
-   -- - - -  -    --     -  ----   --  - -       --  -   -- ---  -- ---- --       -  - -  -  -    -
-     - - -     - - - -   -     --- - -    -  -     ---    -- -  -   --   -  -  --- --     -      --
--      - -- --  -   - - - -        - -      -  -- -- -         - -    -    -   -     - - -  - -  --
-           -    -   -    -       - --      - -   -  --   -   - - -       -          -   --    -  --
--       -    -  -  -   - --- -- - -  -  -- -- - -  -       -    --  --- -  -  -- -    -   --      -
-     --   -   - - -   - -- -  -   - -- --    -- - - -    -- -      - - - - - --  -   - -  - --  ---
--  -  - --  - -    -    -   -                 -      -    -      -  -    -            - -      - --
- - -   --        --- - -      -    ----         -  - --- - - -      -  - -  - -    -- - -         -
-  --      --   - -         - -      -    --  - -    - -               - --- ------   -     -     --
----    -     - --   -- --   -  -       -     - - -     - -    ----  -    - ---      -    -   -    -
-         -       -   -       -  --        -     -      --    -   -   - ---    - --   -    -  -  - -
-   -     - - -  -   -    - -        -       - --     -  - --- -        -  - -    - --   -  -   -- -
-   -            ---  --    -  -    -  -- -    -       -  -- - -   - --   - -   -  -   - -     - - -
- ----    - ---  -   -  -         -   -    -     - --     -        - -- --  - -  - - -   - -    ----
-  -  --   -   -  - -- -    -      -- -  --   --       -- -    -  -  -  --       -   -     -       -
--- -  -    - ----  -   -    -  -- -    ---  ---    ---  -     -- --  -   -   - -     -----   - - --
--      -    -   - -   -     -  -          - -- -       --            -- -    --  - --  -    --    -
-    -    -    -     -  -  --   -           -     -      -     --     -   -       --   - --     -  -
-           -   - -- --    - -   ---  - -       -  - -   - --       -    -   - --- - -     --    - -
--    -  - -   -  - -   -   --  -  - -   -   -   -    -  -     -   -  -    -- - -   -  --- --- - - -
- -    --    -- - -       -         -  - -   ------    - -       - -   -- --        --- - -  - --- -
- -        ---  --   - - -    - - --    -  -  --     -     - - - -  - -  -  -  --  -   -  - - -  - -
-   - --   -  ---       -       -    -    - -    - - - -  -  - --- -    -     -         -     ---  -
--  ---  -  -- -  -  -    --    -       -      -   - - --  -- -       -        -- - ---        - - -
- - -   -   -         ---  --       --   -  -    --  - - -  -   -  -     -     -    -  - -       - -
- -   -   --   - ---      -- ---     - -  - -    - --  - -   -     - - --     --    - -    --  - - -
-- - --     -  -    -   -   - -- --  - ---    - -  -    -          - - - - -- -  - -   ---  -      -
-         -      -- - -           -   - -  - -   -    -- -  - - -    -  -   -- - - - - --       -  -
- ---  -- - -          --  - -    - --   - - - ---  -- -   - -   --  - -  --   - - - -- - -   -   --
-- -  -     - - --  --    - -        -      - -- -      - -  -      -   -  -     - -    --  - -    -
--   -   ----  -   -    -     -     -  - --       -   - --  -   -         - -   - -  -  -  --     --
- - - -       -   -- -   -  -    ----- - -- - -- - -  -   -  -  -- -    -  -   -      ---    -    --
-      -  - -    -     - -     -   -   ---      -- ---  --       -  - -     - - -       -     ---  -
-  -     - --   -   -   -    - -  - - --     - -  ----    -    ---  - ---   - - -  - -- -          -
-     ----      -  --   --   -         -   - - -    --  -  -     -   - ---        - -     --     ---
-- - - -    -- ---     -     ---  -   --   - -- -   -- - - - - - -   --              - - - --- -   -
-   -     -- --  - --- ---     -   - -  -  -    -- ---        -   -         ---    --    -- - - ----
-   - -  --  -    -   -  - ---  -     - -    --         -       -   -  - -    -  --  -     - ----  -
-   -    --- -  -- - - - -    -    -----       -  -      - -   -        -   -- -  - -     --      --
- -      --  -       -         --     - -     --       -    - - --      --      -  - -      -    ---
- - -- -          --   -       -  --   -                 -          - -    -     -  -  ---    -    -
- - ---  -- -  -     - -          --  -   - -- - --  --        -  -  -     -  --   -   -           -
-  -   -          -- -   -  ---   -     - -       - - ---    -    --    -    -  -  ----     ---  ---
-- ----- -  -  ---     - -  -    -  - - -    --         -- -    -         -       -      -     -   -
- --             -- -     -- -   -      -   -  ----  -     - -  ---   -       --- -  - ----        -
-     ----  -  -    -         --     -  -  - -      -  -      --   -  -  --    - -    -  - -    -  -
-       -    -    - -  -  ---      -    -- - --- -   -   -    -  -- -  -      -   - -  --      --  -
-   -   -  --          - -  - -    -  - - -   - -     - -   -   -- --   - --- -    -   -- - -      -
-   --    -  - --  --  - - -  ---  - - -      --    -       - --  -         -  -- -  --  --   -    -
-   - ---  -              - --  - - - - -  -    -           -  -    --- -     - -      - - --     --
--  -     -  - -   - -- -      - - -  - - -   -- --  -     -   -   -    ---  ---     --   - -      -
--      - -   -    -    -  - -      -   -   -         -      -- --   --      - -     -  -   -- -   -
-       - - -     --   - -- --    -      - -  -  --  -  - -      -  -     ---   -     -   - -   -- -
-  -  -    -      - -  -      -    -  -- -        - -- - --  -     -  --  -  - -      -----  - -   -
-  - -      --   -   -  - -      -         -    - -  -  --       -       -  -             - -      -
-  -  ---      -   ---       --  - --  -  -  --  -    -        --     -  --- --  - -    -- - -     -
-   -       -- -         -      -  -  - -  - -      -       -      -           -            - -   --
-   -  -- -    -    - --     -      -       -   -  -  -  - -    -   --     -   -   -   -- -      - -
-  ---  - -   -   --    --  -   --  --  -    - -        --  --   -  -   - -     ---      - -       -
- -       -    - -  ----  - --  -   -  - - --  -  -    -   - ---      -- ---   --              - - -
-   -   -          -   - - ---          - -      - ---  -- --    - -    -  -       -     -  --    --
-- -    -        -   -   --       -   - -     -    -    -     ---        - -  -  -- -------  -- - --
-    --      - --- -       -    -- -  -    -   -    --   -  - --  -      -- -  --           -   - --
---        -   -  -      -- - -  -               - -  ---            -     --       -  -   -- - -  -
- - - - -  --     - ---   - -- -   -    -  -   - --       -      -        --   -   -  --     -- -  -
- -    -  ---  -- ---  -- -  -        - -- - --     --  -- - - - ----    -     -- --      -    -   -
-  - -   -  - - -  -  -      -  -  --         --   - -     --   - -   -  -    - -    --- -   --  - -
- -  - -  --    -   -   - --      -   - -- -   - - --- -     - - -   - - --     - -- - -   - - --  -
-     --     -      --             -    -     --   - -   -   -    - --  - -- - -  - -   -----      -
- -      --      -    -    ---       -  -      - -  - -      -    -   -  -     ---- - --       -   -
-        -  -   - --- - -    --     -  -  --  - - -  -   --   --  -   -  - --      - - -  -- -  -  -
- - ---      - ---   -   - - - -      -  -  -  -     - -    --- -- - -          - -   - -    - --- -
- --- -    - --  -  -  --- - -  -    --         -  ---    ---   -     - - -  --    -- - - ---      -
-      -     -        -     --   --  -  -- --  -  -        -          - --- -     -   - -   -    - -
-  ----   -  -   -    -  --     -  -  --    --- - - - -        --   --   -         --      -    -  -
---     -- -   -       -  -    - -   -                 -  -        - - -   - -  --     - --     -- -
-  ---- --           - --   -     - -  --           -      -   - --    -   -      --  --   -  --  --
- -         -      --      - - -   - --   -   -- --       -           -  -   -  --           -  -  -
---- -- -- -   -  --   -- -     -  -       ---   --  - -- -- -  -   -  -   -  - --  -  --   -      -
-   -  - -- -   -   -- -   -  - -   -  -  -    -   -   -   - --   - -      - -  -     - -      --  -
-    -   -- -- -  -  - -  --   --           - ----      -   -  - --  --        ---   ---  -        -
-   --       - -     -      - - -                 - - --- -- -   -- - ---- -             -         -
-- -  -  -        ---               -   - --    - - --  -  -    -   --  - -        -    - -     -  -
-     - -  --  --    -   --- -   -    - --  --    -- -- - -- - -- --  - -  -   --       - -  -   - -
-     -    - - - - -  -          ---- -   -- ----  -       -  - -   -  -  -  - --   ---   - -    - -
---   - - -- -   -  -  -        -    ----   -        -       -- -     - - - -  - -- -    -   -     -
- - - - - - - -   -    - -  - - --       - - ---- - -- --   -    -  - -   - - - -  -- -   -    --- -
-     - - -  --    - -   -  -    -  -- -   - -    -      -   - -   -- -   - --         - - -- -    -
- - -       -  -    --   - - -   - -    - - -    -     -   - -       -     -       - -       -     -
-  -  -----        - - --              -   --     -  -        --         -    --  - -           -  -
-   -             -  -         --   - - -- -      - -  -  -  - -    -      - --  --  -      - --   -
-   -- --   - -  - --     -                      --  -     -   --  -      -- - -  - -      -       -
- --     -       - - - -     --     -  --           -    - --    --  -    - -     - - -   - -- -   -
----------------------------------------------------------------------------------------------------
