100
100
----------------------------------------------------------------------------------------------------
-   - - -      - -    -    -  -   -              -       - -  - --    -       -  - -       -       -
-- -   - - -     -   -    --  --   -     -      -   -    - -     -      -    -        - - - -    - -
-   - -   - -    - ---          - - ---- -       -- - -    -       -     - --       - --   - -  -  -
-- --- - --  - -   -     -----        --        -    ---   -   --     -      -  --        -  - -- --
- - -            -  - ---  -  -    --  --   -         -  --  -   -      -      -    ----    --- - --
--    -   -   - - -   -- --           -  -  - --   - - -  -  -          ---   -   -   - --  -      -
-   -   -  - - ---     -    --   - -    -   --     -        - --  --     - -- -    - - -  - --- -  -
-    - ---        -  - --   -  --    - -        -  --   - -  -  --     -- -  -       -  --   - -   -
-- -  -      - -- - ---  -- -  - -   --   - --  -      -       -- -- -    - ---  --  -  - -   - - --
-    -- ---    -          -       -        - -           -  -- - - - --          - -     - -  -    -
-      -  - -- -    ---    -- -    -- --- -   -     -    - - -- -         -   - -     -            -
- -  -- -  -           -  --     -   -  - - --     - -  -    - -      -        - - - -- -- - -     -
-           --        - - -   -        -  --     - - -             -  -  -    - - -         ---  - -
- -  - - -  --  -    -         -    -   -- - -  - - - --      - - -      -   --- -  ---   -  - --  -
-        - -  -    - - -  --- -   - - -  -                     -  -- - -   - -        -  - - -     -
-   --  - --- -- - -   - -   - --- - --       -           -    --- --      - -   -- -         -    -
-  -  --  -           -  -  - -          -   -  -   -  -   -    -- - - --  - - - -  - -  --  --  - -
-   ---   - - -- -- --    -      -      -- -   -   -  --  -  -  -    -      -  - --  --- - -  -    -
-  -      --      - -    - --  --      - - -  -    --     -    -- -     --    -        - -   -    --
--  -  - - - - --  - -  ---       -         -   --   --    -- -   -- - -  -- - -- - - --  -        -
-     -- - -   - --   -  -  -- --   ---      - - - - -   -      -  -    -           -    -   -     -
- --  -   -    - -    -          -  - - -- ----       --   --         -    -  -    -- -  -  - - - --
-     -   -  -          -- -      -           - -     - --  -   --  -  -- - -  - -   -    - -  -- --
--   --       -     -  -    - --  -    - -  -- - -- -- -  --  - -     -    --  --      - -  -- - - -
-  -   - - -  -       - - -    --- -       -  - -  - --  -       --        -   -  -    - -    -   --
- -   -  -   -   -  - -  -  ---          -  - -    -   - - -   -   ---  -   -  -   -  -  - -   --  -
- -  -  - - - -  -   -     -   - - - -- - --  -  -   ---     - -- - -     - -      -  -      -     -
- -  -   -    - -- -  - -   -    - -     -    -     -  - - -   --    -  -    -  - -   -   - ---  ---
-  -   --  - -   -       -  -             -  - --- --    -- --   -  -- -   -  --   - -          -  -
-- -  -      - - - -  - -- -        -  -  - -    - -    -  ------- - --  -   -- -       -  -  --   -
-    --          - -   -    -- -  - -    --   ---   - - -   -  -    -  -   -   -  -   -- - - -     -
- --  -        --  -  - -     --      - - - --  - -   - - -  -  -    - --         - - - -     - -  -
- -  -  -     - - - -       -        - ---     --   -      -- --        -   - --  -   ---      - - -
-   - -  - -   - -  - -    - -- -  -    -  --  - --       -     -         - -     - --- -    -    --
-  ---      -  --     - -     --    - -        - -  -  -- -      -   ----        -  - -- -  -- -   -
-         -- -- - ---- -  - -     ----      - - - -        -  - -   -     --     --    - --     ----
-  -  -       -      - -   ---         -   -    - - - -     -   - - -  -     --- - -- --   --    - -
-    -    - -      -      -- -    - --  -       -  -     - -     -- - -    - -          --    -- - -
--   - -  ---  ----    -  -  - ---   - - -   -   -    -- - - -  -  - -   -  -      -  --         - -
--   -  -       ---- -    -  -  -  --      -  -- - --  - - ---    -- -- -      -    -   -    -   - -
-  -        -   ---   -  -  --     - -   -   -   -    --- -     -      -     -              --     -
-   ---  - -  -      -  - -     --      -- -       - - - -- -    - -  - -- -- --  --           - - -
- - -  -      -   -  -           -       -  --   - -  -  -        ---        -   -  - - -- - ---  --
-  - -   -   -- -  -     -     -  - -----        -      - ---     - - ---      -  -  -  --   -     -
-  -    - --     -   - - --  - - - --      -- - -  -    --  --     -- -  -   -   -     - - -- --   -
-  -    -     - -  - - -  -      -    -   ---- --   -    - ----- -   -    -   -    -    -- -   - - -
--       -  -   -     -  -     --     - - - -  -  -          -  - - -      -      -    -  -    -   -
--   -      -- --  --   --  -    -- --   -       -  -  -- -- - -   -  --            -   -      -  --
-         -- -   --  ---  --   - -        -     -    - - -     -    -   -    --    -   -- -  ---   -
-    -  -           - - -- - -- -  - -  -- -    -      -    -   -  -   - - - -      - --    --  - --
-  -- --- -- - ---- - -     -- -  - --  -   - --      - -  - - -   -     -  -  -  - - - -- -   --  -
- --   - --       -    -  - -   -     --  -  - - -- -      -  --      - -  -              -  -   - -
-             - - -  - -   - - -   -   -  ---       -     -        - - ---- - --  -    - ----- -- --
- -     -- - -    -  -  -        -      --        -    --   ---  - - - -  - -      -     -   - --  -
- -  --  ---- -      -- - -     -       - ----- --- -     -  -        -      -   -- --   -     - - -
--  -     -  --  - --  -       -  -    --            -  -   - --  -    ----- -              -     --
-   - -   ----       - -   -   -           - -  -----    -  --  - - --- - --   -    -          -   -
-              --   --  - -     -   -         -    --  - ----     --      - -- - -  -  ---     - ---
-       -   -   -   -    - -  - -           - - - -  -      -   -     -        --  -   -      - -- -
----     -     --     -  -    ---- -- -    -- -   -   -  -   - - -  -         - - --  -      -- -  -
---  ---   -       ---   -- -        -  --    ---     -  - -   -       - - -  --- -- -   --      - -
- -  - -   -     -        --  -    -  - --  -                    - -     - --    - ---          - --
-   --   - -       --  --   -    -  -    ---   - -  - -  -  -- -- --   -- -   -  -  - - -  --  - ---
-- - -  -     - -- - -  -    - -   -   --   -  -   - -       -           -    -  - -   -    --   - -
--   -- - -         -- - -       -  -     - -   -   -  - -- --      - - -      -       -  -        -
-  -     - -  -   -  --     -      - --   -     -   - - -  -  - --  - -        -- --    ---    - - -
--     -  -     --  -     -   - --     --    --   - - -     - -  -      -   -  --- - --  -     -  --
- -- -     - - -- -- --- -  - ---  --    ----  -  -      -- -  -   --  --       - - -    - -       -
-    -   -   -    -- -   --  --      -         - - -         -    -         -- --  - -   -         -
-  -- - - --   - -  -  --   -   -- -   - --   -     ---   - -   - -      - -       -  -     -      -
- -  --   --    --      --       -  -      - -    --        -     -- -        -  -      -     --   -
- -  -  -      -       - -     -   - -          --      - --- -     --      ---  --  - -  -- -    --
-    -  -   -   ---  --   -- -          - -   - - -   - - ---          --   -      --      - - --  -
- --        --   - -        -  -   -  - - --  -   -          -  -- -         -          -   - -  - -
-- ---  - -- - -   --  --  -  -   -     -   -   - -      ---   -     - -           -  - ---  -  - --
--  -  -  --            - -- --   -  --   - -  -   -- --  -  -  --     -   -  - - -     - -  - --  -
-    -  - -- - -    -  -            -  --     - - -   -  -    -    - - -     -      -  - --   -  - -
-  -   --- -  -    -- -    ---     ---    --- - -    -- - - -    -     -         - - - -         - -
-- - --   -     -       --   - -      - -   - -   -    - -  --  --    --       -- --     -      -  -
- --  -         -  -  -   - -  - -     - -      -         -  -   -  -    - -   - -       - --   -  -
--  ---     -             ---  - - -   --   - - -   -  --  -   -     --   -  -- -  -   - --      - -
-            -   - - ---    -   --   - -  --       -    --        -  -        -   -           --  --
- ---  -- - ---   -    -  - -   -   -       -  --- --- -    -  - -  - -   -       - -  -  --    - --
- --      -                  -- - ---  -  -   - - - - -  - -  -            -      - - -  -  - - -  -
-    -  -     ---    - -         -     - - --      - -       - -  -   - -----     -- -- - ---  - - -
-      -  -- -       - -  -- - --  --  -- -     - -   --    --    - --          - --    - -        -
-- -   -  - - - -     -  -- -- -   -    -- -  -  -   --      -      -  -  - -  --   -   -     --   -
- -  -     -      - --          - -  --  -  - -   -  - -  --    -       -   - - - -    - - -       -
-   --    - --- - --            -   - -    -     -    ---- -       ----  - -          -  -     -   -
--   --  -    -     -  -   ---- -  - - - -  -   -  ---      - - --      -        - - ---      --- --
- -  -      -   - -   - - ----   - -  -   - -   --  --  - -   -    - -             - --   -  -    --
-  -   -- -     -- -    ---- -  -   - -    --   - - - --  -  -  -        -   -  -    -   - -  -    -
- -      - -  -     -      -    -   -       -   - ---- -           - - --  --      ---    -  -     -
-- - - --  -    -   -  -      --    -  ---   -- - -  -    -- - -  -   -         - --     -   -- -  -
-        -   -     ---       - - --   -     -      --   -  -   -     --- -  -      -      --    ----
--- -        -     -  ---   --   -  - -- -       - -- -    ---   - -      -   - -   -   -          -
- --    -    - -    -  -   -  - -- -       -    -   -  - -         ----- -  - -- -     -     -     -
- -- -    --       -  - - -     -  -     -- -  --  -   -    -               -  -   -        -    - -
----------------------------------------------------------------------------------------------------
