100
100
----------------------------------------------------------------------------------------------------
-  --      -   -  -    -    - -   - -  --     -  -- -  -          - - - - - -   --   --            -
- -  ---  -  -         -      - -      - ---  - -  - -- -          -  -  --         --  -- --      -
-       - -        -   --    -      -   -    -- --     -    -- -   -   -  -       - -  - -   -  -  -
-       - -     -     - - - - - -                  -- -           -      - --   - -- --    --   - --
-  ---     -- - - ----- -- - -  -     -  - -   --   - - -  -   -   -   -   --       -  --  -  -    -
--       -    -     - -    - -  - -   -           - -     - --  -   - -  - -      ----     -   -   -
-   -   --   -   -    -      -  ---   -  -    - -  -- - - - - -  -  - -     -      - -             -
-  -  -    -   --- - - - --      -  - -     - -  -  -    - -    -      --- -    - -         - -- - -
--- -    -    --    -              -   ----   -  -  - -   - -  - -    -      -              --     -
-   -  -   - - - -- -     -- -   -      - -    - -- - - -- -  -  -    -- -- - -    - -   - -   -- --
--    -         -     - --  ---  -     - - - - -  -       -        -  - -   -  - -    --    -      -
-   - - - ---      -- -   --   -    --   - -  - -               - - - - -    -  -      -- -  - -   -
---  -      -    -   -- --  - --  -  - --        - --  -- -- - - - -  -   - - -      -   -        --
-   -  -  -- -    --  - ----      - -   - -  -  --  -   -       -    -  -    -  -        -   - -   -
-     - -   - ---   -     - --    --  --  -     -   -  -   -      -    -- -  -  - --   -     --    -
---   - -    -  -     - -  ---- - - -    - - -     -- -       - --   -          -  -     -  - -    -
-   -  - -   -    - ---      - -  - -  - -  --              --  -        - -   -      -   -     -  -
-  -   -- --- - - --  --  ---  -  -        - ---     -  - -       --  -- -  -- - - --     - --     -
- -   - --      -- -   -    - -       ---    -   -      --   -  -     - -   -          -    -  --  -
-   -  ---   -   - -     - -   -   -      -       -   -  ---  -  -    - --      ---- - -        -- -
-- - --  -   -   -   --  -   --    -  -  -- - -  -   -- -       -   --    -    -   --      -       -
-    --- -    --       -     -       -  -   - - -- -  -   ---- -   -  - - -     -   - -        --  -
- -   -   - --   -         --   -   - --  -     - --  - - -  -   -    -  -        - -  - -  ---  ---
- -    --   - -   --   --   -  -   -        ---     - - -          --    - -        -  -   --      -
- -     - -     -  - -     ---      - -   -    -  - -  - --  --- -     -  - -   --  -    -    --- --
- - -  -    --  -        -- -   -   ----   - ---      - -    -   --    --   -   -  --           -  -
- -            -   -   - - -- - -  -     -           - - -   ----   --    -  -      -    - - --  ---
-- -- - -   - ---          --  -      - -      -  --    -  - -   - - - -  -  - - - - --     - -    -
-    -    - -    --   -- - -  --- -    -  - -  -    - -   -   -  -       --   ---  --- -        -  -
-   --    -    -    - -    - --     - -   --  -- -    --    -   -  -     -- --- -       -    -   - -
-       -     - --- -   -    -  ---    - - - -  - - -  -   -          --           -  --- -   -    -
-  --  -- -   - -   - -            -   -     - ----- -   - ---- -      -  --- -   -  -   - -   --  -
-  -  - -  - -  - -   - ----     -   - ----      -    -   -      -- -   --      - ---  - -  -    ---
--  ---    -  - --  --- --  -     -        -- -   -- -      -- -- -               -  - --      -   -
-   -  - - - -  - -  - -   - - -       -      --    - -          -       -  --  -- ----           --
-  -      - - -    - - -      - -    -  - - -  - - -   - -      -- --- --       -  -- -    --  - - -
-        --  -     -- -  --- --    -     -   - ---   - -        - -    - -    ---  - -   -     - - -
-  - -   - --  - -   -  -  -   --  - -  --   --  -      - -   -- - --   -    --   -- -    ---     --
-  -   - --    - -  -   --        - - - -      --  -- - -     -            --       -- -  -    -   -
-- -  -     --      -    -      -     - -  -   - - -   -    -  - -- ---- -  --- -     -- -       - -
-- - -  --  -   --        -   --   --       -- -  -   --       --    --   - -        - --  - - -- --
- -     - -    ---    -- -  -   -  -   --  --- - -   -     -   -   - - --     -  ----  - -  -      -
- --- -     -  --   --- -   --               - -    -  ---         --   -   - - -    -  ---    -  --
-   -  - - - - -----     ---   - -  - -   -  --   -   ---  -  --    -   --     - - -    -  -   -----
- -    --   -         - -  -      -      -  -   --             - - --       -  -  -   -   --    -  -
-  --     -  ----  --          ---   -  -- -  -    -  --               -  -  -  -   --    -  - -   -
-   --   -        -   - --        ---  - -     --     -   ---   -    - -   - --  -   - - - ---     -
-    - -    --- -   -  -  - -- -    -  -   - -        ---- - - -  -    - -  -    - - -   -- -      -
-      - - -    -   - -      -   -     -  -  ---   -     -  -     --           -     -   ----   -  -
- -     -     - -- -- -   -  - -           -   - - -  --         --- - -   - -- -     -       -  - -
- -    -     -    ---   -   -     --  -  -  -  - --   -- -       - ---    --  - -               -  -
-    - -   --         -  - -   -    -   --             -- --   -         -  -   - --      -   -  - -
-  -      --    -       - -   -  -     - - -   - -- --   --       --- -       -   -      -   -  - --
- -   -       --         - --- --  -    -        -   -     -  -       - --    -  --    --   -   -  -
-    -   -  -         -   - -   -- - -   - -        --      --   - - - - -           -   -     - ---
-      - -    --  - - - -  -  -     - -             -   ---   -          - -     --  -     -       -
--  -        --  - -  -- -  -    -     - -- -  - - -  - -   -   - -  -    -         --     --- --  -
-       - - -  -- ----    -   -----  -- -       - --    --   - -     -           --     --      -  -
-- -         - -  -   -   - --    -   --  -        - -        -  - -- - - ---- -  -    -  - ---  - -
- --     --   -    -- ---- - -  -    -  --  --  --   - -       -- -         - - - --     --- - -   -
- -- -     -  -          -  --   - - -   -     -    --    --     -   - -   -   -- -      -   -     -
-  -- -          - - ---  -- -  -     - -  -- -    - -  -  -     -  -- --- -      -      --  --  - -
--   -   -    -  -    -- - -       --  -            - -    - -- --       -     -  -   -    -     - -
-- -   -- -   - --         -  --   -   - - -   -       ---  -   -    --     -  - - -- -  -   -- - --
-   --    - - - - ------ -    - -    --         ----     -  - --       - - --  -    -  -  --  -  - -
---    -     -- -   -  -               - ---- --  --- --      -     - -        -     --- -      -- -
-   - -- -      --      -  -   -- -   -          -   -      -    -  - -  -    - --    -  --   --   -
-----  --   -   -       ---         - -      -          -   --      --  -   --   -     -  - -      -
-   - -  - -     -     - - --  -     - -  -      -     --  -    -     - --   -       --           --
-  -   --   -  - -   -            -   - --             - - -- -   - -  -       - -    -    -      --
-- -      -  -  -    - -- ---- -  -       -    - -- -          -   -   -      -   -- -     -  - -  -
- -    -  - -     -  -    -   --- -    -  --- - -      -  -  -   -   -   - --   -    - -     -   - -
-- -    -   - - --   - -- - -      -    --  -     -   - - -      -    - -  - -   -    - -- -       -
- -      -           -- -  -   -  -   -- --      -      -   -- -- -         ----   -  - -   --     -
-      -     - -  -- -  -      - - -   - - - -    --    -   --    --    ---       -- - --   -  --  -
-  - -   - -     --     ---- -- - -      - --  -     --- - -   - -   - -    -  --  --  -  - -      -
-  -  -  -  -- -      - --   --  -  ----  - --  ---- - --     -- -  - -  -       --  -   - -    -- -
-   --    - -   - -       ---  - -      -- -   -  --   - -- - -   - -   -        ---  --     -  - --
- -         -    -       ---  - --   -     -      -    --  -    --   -    -  - -  -    -- - --  - --
- - -     ---  --  -  --    -  -  -  - ---    -- -  -    --   - - -   - - -     --    --    - - -  -
- -   -     - -  --      -    -- -     -   -    -    - -----  -   -- -- - - -  -   -       -   -   -
-  - -   -      -    -    ----  --  -   --  -      -     - --  -       -   - -    - -  -  -      - -
-     -     ---   -  --      --- -     -      --   -    - -  -   -   -   ---      -  -  - --- --  --
-   -  -  -- - --      -       --    -     -- - - - -    ---   -- - --   - - - -- --  -  -  - -  - -
--   -        - - - - -  -  --     -      -    -- -----  -      --   -    -    - -   --       - -  -
-  - -- ----    - - -  -        -     -   --     -   -     -          ----      ---  - -   -   -   -
-      -   -     -- -- -    --  ---- -      -     - -- - - - - --   -                -   ---     - -
-  --    -- - -  -- --   -    - -    -   -   - -   - - - --  -   - - - -   --       -    -  -  - - -
-- - -   -    - -   -     -  -        -  -       - - - -  --     - --   -     - - -   -    -  -  - -
-   -         - - --  -          -  -  - - -     ---   --     -  -- -  -  ---   - -   - - -   -   --
--          -     -   -- -   -   - - -   -  --   --        --          - - - -   -           - - - -
- - -  -- -        --    -- -       ---       -    - -  --   -  -    -   --  - -    -        --    -
-   --   -   -- -    --  -  - -  ---  -            -         -  -    - -   -    -    --   ---    - -
--    -         - - - - --   -      -  - -- -      --    -   -  -- -  -   ---  -  -  -- -   -      -
-  --   - -  ---     -    -  -  -              -       -     - - -  -           -   -  -     - - - -
- -  - -   -     - -   ----  -- --  - -   ---          -   ---       -  - -  --  - -       -   - - -
-     - -              -     -- -    -               -       - -  -  -   --   -  --   -   -- -     -
- --    -             -   - -          - -      -   -   - - - -    --    -  -   -           -      -
----------------------------------------------------------------------------------------------------
