100
100
----------------------------------------------------------------------------------------------------
-          --   -      - -  - - --- -   -     --    -  -- -  ---- -  - -    -       -    --  --    -
--- -  -- -       -       - -   -  --  -      - -    -         -       -  -- -- ---- ----  --  --  -
-    ---    -    -     -- - - --   -     -    -       - ---  - - - --   -   -  --      -   -- - -  -
---  -  --   --    -- -    - -  -  - - -----     -  -  -  -      --    -    --  - -- --  -     - ---
-  -     -     -   - - - -     - -       -  - --   - --- - - -        --      -        - -     --  -
-- -   --  --- -     -     -    - --   --     -  --  --- - -  -     -         -        - -  -   -  -
--   -   -     -   ---   -     -   -     - ---  -               ---    - -  --  - -        -   -   -
-  -- - - --     --  --      - -  - -    -    - - -  -  - -- - - -  -    - -- -   - -   - --   -   -
- -  -   - --     -  -      -   -- - - -   -    - ---     -   - -- -   -   -   -       -- - - - -  -
- - -- -   - --      -          -   -- ---   -  -    -  -    -   - - - ---    - - - -  -- -   --   -
- -  -- -   --     - - - - -  - - - - --    - - -  -- -   --  --  -      --         -  ---        --
--  ---  - -   -             ---   -     --   -           -- - - -      -           -  -    - --   -
-        - -  -  - -      -    --   -   -  -  -  --     --     - -- ---  --   -  -   -   -- -      -
- -  -    -  - --   -        -- -  -----        -     - - ---      -  -- -   -     -  -    -  -    -
-   -  -      - -   - -- --      -    -    - - -   -      - -   -           -    -  ---    ----    -
-   - - --        ----   --      -   -  - -- -   --- - -   -  --   --   -     -    - --- -      - --
-   - - -       -  -       - - -- -    -  - - -- -            -- -   - -- ---   -- - -  ---- -   - -
-   -   - -     --  -- -        -    --   ---  -  ---  -  ----    -    -   -- -     --    -   -   --
- -   -        --  - -- -  - ------ -     -   -- -     --   --   -  -             - - - -  -- - -  -
-  -       --      --  --      -       -     -   --  -   -   ---  - ----- -      - -  - - -  ---  --
-   ---  -  -  - -        -  - - - - ----  -  --        -   -   - -    -   --- - -    -     -      -
-  -        ---  ---   -   -  -    - -       - ---   - -      ---   -    -   ----  --  - - - -     -
- --    ---   - - -     - -    - - --    --        - --  - -- -  -    --   -    -         --       -
-- ----  - -- - -    ---   -   -   --  --  - --   -   --  -- -- - -     -    - - - -- -    - ---   -
-     -- - -  - -      - -  -- - -  -  -       -   - --    -   -     - --        - -      - --    --
-          --    -   -  ---     - -    -     - -----   ---  -  - -        -       - -     -       --
- ----          -  -         - -- --     -   -        -            --- -    -  -         -     - - -
- -           -    -        -    - -  -   -    - - - -     - - - -      -   -   -  --        -   ---
-    ---     - - -   - -       -   - --     -          -                -   -                      -
-  -   -  ---   - - - -    - -   -    - - -- --               -  -  - -  -       -   -  -    - --  -
-            -  --    --   -  -    -----   -           -- ---    -  -      -   - -  -  - - -    - --
-      --- -- -  -    -      -  -- -     -         -  -                   -     --                --
----  - -- -- -     -   -     -       -    - -  ----    - ---   - -     --   -    - - - -   --- - --
-     -           -            -- -  -   -  - -  -    --          --- -        -        -     -  - -
-    -      - - --   ---  - --  -        -- - -      -   -- - - -   ----         -  --   -- --  -  -
-      --  -  -  -- -    -    - - ----- -  - -    - - ---  --   -    -      --  --    -   -   -   --
-  -   -  -   -     - - -  ---      -       -      -      -     - -  - --       - - -   -     -   --
-   -   - - - -  ---  -  -    -- --  --  ---    -      - -           -      -     -    - -   --    -
-- - -     -    -   -- -    -   -  -      -  -- --          -   - -    -   -   - -  -  -   -   -   -
-    - - - -  - - - -    --      --     ----   -   -- - --- -  - -    - -    - -  -- -- -        - -
-   - -  -  --  --  --  -     -    - - - --  --   -   --     - --       ----           - --  -  -  -
-  --   --    -   -   -   -- -   -               - -    -- -   -     --          --- -- - -     -  -
- -- -- -  - -      -      -   - --   --   -          -   - --  -         -    -   -           -   -
-      -     - -     ------ -  --  -      -  -  -    -   - -   ---  --- --    --          - -      -
-    - -   - -    -- -       --  - --   --     - -- ------      - --       -          -        -   -
-   - - -    -- -      - - - -  -- - -  - - ---  - - -     -   -    --   - -  --  -       -        -
--- -   ---  ---  -   -- --      --         --   - --  -   -    -- -      --   -- -  - -      --   -
- -  - -  ---  -- -    - --  --    - -  -   - ---   -- - - -- - - -  --     - - -- -  - -      --  -
-  -  - -  -                --        -  -        --    --  -  --    - ---    ---  ----- --- - --  -
-    --- -       --     -- --     -   -- -  ---      --- -   -    --  -- - ---   - - --- -  ---    -
- -                 -     --  -  -  - -- -- - -                 -    --  -    -          - - ----  -
--    -  -    -      -      -- --        -     -     - - - -      -    - --   -        -   --      -
- - -         -     -- - -   -   -- -  --- -  -  -   -  - - -  -  - -    - -   - --      -    - - --
-- -    --   -  - -     - -   - -    - -  -   -      -       -- - - - - -           -   - -    -  --
-- ---    - -  - -- -  -  -- -    -  --  -  - -   -     -             - - --   --     --  -- -    --
- - -   --    --- -    - -          --   -   - - -  -  --     -  - --         - - -   - -     - -- -
-      -       - -    -   - ----      -    -  -         - -  - -       -    - -               -    -
- -      -     - -              -    -    -  -  -     -  -       --     -   -     -     -  -       -
-      -    - -   --   - -    -    -      -   --     -- -- - --- -    ---  - ---   -  -        - - -
-- -  -       - -     -      - -      -       -    --        --       -    --  - --- -- -  - - -   -
--    -          ---  --- -   -  -   - -      - -    --      - ----- - -      - -  -   - - --      -
--   - --      -       -       --- --   - -     -  -        -   - - --    ---- ---   -       -  -  -
- - -  -  -  -    -    -     -  - -      -- - -  --   -  --  --        - -  -    -              -  -
-- - -    -    -   --         -   - -  - -  -        -  -- --     --  - --    -  -- - - -  ---     -
-    -    - -      - -  - -   -             -- --                     -  -  -- -         -    -- - -
- - -  - - -   -    -   -   - --   -   -    -    -  -   -       - ---   -- -        -        - - - -
--   - - -     -   -  -   -    -  -- --  ---    --  -   - -- - -   --        -  - -        -  -- - -
-  -   - -     - -- -            -      -      -  -          --  -   -    --  -- ---  -  -   -   ---
-    ---- -  -       -         --- ---      -   --   -  - -  - -- - -   -         - -     -   - -  -
-  -- -       -  --    -    - - - -   -- - -  -          -  --    -- --     - -- -   --     -    - -
-   --    ---        --  -    - - --          --              - -     -     -- -    ---  ------ -  -
-  -  - --   -  --     -   - -   -    -- -- -- - --   -       -  -      - - -   --     -  -   -   --
-   -    -- - ---    - --  --  --   - - -    - -     - --- -  -       -      - - -               ---
-  - - -      -  - -    ---         -   -   -   ---- -    - -     -      -   -  --   --- --    -   -
- -   --        - -    - -       -  -  -  - ----   - ---   - -    -- --   --  - -    -  - -  -     -
-- - -     -        - -    -    -       -   -  - -  - - -  -   - -       -  - - - - ------ -  -    -
- -           ----   --    --    -- -           --                ---  -  - -   - --- -     -  --- -
-   -     - -  - -   --       --- -            - - --   -   - ---   - - - - --- - -  -  --       - -
---  -  - - -     - -     -  - - - -      - -      --     -     ---   - -  -  - -   -      -       -
-   --- ---- -    -     - - -  - -   -     - -  -   -     --  ------- -  --      -- -      ----    -
--   -    ---         -   -    - -  -   --   -     -  --  -   -     -  -       - --  -- ---    -   -
- - - -         -- -   -    - -  -    -        -  - --- -   -- --  -     - - -     -     -   - -   -
-     ---  -- --  - - -         -  -  -     -   ----   - - - -- -  -                    -   -  - - -
-- -  -   -  -     -      -- -  - -- -   - -  --    --  -  ---       - -- ---- - --  - --- -  -  ---
-  - -  -  - -  --   -   -  -   -    - -   --  --  -     -         - -    - - - --   -    -    -   -
- - --         -    -   - - --  -   - -- -  --  -    -  -  -      -  -    -         -    -    -  - -
---  - - --  --  --              ---        -  -  -        - - -  - -- -      --  --  -  - -       -
- -  -  -   -       -        -   -    -- -   -  -  --   - - -- -     -   -  -           - -   -    -
--       -  -     -      ---  --  -         - -     -  - -- -- -  -        --    - -- - -  - -- -  -
-- -   -- -  -        --    - - -  -  - --       - - --             -    --      -  -           -- -
-  -      -  --- -   --  - --     ---   -     -    - - -    -         ---    - ---       -   -     -
--- -               -   - --  -   -   -        -  -               ---  ----- --   -  - --  -       -
- -  --  - --  -  - -  - -   -  -  -    -- -   - -      -   -    - - -         - -  -     - - -   --
- - -    - - -  -    -  --     -  ---  -- --  - - ---          -     --     -       -        -     -
-- -- --  -     - - -    - - -    -     --     -    --  - - ---- - -  -           -     -  -     ---
-  -- ---     -   -         - - -- -     -    -   -      -- -    -   -  -  -    -- -    - -  -  -  -
- -   --  - -  - -        -   -             -  - -  -- - --  -    -  -           -    - -    -  -  -
-  -    --  - -    -        -            -  --   ----   -      ---     -   -      -  -     --   -- -
----------------------------------------------------------------------------------------------------
