100
100
----------------------------------------------------------------------------------------------------
-    ---     --     - --   - -     -  -             - - -  -         -     --   --      --         -
-     -   -        -    -   -    -  -  - -       -  -    -      ---    - --   --           - - - - -
-----  -  -      -    -   -- -     --  -       -      ---     -  -    -   --  - - -     -        - -
- - - - - - -- -    -   -  --  ----     -   --    -   -     -   -  -      -      -     -  --    -  -
-    - -  --   ---   - -  -  -  -    -    --- -     -- -- -     -  -  ---  - -      -  --   -      -
-  -       --  - -    --  -- --   -- -    --      - -  - -   -- -  ---         --   -   -- -       -
---      - -         ---          -  --  - -   -   -     - --  -   -    - ---   ---  --   - - -    -
---     -   -      --  -   ---   -      - - --        - -    -  -       -    -   - - - - -      -  -
--   -     -- - -            -  -  -    --       --- - -   - --   --   - -    -   -       ---      -
-    -       -         -- -        -       -     -   -    - -   - -       -   -   -          - -   -
--           - -       -  -      --  - -  -     -    -  -       --   ---   -    --   --- --  -    --
-   -   -  - --   -  - - -      -    -    ---    -- - --           -                  - - -        -
--  -   --  - - -     -  -    --   -- - -    --    - -    -    -    -   -      -  -  -    -  -  ----
- - --   -   - -  -    - -  -- --  -   -- --  -  - - -   -- -  -      --  - -  -      -     -      -
- -  -  -  -    -  -  -  -     - - -              -- -- -  -      -  -   --   -- ---- -    - - -   -
-         -     -  - -  -     -       -- -     ---     --   --      -  -       --      -   -- -    -
-   - -     -- -  -    -   --   -- --       ---   -      ---    -  --   - -  -    -- ---     -     -
- -      ---  -  --   -  -   -   --  -     -      -   -   -  - -        - -  -   - --          -   -
-  -  -            - -  - -  --- -  -            -   -         -  -  ---  -   -- - -- --     - -- --
-          -  -  -    -    ---     -  -  -        -     - -  -     -    ------    -        -   -   -
-   -       -    - - -   --   -  -- - -  - -   - -   - -        -   -   -     -   -- --    -       -
-     - --   --  ---       --  -    -   -     -    --- - -  ---       -  --   -    --  - -   --    -
-      -  - -    -    -   -     -         -- -- - -   --  -- -   -     - --  -   --         - -   --
-   - ---  -       -      -         ---      -     -   --   -  --   - --  --  -    - -       -    --
-  -     - --    -- - - -     - -       ---- - - -  - -  -   --- -      - -    -    - -       -    -
- -     - - - -  -  - -              - -       -    - -- - -  - - - - -     -    -            -   --
- --       -       - -      --- -  --       -   --   -- -    -          - -   -         -    -- -  -
- -   -  -  - - --- --   -   --     --  -  -              -   ----  -- -   -     - -   - - --    - -
-- - -     - -     - --    ---  --  ---     --   -     - -- -   - --  -  - ---- -      -  - - -- - -
-  -   -                 --  --  - -       -  -- -         --    ---- - -   -  -  -  -    - - --- --
-  - -  --      -- -  -    -   - -     ----  -  - -   ---- ---  -  -         -     --- -          --
--  --   --      --  --   -   -   ----    - -               -    -- -   -    - -  -    --      --  -
-    - ---       -  -       -   - -    --  --- - - - -   -- --   --   - ----- --    - -      --  ---
- -  --   -      -  - -      --     - -- -  --  -   -     - -      --  - - ---    -    -  -     -  -
- -   - -     - - -       -   --   --   - - - -   --  -               -- -    -    --  -           -
-  -   - -    -- -    -    - - --     -   -             --- -- - --     -  --  -  -  -   -- - - - --
-   -  ---- -    -     --    -   ---- -  -- --    -- - --     -      - -  -  - -   - - -  - -- -- --
-  --         --  - - -  --   --  -        -         --   -        --       - -- -     - - -     - -
- - -  -----  -   - ---             - - -    - -- - - --      -  -      -   --  --  --- -    --  - -
-       -    -    - --   - -                - -   - - -  -    -        -      - - -      - -  --   -
- --  -   -   --      --  -    -  -     - -   ---     - -        - -    -  ----   -  ---  - --   - -
-   -   ------ - -  -  - -    --   -- -     -     - -  -  -  -  -  --- -    ---   - -  --      - - -
-        -     - -  --- - - - - --   -    - -  --  -   - - - -        --        - -   -        -   -
---    - --   -----  -----   --    ---   -- -   -    - --- - -       -    -   -      -  --    ------
-     --  - -  -   - -- -- -     -  - - -  - -----         -   - ----  -   - -   -    -        -  --
- -   -  - ---    -      - -   -  -     - -       - -        ---  -  -        -     ---     --  -- -
- -- - --      -  --  -- - - -    - -  --  - -  - -- - --  -      -  - -  -        -        - - -  -
-  -     -    -  --       - -   -                      -  --------    -   --        --- -     - -- -
-    ---- -  - -   - - -   -  -  -  - -    -  -  -   -  -   -     -       -- -      --  ---        -
-      -  - - - -   --    -    -  -    - --    - -   -  -   - -- -   --     -- - - -    - - - -  - -
---      -      -   --  - -  -  -- -      -  - - --    -          --   - --       - ----     -  -  -
-  - -  - -   -   -        --- - -- -   -       -  -   -    -- - -      -       -- -  -   -   - ----
-- -- -    - -       - - --   --       - --   --             -   -- -     -- - -   -     - -     - -
-      --  - -          - ---- - - -        - --  -      -   ---- --  -  - - -  -       -    - -  --
-   -  - -  - -  -    -   -  - - -   -- -  -     -  - ---   -  -   --         -   -    -     -     -
- -     -   --  --    ------ -    --   - -     -     -   --- -   -    - - -     - -- - -   -  -    -
-     -   - --    --  - - - -- --  - --  -- -  -       - -  -   --           - -    -  - -- - - -  -
--  - - -      -        -   -             - ----             -    -- - -   -        --- -  -   -  --
- -    -    --- -    -        -  -     -       - - -          -    -    - -    -  -    -           -
-   - -    - - -    -     - -- - -- -  - --   -   - -- -    -- -      -   -      --        -  - -- -
- -   -  -   -  -       - - - - -   - - -- -              --   --      -   - - - - ---- -          -
- -  -      -   -  -       --  - ---    -  -  -  -- -     -      --  - - -  -  - -        -     ----
-      -- -     -     --  -       --  -  -  --     - -     --- --    - - -- - -   -  - -  -      - -
-----   -    --  --    -  -- -  ---  - -   --   --  -   - -  -        - -  -  -    --   -  -   --  -
-     - --       -- ---       -         --  --   -  ---    --  - -  - -  --   --  -   -  -  -- -  --
- -          -   - -     - - --- --  -    --         - -    -                     - - --   -- --   -
- - --  --       -  --   - - -  - - - ---  -     - -- -     --   -    - - -               - - - -  -
-   - ------  --- -   -   -   -----     - -  -  -  --  - -                 -        - --      -  - -
--                 -   - -  -    - - ---- --- -   -- -       -  - - -   - -    -     - --  - -     -
--    --  -   - -     -  -  - -  -  -    -  -      - ---- -     -      -- - -   -- -   -   - ---   -
-    -      - -         -- -  -- -   -   --- -  -- -   -      -- -    -   --    - --   - - - --    -
-  -    - -- -   -       -  - -   -  - --  - -    -- --- - -   -    -       - -         -   -   - --
--  --  - - - -  -  -  - - --     --          ---     -   - --   -- -  -- - --   -  -              -
- -  - --   --  -- -  -    -    --  - -     - --         -   -   -    -      - ---   - - -    -   --
-     - -      -   -  - - - -          - -    -- -   --       -      --  -   -     -- -        - - -
- - -   -        -       -- -   ---        --- ---     -  -    --- -    -   --  -   --    -       --
-     -- -  -     --   -  -    --     -  - -  -  -- -    --  -   - - - -       -- -    -       - - -
-  -       -  -  -   -     -  --  --  - - -   --   --  --  -  -     -        -             - - --  -
-   - -  - - --       - - - -      -           -  -      -   -   - -     -  -- -       -   -- ---- -
- --   -- -     - -- --- -     - - - - -    -  - -      - --           -  - -  - - -    -     - -  -
- - -- -     - -         -  -     - ---- -       --  - -   -  -      - -    - -      - -    -      -
- -    - --  - - -  - -  -  --   --    - - - - --       -  - -   - -- - - -   -   -        -       -
- - -    -   - -- -  - -- ---  -  --  -   -   -    -   - -  - -- -- --- -   - -  --   -      -  -- -
--  --   -       -    -- - -  -  - -    --  - ----  -- -    -    -     --      --  --  - - -  -   --
-    -     - --    -          -- -   - -   -   -  -    -  -         -- -    - --     --   - -  -   -
-   -        -    -    -  - --  -     - - --  -     -- -     - -  - --   -      ---  -  --   - - - -
-  -   --- -- -  -  -         -  -   --  -   - --   - ---  -       -  --     - -  --   - -    -    -
-        - -- -       ---    - -  - -             - -  -   --    -   - --     -                  - -
- -     ---  - -  ---   -  -  -   - --   --  - - - - -     -    - -- - -   -   -  --- - --      -  -
- --        --    -- -  -      --  -   -- --   -   -    - - -- -   -  -      - -  -     -      -   -
-   -    -    -  -     -  --- - - - -- --    - --     --   -  -- --  -    -- -      - - -    -  -  -
-    --      - -  -  -  --                    -      -   -  -        - - -       -        -  -   - -
- -     -- -    -   -         - -      ----  - -----  --   -  -   --  -   -    - -        - -    - -
-   -  -- -      -   -   -   -   ----  -   -     -  -- - - - - -      - --  -     -  -  -      - - -
- - -   -     -      --  - ----  - -  - ---    -  -    -     -   -- -   -     -   -     ---        -
- --   - -   - -       - -       - - -     -  -  -  - -  -  -    -   -   -- -               ---    -
- - -       -  --- -     ---   --    - ----     -  -      - - -  -  - - - - -   -   -  -  - -  -   -
-   -  --    --  --  --      -   -  -       ---    --     -  -  -   - --         -     --       -- -
----------------------------------------------------------------------------------------------------
