100
100
----------------------------------------------------------------------------------------------------
-   -        -        - - -  -       --     --  -                -        -  --     -- -      --   -
-   - - -  -- -   -  - -  - --   ----   -      - -    - -  --  -  -   --   --  -    -  -  --  --   -
-    -    -  --  -   - - - - -  -   --    -      -  - -   -- -- --    ---    - - -----          - --
-      - --   - - -  -             -     -   -- --    ---- -        -        - --   -  -     --   --
-    -   - - -- -         -- --     -  -    - -   - - - -      - -     --        ---    -       -  -
-  -   -      -      - - -    -    --    -      - - -     -     --  -  --- --  --  -   - -- -  -  --
--   --   --- -         -   -  -     --    -    --      - --  -- -      --   -- -       -          -
- --   -  -          -    - -  --  -    --    - -  -  -    - --      -  - --    --    ----  -      -
-- -- -     -- - - -- -- --  -     -   -   - - -   -  -          -    -   -- --     -- -    - - - --
-  -   -  -      -- - -     - - -  -       -  -         -      - -   -  - --   - --- - -   - -- -  -
--  --     --       -    -  --- ---        - - -     -    - -  - --  - --       -- -     -         -
- -     -- - -   -    -       -     -        -   -    -- --           -     -    -- -- -  - -- -  --
- -----      --         - -- -    -    ---          -       -  - - -  ----  -- -   - -   ---     - -
- -  -    --  - --   ---     -  -  -  --    ----         --- -   - - --    --    -   - -  -  --- - -
-   - --  --       -     ---  -     -- -  ---      - -        -  -- - - --    -- --  -      --  -  -
- --    - -   - - -   --       - -  -     --  - - -     - -- -      -  -   - - --     - ---     - --
--    - -  -     - ---   - -            -    -- -- ---       -      --  -  - - - -  -   -  --    ---
-   -  -  -   -         --       --  -   - -     - -- - - - -  -- ---- ---- - --      - - -        -
-        -   -   -     -  --    - -- -  -   - --  -  -         - -  - - - -           -       - -  -
- -  -  -  -   --  -    -   -  --    --    -- -   -   - - - - --  -   -   -  - -         - -       -
-      - -   --       -   -  -   -   -  -   -     ----       -     -   -   -- -  - -  - - -   -    -
-         - - ---    -- -- --- -- --            -      - -  -  --- -  -------    --    -    -   -  -
- -- --  - -     --        ----       ----  -  -    - - -        --  -      -     -     -  -  --   -
-  -    --  -      --   -         - - - ---  -- - -                   -  -    - -- ----  -    -  - -
- -  -            --  -  -   - -      --          ---- --  -    -     -- -    - - - -     -       --
-  - --   -  --       --- -  -  -    -  --- -                    -   -- -  -  -    -  ----      -- -
-  ---       --   - --     -   -           - -   ---    -- --    ---   -    --  - -         -  --  -
--     - - -   - ---   -   - -  - -  - -       ---         -  --               --    ---      -    -
-   -- --    -- -           - -  -      -         -- - -      -                  -      -  - ---  --
--      --    -  --    -   -       -    --   - --      ----          -   -     -   -- -- - --      -
--   --   -   -  -- -- - -         -  -       -  --           -       -      --   --  - - -  -  -- -
--   -   -  -      - - - -   - - -      --     -  --      --  -    ---- -      - - -    -   -- -----
-   --    - -   ---      --    - - - -   -  -    -- - ---  -     -      - - -     -  -- - ---      -
- -     --   -         -      --       - - -- -    - - -     --  -    -  - --   --  ----  -  - -- --
--  -      -     --  - ---          -  -   - --       -  -      -        ---    ---                -
-- -  ---- - -      -   - -   -  -- - -- -      -- ---   - ---   - -- ---        -    --  -    -   -
-  -    -  -   ----     -       -  -       ---  - -   -  --             --    - - -- - - -  -  - - -
--     - -- ---  -   -   --- -- - -    ---   - -   - -- -- --       -       -       - - --  -      -
-  --     -  ----    - -          -   -     ---   -     -- -      - - - --  - --  -   -- ---  --  --
-- -  ---             -  - -  -      -  -  -  - --      --  -  -  --     - -  - --             -   -
- - -  - -    - -   ----- -  - - - -      ---  -   -    -    - --       - -   - -     --   -   - ---
-   -      -   -  -   -     -     -- ----- - -      -   -- -     ---   --  --     -     -         --
- -  -      -- -   - -  - ---  -   - - - --    -  - - --  -  -        - -   - - -     -  -     --- -
-  -  -   - -   ---   -     --     - -- -  -      ---    -      --  -    -- - -  -   -  -  - -  ----
--  -   --  ---     -  -  -         -    - -    - --  - -   --      ---    - -           -         -
---  -         -- - - --      -- -    -    - -      -           --- -  - -       - - - ---   -    --
-  ----     - - -  -    - -     -   -   --     ---     --- -  --    -        -           -    -    -
-      -    - -  -----  -        -   -      --       -   -      -     -  --   -   -  --   - -   -- -
-   -  - - - -  -   -   - -   - -     -   - -  --- -          - - --  - ---  --  --   --     -   - -
-          -- - - -- - -    -   --    -     - -   -      -         -     -      -     -  -    - -  -
-   - -- -    -    -     -   -- - - -- -  -- - -- -  - -   -- -       - - --     -- -   -    -- - --
- - -  - ------   -  -  -   -  --   - -  -    --  -       -   -  -    -     -    - -   -   -     - -
-     - -            --      --     -        -    - -        -     - -   - --   -          --  - - -
-- -   --    --    -- -- -   -        - - -    -    - -   -  -   -   -  -- -   - --     -- -  - -- -
- ---                      -     -       - --  -    --  -       - ---         - -   - -            -
-- -    --  - - -    --           -  -       -  -        -         -     --  -           - -   - - -
--  - - -      --     - --   -  -    - --   -   -  --   -        -  - -   -   --   - -           - -
-  -   -- -   -              -      - - - - -       -     -  -    - -  - -  -        -  -   - -  - -
-               -- -- - -  --          - -  - ----     -   -      -    -    -- -   --  ----- - -   -
-  -  -     -- -  -   -  --              - --       -     - - --  -        -   --  -    - -- -     -
-  -       - - - -    --    - -  -  -  -  -   - --  ---    -   --  -   -    - - - - ---   --  -- ---
-- -  --  ---   --    - -       -             -   -   --   -  -   -   -  - -    --         - - --  -
- -- --    - - - -  -   -  -     - - -  -    -       -   -  -  --        - - ----    --  - -- -  - -
--       -  -  -     - -  -  - --  - -- - -     ---  --     -      --  -   --      --      - -  -- -
- - -        -    - - --     -    -     -   - - -         - -    -  -   -        - - -   --    -  --
---      -         ---    --    -- -  - - -     --     -- - -   - -         -- -   --  -   --  --- -
--     - -    - -  -  - --   -      ---      -     -     -- -  ---               -    -       -    -
-- - -     -    -- - -    -   ----    - -  - - -- - ---               -     -   - -    -      -  - -
--       -  - -  - -  --   ---  ---   -- --              -- - - --   --  -   - - --    - -   -     -
- -- - -  -   -  -   -  -    - -----  --     -   ---  -  - - -           -   -   -  - ----     - - -
-     -  ----   - -  -  -  ---      -  -    - --  -- --   - -  -  - -      - -      --  --  -      -
-  -         - - -- -  -  -      - - -- - -  -  ---   - -       --   -  - --      -   - - -  -  -  -
-- - - -----   - - --   --   -    - -   -  -  -- - -      --       -  -    - -         -   - -    --
-         -  -     - -   -- - -- -       -    -        - - -   -    -     -- - -     -  -----      -
--    -         - -- -  -- --     -  ---  - -  -  -- --             -  -  --   ---     -   -   -- --
---   -  - -   --   -  -    - -    --         --   -      --   -  -  --        -    --  --- -     --
-           - -- --  -- - -  - -   -       -     -   -  - -- -  -   -      - - -  -   -     -     --
----       - -     -- --   - - -  -  -  - -      -    -            --  -   -  -  -          - -  - -
-  -      - -        --         -   -            -   --     -        -    --      -- --  ---  -  - -
- -      -   -              - -     -      - -    - -   ---  --   --   ----  - --      -    -    - -
-  -   - -  - --- --               ---   --   - -  -- -      -  -        - -        - - ----       -
-     --   ---   -  - - - -   -       -     - - -    -         -  - ----  --- - --    -    -  - ----
- - --           -    -    -  ---   -  -    -      - -       - -- -- -   -  --    - --   -- -  -   -
- - -      -        - -  -       ---    - -     -   --   -- --    -     -     --     ---   -   --  -
- --  - -      - -    --   -         - - --   - - -    -  - -  - --- -   - - -     -       --   -- -
--    - -     -- - -- -       -      -     -  - -   -    - - - - --  -    -  -   - - ----  --   - --
- - --  - - -           - --  --  -- -   -    - -       -   - -   - --  - -- - - -   -  -     --  --
-     - --     -    -- -  -  -  --    -   -     - -- ---      -         --     ---  -  -  - -     --
- -        --      -  - --     - -- --    -    -       - - -    -    -     --     -       --      --
- -  - - -   -        --   -            --   -   - -  -    -  -   -- --- -  -- -    -     -- -  -  -
-   --   -  -   -       -- - - --  -    - --     -      -- --  - -  -      -  - - -       --      --
- -      --   -      -   --      -      - -   -   --   -   --- -- - -- - --    -          -- -   - -
-    -     --        - --   -    - - - ------     -  - - --     -  -       -  -   -  - ---  -- - - -
-        -  -- -   -       -    -  -      - -- --- -   -   -      - - -- -- -  -    -  -    -   -  -
- - - -     -  -- - --- -   - -  -   - --     -  -     -    -  -- -    -        -     -  -  -     --
- -         --   --       -   -        -   - -       --    --- -    --- --- - -  --   -  - - -- -  -
- --     -- - -   - ----  -    -   -- - -  --  - -  -   -      -- - -     - -   - -         -      -
-  -   -    -   -                -     -   -       -   - --  - -   - - -   -     --  -             -
----------------------------------------------------------------------------------------------------
