100
100
----------------------------------------------------------------------------------------------------
-        - - - -   -  -     - - -    -          - - -     -        -      -    - --  --   - - -    -
- --   - -  -       -      --             --  -   -   -    -    -            - - -  --   -    - -  -
-- - -- - --  -   - -        -  -- -  -             --        -     - -  -  -  - ---  -     - - -- -
--     - -   -- --- -      -    -           - - ---          - -  - --  -- -  ---    -     -  - - --
-  -- ---      -  -     -  - -  -      -     --  - --- ---        -    -    ----  -- -    -  - --  -
---   -  -       -- --- --   -     -  ---     -  -       --  ---  - - -  - --   -       -   ---    -
-  - - -     -              -   -                   --- -    -   - -  --- -   - -       -       -  -
-      ---    -  - - -   ---   -  --  ---           -   ---  --             -      - -    - --   - -
- --- - - -     ---    -   -   --     -   --     -   -  -  - - -     -    --  ---      ---     -   -
-    - -   -  - -  -     -- -    ----- --  -    -   - - - --        -     - --   - -     - ---     -
--     - --   -       -   ----  -  - - --- -    ------ -  -   -  - -- -  - -  -   -  -    ---  - - -
- - -          - - --    ---        -- -      -  -    -     -  - -       - - - -       --  --  -   -
-     -   - --   - - ---     - ---       ---   -    --   --     -   -   -- -    ---     - --   -   -
- -  - - -   ---   - -     -     -      -     -    -        ---   - -- -      --   -- -- -----  - --
-   -  - -          -      -   - -    - --- -       -    -      -       -- -  - -      -- -    - - -
-         -- -- - -  -       --- -   -    - -  -  --    - ---- -     -    -  -   ----  -    -  -- --
-- - --  -     -  --   - -- -    --       -  --- - - - -- - -   -- - --        -   -      -  - -   -
-  - -    -   -        -    --  -   - -  -  ---  -  - - -          -  -     -- --        -       - -
--    -- -     -  --   -              -   --   --          -    --  - - -          -- -  - ---- -  -
--   -      -   -      -   ---   -- -   --  --      -  -- -   --     --    - --   --   -  - -   - --
-   -  -- - -   - - - - --- -      -  --      -    -          --        --  -  ---    --     - --- -
-     - --     - -    --   -  --   -   ---    - -               --  -- - -   -     -            -- -
--  -                 -     -     --  -  - --   -  ---               - - ---   -- -   - --  - -    -
- -- -   - -        -     -  - --  - -  ---  --    --       -     --           ---  -      -    - --
-  -         - -  -  --  - -- -  -    - -  -  -    -     --     - - -   --  -   -  - --- -  -  --  -
- -        -  -        --       - -    -   -  -  -   -- -     --  -  --   -         - - -        - -
-      - -- ---   - -      -- -    - - -     - -       - - -     - --  --   ---   -   -  - -   - ---
- -     -    -- --  -  - - -   - --   - -  - - - -   -    --      -   -  --   - - -   - - - -  -  --
- -       - -     --- --    -   -  ---    - -  - -        - --- -   - -  -         -  --  - -- - ---
-            --      - --- -     -   - --    ---      -    --  -  - -   --      -    -  - -        -
- --  -- -   -----        -   -     -        -   -   - -  -  -  - --  --       ---         -     - -
--   -    - - -      --  --   - -- -    ---        -    -    ---   -    - - - - -  -- --     -  -  -
-    -   -   -  - --    -- - - - ----   -   --- - -  ---   ------     -       - -   - -  - --- --- -
- -        -   -     -  - -             -  - - - -   - - - - --         -   --  - - --      -    - -
-  -       - -- - -   -- -  -  --  - -- -    -     - -    -      --   - -   - --         ---   -   -
-     -       -    - - -  ----  -    - -      -    -- -     --- -     -   -  -   - -   -        -- -
- -   -- -    -  --       - -   -- -    --         - -   -    - -      --   --       - -  -   - -  -
-   --   - ----   -    - -            - --   -  ---       --       - -  --    -- -  -    - - --    -
-  - - -              - -     - -  -    -    -    - -  - -- - --    -  -      -  - --        - -   -
-     -- --  - -  -       -     --  --   --   - --       -    -  --  --  -- --- -   -    -  --    --
-  ---  - -  ----   -         -  -  -  -  -  --   ----- - -    --- -  -       -      -- --  - --- --
--       - - -  - -   - -   --- -      --  -   - --   -  -    - -   -      -   -          -   -   --
- -   -        - --   --  - -    -   -  - --    -      --- - -   --   -----  --      -  -  -  -  ---
-  -  --     - -  - --          -    - --  -   -   -  - -   -- -          -  -  - -    -    -   -  -
-- -    -    -- -- -     - -  -  -- -       --     --    -      --      --   - - -       --        -
- - - -      -     - -   -    -  -    -   --   --   --  --    -- --   -- -  - -     ---   -     -  -
-   -  - - ---     - - - -    - -  - -     -  -  - - -   --       -        -     --  -  -   -- - - -
- - - - -     - --     - -     -     -     -  -    -  - -- -     -  - -    -  - - -  - -    -      -
-  -- - ----   - -  --   -   -  -  -   -      -    --        -  -- -    - --  --  -      - -     - -
-     -   -  -    -   -    - -- - -   - - -   -   - --     -  -        -  --- - -  ----       -    -
-    -     ---   -- - -  -     -   - -  - -      --   - -   - --  - -  - ---     --      -  -  -   -
- -  - - ---        -    -     -   - -      -      --     --    -  -  -  ------  -            -    -
-     -     -    -           -----     -    --   -     -    ---   - -             - -        -     -
-     -  -   -- - -   ---     -        -       -               ---- -  - ---- --       ---    - -  -
-- - - -    -    - --           -           - - --       ---    - -       --    -  - -  -   -  -   -
- -          - - -- - - -          -  -     - -         -   - - - - ---        - -        -  -- ----
- -- - -  -  -     -           -       --  ---           --- -        -   -  - -         -       - -
-    -   -     --   -   - -     - - --- -     - -    ----   -- -   --     -  - -         -         -
- -       - -  -   -              -    -   ----       -  -   ---      --  -         -  --    -  - --
-   - -            -      -  -  --    -  -  -   - - -  --        -           -   - -      - - -    -
- -    -         --  -    -  -  - -                -   -    --   - --  - - -  -   - -        - -   -
-- --       --   -  - -   -   -  -   - -        ---    - -       -   - -- - - -    -   - -         -
- - --  - --   -    - -  - -          -        -   -      ---   -         -    - ---  -  - -  --   -
-- - -  - - -   ---  ---   -         -  - --- -     -  - -  - -  ----   - -- -    -    - --        -
-   - -             --         -        -   --    -  -    --  -       -       - -  -  -    ---- -  -
--       - - -      -- -  -   ---- - -  - -    --    - - ----    ---     --         --  -    -     -
---- -      - -    -      - -     -   - -   ---   -        -  --- -    -- -         -  -   -    -- -
- -  - -          -  - -  --     -    -  - -          -     - -     -  -  -   --  --  - -     -  - -
--     -     -- -  -- -    --   - --  --        --        - -   - -    --  - -  -      -- - -- -   -
--       ----  -  - -      - -         -  - -        - --      --  -   - - --   -   -        - -   -
-  -   --  -     -  -- ----- - -- -  --   -  --- --- -  --  --  -    -  --      --   -  - -       --
- --             -      - --    -   - - -- - -    -        -      - --  -- -  -   - -- - -       - -
- - - -   -  -  --   - ---        - - - --    -  -   --    -   -   - - -   - -   - -   --  -   -   -
-  --     -      --  -------   - -  - --  -   -   -      - - -    - -   -        - - -- - - -    - -
-    - ---  - - -- -       - -   - - --    - -      - --    -   -  -  - --- - -     -  -  -  - -- --
-  -        -- -    - - -    --    --   -   -  -          - ---       - --  --- -  -     - - -     -
--    - -    - -    --  ---  -  -     -   --  - - --  -    -   - --  - -     - --   -   -  -  -  - -
- -   -        -    -    --   - -   -        -         --    -   --      -     -  -        ----    -
-           -     --  -  -   - --  --   -----      --    -  -  -    -     - -   -   - -- -   -     -
---   -- -  -- -     -  -   -- -- -  ---  -  - -  -        - -- - -     ----- -   - -     --  -- - -
-          - --  - -  -     --     -    -   -- -        -  - -  -      -  -   - --- -              -
-     -   -    -    -        -        -  - --       -  -  ---   -   - ---  - -   - --    - -  -    -
- -      - -  - -   - --   -   -        -   ---- -    -  - - -     -   -   -       -  --       -   -
-   - --      - - -  -     -    --  -   -       -   -   --   -  --      - - -- -  -    -  -  --  - -
---   -       - -    -  - -- --   -  -       -- ----         --      --- --     -- - -    -- -- - --
-  --    - -- -       - --  --  -     -   - -  -         --    - ---  - -    - ---     -     -  -- -
---    -- -     -   -     -  - -  - -    -- -    -  - --- -----             - -   -  - -  -    -   -
-    - -    -    - --- -     ---  -   -- - --           --   -  -- --      -  -     - - -  - - -   -
-     -  -       -    - ---- -    - -     --  -  -   -    -  -               -  -  - --   -    -   -
- - --  - --  --  -       -   - -  -  - -    - - -    --      -   -         -     -  - -    -     --
-  -- -   - -    -  ---     --   -- ---    ---    -    -   --  - - -    -    -   - - -   -         -
---   -   ---         -   --            - - -   ---  --    --  -   -    --  -      -  --      --   -
- - - - - -   -     -      -- ---      ---    --    -  -  - -      - -    -   -    -  -    --- -   -
-   -  --  -   -  -  ---   - -           -  --    -    -- -- --  - --  -   -- -      - - -  -   -- -
-  -  -  - --  -- - -         --- - -        - -- -  - ---   -   --   --   - --    -     -     -   -
-      -         -- ------      -     - --  -    -  -  --  -  -         -  - -   -  -          - - -
--    - -  -     --  -  -   --        -     --  --      -   -- --- -  -     - -     --  -    --- ---
-     -      -   -  -  -  -         - - -   -  -   - -  --        -   -    -  - -   - -    -   --  -
----------------------------------------------------------------------------------------------------
