100
100
----------------------------------------------------------------------------------------------------
- -   -      -      -         -- -   - -- -  -       - -      -  -           - -  -   -   --- -  - -
-        -      --   -  - ----   -         -    --     -     -  -  -  - -     -     -    -  - - - --
-    -    - -     -   - -   -  -            ---     --     -   -- -- - -    ---  --   -   - --   - -
- -    -  -     --- - - -     -     ---   -    -     --    -  - -    --          - -             - -
-      - -    -  - -     -- -- -    -       -  -       - --  -   -    -      --   - - -- --- --  - -
-    --   --  -  -  -   -   - - - - -   ---               -   - -    -- -  - --     -     -    --  -
- -- -  -      -- -  -   -   -    - --      -- - - ---   - -  -   - - -      - -    --   --   -   --
-          ----      -        --- - --  -  -    --   -    - -    -   - -   -    --- - - -  - --    -
-       --       -      -    -   - - -       - -      -   -   -  -  --  - -   -- -       -    -   --
-    - -      -     -  -   -     - -  --  -        -   -    -     -  --- - -   -   -  - -   -- --  -
-   -  - -  -     - -   - - --     -  -    - -  -   -        - -  - -   -     - -             -    -
-    --      --  - -     - - --- - -    -     -- - -  - -- -- -- --   -- -  - --  --- -    ---     -
--- -    -  -  --    - ---       - ---           --        -      -   -- -       -    -        --  -
- -   -         - -  - -   --  ---     -   -   -       -  -  - -  - -   --  -- -   - --   ----  -  -
-  -       -  -   -       - - -  --  -   --  -   -     -   -     -  -    - -  -                   --
- --  --- -    -      -              - -    - -     --   -  --     -     -    - -  -       - -    --
-      --  -  - - -    - - -  - -  -        -    --     -   -  -  -  -  -- - -   -- -        - - - -
-     -  -      --    -  - - -  - - -  - - -- - -          -  -  -  -          -  - -    --  -     -
-      ---   -  -          - --  -- - -        -    -  - --   - -  -  --   --    - - -   -  -  - ---
--  -   --  ---  -  -  - - - ----          -- - - -     -              - -   -  - --   -  -   --   -
-- --- - - -- -    -   -- -      -   - -  -   -     - -    -  -  -  --     - - - -  -- -    -     --
-       -     -  - -    --  --  -         -- ----   -    -       ---- ----    - - -    --  -    -  -
---  -   ---  -      --   -   --   - -  -   -    -        - - -      - - -   -       -  -    -     -
- - -       -- --   -      -- --  --  -  --          --  -   - -  - -         - -  ------  -      --
-- -    -- - -   -   - -   -   - - -  ---- --- -  -         --    -    --  -    - --- -     ---   --
- -    -     -  - --     -   -  --- - -  - --   - -  -   -     - - - - -  -       -   - - - - - -  -
--      --- - -     -    -    -      -    -   - --  -  -  -   -        --- -       -    -  -     ---
-  -  - -   -  -   -    -  - - -     -       --  -    - - - -             -       - --     - - -   -
-  -- --  --  -      - -     --    --   --          -    -   -       - - -     -   -  --    -   -  -
- - - -     --  -  --   -   - ---     -   ---   - -      - --           -  - -- -  - -      - -    -
- -    -  - --   -     --  --  -          -   - -     -  -         -     --    -  -- -     --  -   -
-   -- - --  -        -     -   --   --      --  -     -   --       -  -  -      -- -   ---     -- -
- -   --       -     -        - ---    -   -   -   --  - -   - - - - --  ---  -      - --   - - -  -
- - --     -   - -- -    --- -- -        --      -      -     -       - -----      --- - --  ---  --
-  -        --  -    --  -  -  -- --  --    -    -   -    ----- -      - --  -  -        --     - --
- --       -   - - -     -    -     -    -  --   -              - - -  -  --        --     - --    -
-   - -- -  ---     -    - -      -  --     -     -  -    -- --- -  - -   - - -    -    -- -   - - -
-- -  - --   -  -       -           -         -  -  -   --         - -   -   -- ----    -  --      -
--  - -- -  --  -        --    --   - - -      - -   - -  --- --  -  --    -  --  --- - -  - -  -- -
-    - -  -  - - -     -  - - -   --   - - --      -      - -    - -         -              -  --  -
-    - -    --      -- -     --  --     ---     -- - - -  --  - - --     -   ---- - ---   -- --    -
-- -   - -  -  -    -    ---- -- --  -- -  -    -    -     --   -     -  --      -    - - ----  - --
-- --    - - -- -     -  -      -     --  - - -    --  - --      - - -- - -  ---   - -   -        --
-  - ---  -     -   -  - -   -    --- -    -  - ----   --  --               - -       - -  --     --
--  -     -   -    --      - - --    --    - - -  -- --   -   -   -   -           -  -  -- - -    --
-   -  -- -  --     -  --  -  -     -  - -  -       -     - - - --    - -  -          -   -        -
-- -         - -    -- --   -  --  - -   -        - - -       - --        - - -  -     -         - -
-   -    -   -   -        -  --            --       --    - --   - -   - -    - --    -    -  ---  -
--  -  - -   - -  - --        -   -  -      --   ---   --      -             - -  - -  - -     - - -
--      -  - -   -       -  --    -   -- - - - -  - -   -   -- -- -  -     ----  - -        -     --
-   ---   -- -  --  - - -        -   --      --   - -- --   --   -   -   -      -  - -  -   - --   -
-  - -   -     -- -      -     -      - -    --  -  -- -  -    -  -- -     -     -    - --  - --   -
-  ---   - - - --  -  -    ---    - --    ---- --  -  -----  -  ---      -- -- -      --    --   ---
- -     - -     -- -     --          -  -        -       -     - -         - - -       - --       --
- -     -   -  -    - --        - --     ---  - -     -   ---  -    --  --  -- -  -  - ---  -      -
- -      - - -- - -  -  -   -  - - -          --   -    -- - - -  -    -  -            -    -      -
-  -    -       -    ---  -   --      -  -- --   -              -  --      -   ---     --    -   - -
-         - ----   - -     --   - - - --         - -- -  --    -- -  - -           - -    --  -    -
-   - -    -  - -  -  --             - -   -   -  -   - -   - -     --  -   -       -- --    - - - -
--  ---     -  -           - - -  ---- -  -    -   -  - - - --   - -    -          -     -   --  - -
-  -  - -     -   -     -  -- -  - -     -   -    -  -   -  --   -- - - - ----   - ---      -  -   -
--  -  ---- -   - -   -- -    - ---  -     -      - - --- -   -       - -- - -   -  -  -  - -  -  --
-  --- - -     -        -      -  -- - - --  - -    -   -- -         -    --   --   --  -  --   -- -
---   --- -- - - -- - - - -    -  ----  - -  --  -- -   -- -  -  -- -  - -   ---       --          -
-   -  -  -    -      - -   --   -       -     -      -  -  - ---  -    - - - - -  - -     -- -  - -
-  - -       -   --  - --  -       --   --   - - -  -   - - -        - --   -       -   -       - --
--    -    -    -  -   - -   -    -  - -  -   -  - -   -   -   -                 - ---     -  -    -
-     -  -  -       -     --- -   --   -    -    -      --     -   - -  - -  -     -    ---     -  -
-    -     - -  -    - -  -  -    -  -   -      --- - --         -   -    - - -  -  --     -  -    -
- -    --      -  - --  -- - -    - -    - --  -          -   - -     -  -- - - -  - - -    -     --
--           --    - --      -    -       -  ---- -  - -   -      -     - -- - - -     -       --  -
- -  -      -   -    -   - -- -  -- - -  - -       -   --- -        - --  -  -     -   -  - --     -
--     -   -- -      -   -     - -     -- -     - - -      - -  -  -   -         -     - - -- - -- -
-  - -    - -      -  -----            - -   ---       -   --  -     -   -     -   - --  -   -     -
-  - - - -  -    - -- -       - -      -  -  -    - -- --        --           -   - -    -- --  -  -
- -- - - --- -  - --        ---   -  --  - -     -  -  -  -   ---      -   -     - -   - - -   --  -
-- - - - -     -   -   ---    - -      -  -      -           -    -      -  -  -- --   -      -  - -
- ---   - -- -  -   -         -     -  - -   -   - -  -    -     - - -    --- - - - - -        -- --
--     - -        - --- -  - --    -   --     -  -  -        -        - --     -   -  -  - - - -- --
-  ---  -    --   --           - --           -- -   -  - -     --- -  --- -     ----     - -   -- -
--     -  - - -     -      -    - -    -  ---   -- - - -   -  -     -    -   - -              -- - -
-  -   - -  --- - - -      -    - -      ---      -  - --- -    ---   --  - - -   --- -       - -  -
---  - ---  -  -     - -   - -- -      --     - -   - - - - - -  -  --   -  -   -     -- --- - - ---
- -- -  -   - - --     - - - -    -         -   - - - -     - -   - -   -  -   -  -- --     - -    -
-     -  -- -   - -- -      - --  -    - - -        - --    - - --       - --   -   -        - -  --
- --   -  -      - - -   - --    -  -  - - - -    -      --    - -- -   -  -   - - -  - -         --
-   -    -   - - - -  -           -   - - --     --       -         -  -  ----- -     ---    -  -  -
-- -  --  ----    -  -     --  - -      -      -  -  ---        - -- --     -- -- -  -   -  -  -- --
-- - - -    - -  - - - - -             -- --    --    --     - ---  -     --    --  -   -        - -
--    -   -       -     --  --    - -  -          -     --    --     -- --      --   -  -- -   - ---
-  ---- - - - -- -- -   ---     -    -        - --  - --   -   -        - -- -- -        --        -
-- -     -         -    -  - ----   -       -    -      -    -  -   ---   - -   - --- -  - --      -
-  -      -  -- - --    -      - -  -   - -   - - --   ---  -       -      ---  -- - -   -- -  - - -
-    - -     -   -- - -    - -  --   -           -----     --       -    - - --    -   --     -   --
-        --  -       - -  - -     - - -       --     -   - - -  -      - - -    -  -  -     - -    -
-                  ---      - ------ -           ---      -  -      -  -    -    -   - - -    - -- -
-  --      --- -         - -   -  - - --  --   -  -- -   - -     -  -  -   --  --   -- --  -- -   --
- - -        -    -  -     -   ---  -      - -      -    -  -        -     -       -     -    - -  -
----------------------------------------------------------------------------------------------------
