100
100
----------------------------------------------------------------------------------------------------
-        -        -       -         - -      -      -  -   -            -    - -     --  -       - -
----  - -      -  -       -     --     -  -  --          - -       ---- - -  -    -    -- -  --- - -
-  -      -   -  - -  - --   -  -  -  -         -  --  --     -   -        -    --  -     -   -   --
-- -  - -  -            --   --  -- -- --    - - --  --  -    - -  --    -- --  - - - - --- -      -
--  - -    - -        -   -                -- - -  ---    --  -  -   - --  ---  -  - -   -- -- - ---
-  --  -     -   -- -      -      -  -    --- - - -      -    - -   - - -      - - -    -    -  -- -
--     --     - -   - --  - - - --     - -  - -      ---   --  -        -  - - - -  -       -  - - -
- -    --- -  -- - -         --- -    -  - ----    --    - -- -      -- ---   --       -  -   --   -
--- --    -    - - -   -  -              - -   - --   -         -   -    -- -  -- - --  - -  -   - -
- - - -     -    - - -  -     -      --  --  -- -    -  -    --   -  -       --   -   --   -      --
-    - - -         - - - -     -- -     -- --    ---      -  --     -   -    - ---- -  -        -  -
-   - --   -- - -  -- - -- -  -    -       -  --   -  - - -  --   --   - - -  --  -     - --    - --
- -- -    -  -- -         -     -  -   -   -     - -  --  --   -  - - - ---      ---  - - - --     -
-     ----    -    -----    -  - -       - - - - - -- - -     - ----- -   -       -- --- --   - - --
-  -      -  -    -  - -      -  -  --   -     - ---   -  --   -    - - -     -     - --     - - - -
--  - -- --   -  -- -    -  -      - - - - --- -- -    -      - -   -  -   --    -      -     -    -
- -      - -        -      -  -- - -- - -      -- -        -   -      - --      - -    -  ---  -   -
-  -    --  -        - -- - -  ---- - - -  -   -   - --- -       -   --        - -- -    -     -   -
- -       -  -  -  --  -- -  -        - ---      ---      - -   ---       --- - -   - -  -  -  - - -
--  -  -     -- - - --      -  -      - - -       -     -  - -      -   -   --       --  -  -      -
-    --    - -  -    --     - - ---   --    -- -- --     -       -- -    -        -         -     --
- - -  - - -     ----  ---        -      -     -    - -      -   - -      -  -  - -  - -      -    -
-     -      - -  -                     - -  -    --    -  -  -     -         - -    -   - -      --
- -     -       -       - -  -     -          -  -    -- -      -   -  -  ---- -   -- - - -        -
--  --  -  - --   -- -  - -    -    -       -  -     -   -----       -   --    -      -      - --  -
-  -     -  -     -   - - - -  - -    ---   --- -   -        -  -     -  -  - -      -    -  - --  -
-         - - --  --    -  -    -        -     - -   --  ---   --   ---                  -   - - ---
-      -             -  - -    -   --   -   -  -      --      -  - -        ---   -- --- -    -   --
- - --    --   --  --   -  - - -- -   - -- -   - - ---   -  -   - -         ---     -      -  -   --
-   -     -- --   -    -- -  --      -  -    - -    --- -     ---  ---   - - -     -    ---     - --
-   - -     -                   - - - -- ---- --  -    -    -      - - - -  - - -     -         -  -
-     - ---   -    ------  -   -- -  - -   -    -  - -- --- -  ---          - -   -  -         -  --
-    - -     -  -  -    --       -  -   -   -   ----        --    - -      -        --   -      -- -
-- - -     - -  --  --           -     -   - - -     -  -   -       -   -  -- ---    --   -   --  --
- -     -  -     - -     -   -  -     -  --  -     - -    - -- --   -      -  - -  -- -  -      -  -
-   -   - - - -   -   -    -      -   --     -  ----   -   -    -      -  --     - - - -    -  -   -
--   -  - -        -  -  - - -- - -      -    -  -   -     -  - -   -        - - -- --         -- --
-   -  - -       --- - -         -- - -   - -       -  -  --    -    -   -    - - - -       -     --
-  - -      -      ---- - -  --    -      - ---  - -  ---       -     -   - -    --- --- - -    -- -
- -   --       - -      -     -     --  --        -    -- -       -      -  ----   -- --   ----   --
-  -     - -     -- - -  -    - - - -    -     --       -     --   -     -    -   - ---   -  -   - -
-   -      -  -- - -   -      - -   -  --  --     - -      -        - - - - --  -      -    - -  - -
--  -  - -   -  - -       --  -   - -- -        -   ---  -    -  -- ---   -  ---  -   -  -   -   - -
-      - -   ---     - -   -          -  --      --    -  -  --      --     --  -  --    - - -    --
- - -        -        -   -- -   -     -   -   - - --  -- -  -  -    --  -   --          - -      --
-- - -   - -    --   -  -     - -  -     -   - -      -  -     ----   -  --   - - -  --  -  -   - --
- -- - - -  - - -   ----     -  -     ---   --    -- -  -  -     --    - -  --  -   -         - -  -
-             - -----   -                  - - -- -   - - --  --   - - -   -  - - --   - -     - - -
-  - -- -    --      -- -  -    - -- - -     -     -       -      -- - -  -- -    -  -       -   - -
-         -     - --  -      - -   -     -- --- ---  -   -  - -  -    --    -     - -- --    -  -- -
-   -  --    --    -  -  ---           --      - --        -     --   -    -- -         --   ---   -
--  - -    -     -- --- - - --      -     - -- -  -  - -- -  - -       --    -        -- -   -- -  -
-    -  -- ---   --- -   -    --  -   -    - -  -  -        ---  --                   -  - ---     -
-   -    - - -      - --  - - -    --    - - -    -   -         - -  ---    -  ---   --  -  -  -----
- -  -  - - -  -- --     --     -   -  - -     --       -   -    -  - -  -   -  - -  - -- - -      -
-   -     - - -   -   ---      -  --  -   - -           -   -- -    -- -   - - -  - -    - -  -   --
-    - -      --     -   -       -    -  --  --    - -  -        -  -    -  -     - - -   - -    - -
-  -  -   -  -     -  ---  - -     - -- - -    - -     -- ----- --- -  --  -  -  -     - -     --- -
- -  - - - -  - - -     -- --- - -            --    -  --    -  - - -                  -  -    -- --
--       -    - -  -- -     - -    --- -   -       -     -  -  -- - -     -  - -  --      - -  - - -
--    - -  --     -     -    -  -  -   - -   -        - -- - - -    -   --   -       --  -     - - -
-   - -       - - -   -  --  - -   - -    -     -  -   --   -- -- -       -    --   -    -  -      -
-  -   -  - -  -        -   - -   - - -  - -  -  -     -- -  -       ------   -  --   -  -  - -  - -
--    --   --- - -       --    -  --     -      --     -  -- --   --   -     -     ----   -  -  - --
-  -  -   - -      --      -- -     - -- -           -   -   -- - -  - -  --  - ---      -  - -- - -
- - -   -       -    --     -    --      -    --   --- - -       -  -    -          -     -    - - -
- -    -    --   - --- - - - --  - -     --      -     -   - ---      -   -   -       -- - -       -
-     -  -- -          - - -    - ---   -   - -   - -   -  -         - --       --  ---      - -   -
- -  -- - --  - - --  -- -     --    -  --     -- --  -   - - - - -   --   --     -        - - -   -
- - -       -    --  -- - - -       - -      --  -  --   -       --  -  -- -    - - -          -   -
-    -   -- -  -   - --  - -    -  -     -     -       -       -   - -     -- -  - -      --  --   -
-    --      - - - --     -   -        -- -- -- -    -- --   -   -  - - -  - - -      - --    ---  -
- --- --  --    ---  - - - -- --     --  - -  - -   -  -    -  -    --       -    -  --   -  - -   -
-  -- --    --  -- ---         -  --    -- - - -     --      -       - -- -    -  --   -   -     ---
-          -   - - -- -    - -     -       -  -  - -   -    - -      - --   -    - -    - -  -    --
- -- -  - - - -       --     - -   - --  -  --  -    -     - -  -   --      -       --      --     -
- - -  -       - ---     - --  --         - -   -   -   - - - --  - -    - - -   -   --            -
- --  - - -  -- -  -  --   -   -  - --- --    - -- -   -  - -    -  -  -    - -  --  -   --   -    -
--               -  - --   - - - --   -    -  -  -- -     -       -- --    -   -  -- -   - -    -- -
-          - - -  ---   - -   ----   --  ---          -         -       - -          -  ---  --   --
----  -              ---  -      -  -  - - -      -    -    - --      -  -- -   -    - -   -  -   --
-  - --  --  -   -  -   - - - - -   - -    - -  -  -   -     ---   --          -     -   --  - - - -
--- -   -       - -- --   -  --         -       -  -       -   -   - - - -     -  --     --  - - - -
- -   -   --       --    - -  -  - -  - - -   -      - - -    -  -      -    - -     - - -     -   -
-- - -- -  -         -    --          -   -  -   - -  -     -              - --   -   -- -       ---
-   -   -   --    --         -       -        --   -  -           - - --  -      - -    --    - -  -
-     - -   -  - --        - -       -        -   -   ---   -    -    --    -  -       -    -    - -
-  ---- -- ---       --   -   -    --         --              -    - -      - --   -   -           -
---    -        -    -          ---- -   --  - -     --- - ---       -  -- - -  --   -          - --
-    - -        -    - -  -    -  --        - -    ---- - --             - - - -     -  - - -      -
-     --          --       - -    --   -- -   - ---   -    -          - -  - -   - - - -   -  -    -
- -      - --   -     - ---- - -    -   -   -      - -    - - -        - --  - - - - - --- -   -   -
- - ---  -     -  --   -   --  ----       -  -   - -   -    --  -   - -    -   - -  - -     -  -----
- -- -  --  ----    - -  - -  -  -   -   -       -   -   -    -  -   --    ---   - --            - -
--  -  -  -- --   -   - -    -- - --  -      -    -- -  -  - ---   --     - -- -     -  -  ---- - --
- -     -   -       -  - - - -  ---   - -- -- - -    -    - -    --  --    -     -     - - - -  -  -
-  -  -            -   -    - -    -    -    -      - - - -    -    - - - - -             - --    --
-                   -   -- -  -        - - --   --      -      ----       -       -     --    --   -
----------------------------------------------------------------------------------------------------
