100
100
----------------------------------------------------------------------------------------------------
- - -         -            ---    -   ---  -- --  --  -              -         -  --      -        -
- -    -- -                    --   -      -        - - -- - -    - -     -  -  --  - -     --  - --
-      -  -  --   - - -   --- -- -     -    --  -  - - -  -    --       - -       -   - -  --    - -
-    -    -    -  -    -     -       -     --    -- - -- -     -   --  -       -  --      --       -
-   - -----    -  ----     - - -- -       --    - --  -  -      -     -    - - --     - -    - --  -
-     -        -      -- - -   -    -   -   -     - --  ----           --   -   --    -  -      -- -
-  --- - -    --   -     --      -     -- -    ---  -  -  -  -   --  - - - - -  --   - - -  --     -
-       --- --     -       - --   -  --      -   - -   --- -        - - -- - -       -     -   -  --
-  - --    --      - -    -  ---   -   -       - -  -  - --   - -    --  - ---  -  - - -- - - -    -
- -       - -   --  -     -     - -  -     -  --  -  -  - --   --     -- -    -     -  - -  - - - --
-   - -     - -- -- - -        -    - - --           - - --  ---    -  -   - - - -       -   --    -
-- -       -  -  -    -   --  -  --  -  -      - --             --- - - -    -   -     -  -- - - ---
--     -  ---      - ---        -   - -  -   -      -  - --   --         -  -       -    -    -   --
-             -  - -       - --    -   -- -       ---  - - - -     -  - -   --  -- -        -   -- -
-  -  -  -   - -   -  - -    ---    -   --   -  -         -  -  - -  -- -  --      - - -  -       --
--  -       -     - -   --- -   -    --- ---  -- -  -   -    -    -             -    -    -       --
- - -- -   -     --   --   -   -  -         -     ----- -  - - -     - -     -    - -     -      - -
--- -  -- -  -      -     -       - ---  -     ---- ---   - -   ---    - ----  -  - -- -  - - ---- -
- -    - -  -  -  -  - -  -   -         - -  -     -    - -----    -     -        - ---- - -      --
-   -   - -   -    -  --  -       - - -- -    ----    - --           - - -  - -  - -  -  - ---   - -
-         -     --  --   -    - -     - - --     -- -  -  --      --    -  -      --    - -  - -   -
-  --  --    -      --- - --     - -   - -  -  - -     -- -    - - ----                   --  -- - -
-  --  -   -   -        -   -     -- - -      -           ---- - -       ----- - ---  - --   -     -
--   --     --    -  - -  -          --          --  -         - -    ---    -         -  -----    -
- -   --  -               -- -        ----   ---- -     ---   -   -   -  --       -    - -     --  -
-  - -  --   --  --   -        -  --       -  - --       -  -   -- -   --  -- -    --      --- - - -
-   -- -      --     --   --      -     - -      - -        -  -      -  -   -- ---    -        -  -
-  --- - -- -   --  -  -  -- -  - - ----         -  - -  -                -        --    ---      --
-   - ---          -- -   --  -    - --      ---  -  - - -- -  -  -    -  -   - - -   -   - -- - - -
- -  ---  - -  - --     -   -    --    -   -  -   --            - - --  - - -    -     -        -  -
-   - -    --   -  -    - -  - -  - --- --          --     - ---- - -  -    -    --- --    - -    --
--    - -      -  -- - - -- - -          - -   - - -     - -  - - - --    -  -   --    -      -    -
--   - -    -  -    - - -          ---    -  - -     -   -  --   --    -   - -   -  ---  - -     ---
-   -   -       --     -    -  -- -- -      -          ---   -    -   ----    -          -    -    -
--    -      -    - ---  -  -    --   --       -   -    -   - -  --- -         -     - -    -- -   -
---         -   - - -  --  -  --  -  -  -   -  - - -   -  - - -  -     --   -       -  - -      -- -
-   - -     -     -  -    -- -   -     -     - - -- - - -  - - - -       -    --- -     - -    - - -
---          -   --    -    -   -  -  ----- -- -     -             --         -- -- -   -    --   --
--   --     - - - - -   - -     -   - -    -   --  -   --    -   -    -   --     - -       --   -- -
-     ---   - -    - - -- --     -   -    -- --  --  - -   - -     --  ---  - - -      -     - -- --
-   -     --  - -       --  -   -        -    - -  -   -  -       -   -  -          -  --- -     - -
-  - -- -    -  -    - --    -  -  - --- -  --    - -  -   -  -   -----    -      - --- -  --     --
-- ---    --  - - - -   - -  --      -         --   --- -       - -        --       -    -    -  ---
--- -       - - - --- - - - -    - -     - -  -       ---   -   -  -  - ---  -  --   --    ---     -
- -    -   -   -         -  -- -  - - --- -  - -   - --  - --  -            - -  - ---- -  -  ---- -
-  -  --      -- --- -  - --       -  - -  -- -     -- -    -    --  -  -   --  - ---  -      -    -
- -- - -  - - - -      - - - - -      --          -- --  - - -  -      --  -   -   - - - -- --- -- -
-  -  - - -     - -  --    -     - -    --         -   ----   -  - -  - -  -   -     --   -      - -
- -- --  -    -   -      -  - --    - -        -  - - - -  -   - - -       --    --   -    -    -  -
- -  -    -- -   --- - --  -    -  -    -    -          -         -  -           -    -  -  - - -- -
-          - -  -        -    - -   -   -      - --   -- - - -      -   - --  --- -             -  -
--    - -       - - --        -       -             -    -        - --      -- - -     -  --   - - -
-  - - -  - - -   -  --   - -- -   ----           -- -  ---   -    --   ---   -       - -      -   -
--  -    - - -  --         - -    ---    -        -- -     --    -- ---    -- - ---    - -- --   - -
- ---  -   - -  -       - - -      --  -      --  - -  -   - -    - -   - -  - -  -  -   -  --   ---
-       -   - -    - -     -   -- -- -   -  -    -      --   -  --- - - -       -   - - -- -   -   -
- ----  -  -     --- - -- ---    --   ----- - --     -    -           -     -   - -- - --  - -     -
--       - --  -   ----         -   -      - -   - -   -   -   - --  -  --   -  -         -  -    --
-- --     -   - --      -  --  -      -- --    -     -   -         -         --     -      - -    --
- - - ---   -  - -     -    - -   -    -    -  -   - --    -   - -- - -       - -     --- --   --  -
-   - -  -- -- ---  -- ---- --   -  -   -- - -        - -    - --  -     --   -  - - - -  --  -    -
- - - -      - -   - -       --  - -    --   --   --          -    --   -  -- - -       -          -
-             -    -  - ---   -  --- -  -      -      --        - -    - - -     - - -    -  -  -- -
-- - -- - --   - - -  -- - - -  -    -      -        -    -  ---  - ---    -   ---   - -- -- - -  --
--      -- -  --        -    -     - -  - -  -     -    -          --    -       - -  - -    -     -
-    -      - - - -     -                      -      - --- -- -     -         -       -  - -  --  -
-- - -   --  -  --  - --    - -          -   -- -  - - -   --  ----    -    -  - -  -      - ---   -
-   - --      --  -  -    - -   - -     -       -   --            - --    -     -    - --   -     --
--    -  - -           -      -     -     -       - -  --     -  --- -    -   --  -- -      -  -   -
-     -  - - - ---      --      - -  -- --    --      - -     --     - -  - - --  --     -   -     -
--   - -     -    - - -            -  - - --     -   -- -  - -  -  -   -  -    ---     - - -   -   -
-  --   -  - --    -  - -  - -          -  -  -  -      -    -- - -- --    - --           --  - -  -
--  ---          ---  -      - - - -   - -  - -- - --  -- -    -     --     -         -      -     -
- -  - -   -             --  -    -   -    -- -  - -     -- -    --    -  -  --    --  - - -  -  ---
--   -       - - -     --    -  -  -  -   - -- - -  -       -  -   ----- - -   --      - - -   -  --
----    -- --  -   - - -  ---   -    -   -        - -  -  - --- -----  -     - --      - -- -   -  -
-     -  -   -- -   -- -     -    - --        --      -  --- --    -   - - - -  -  -  - - -  ----- -
--  -  -  --     - -      -   -     ---  -            - - - - - -       -       ---   - -  -    -- -
--    --  -   -  - --     -  -  - -            -- -  --   -   -    -  - - -   --     -- - -    --  -
-- - -  - - -  -    - - - --  -      -   -      - -  -         - - -       -    -  -        -     --
-    - -      --   -  -    -     -       -    --    - -      -    - - -- --   --  --    -       - --
--     - -      - -          -   -     --      -  - -   - -    -  - -   -       -- -- -  -   --    -
- - --  -       - --    - - ----   - -         -   - -  - - --  --   -   -   --       --  - -     --
-     - -             -           --       -                  - -  -   --    - -   - --         -  -
-         -    - -       ---- -       - - -    -  -  ---  - - - - --  -  -  -     -    - -  - - -- -
-  - ---  --   -    -   -        ----   -   --- -  -       -  - -  -    -   ---  -   -  -    -- -- -
- -  -     -- -  -        - -- -- - --  -     --   ----  -    -  - -    -  --   -     -   --   -   -
--   - --       -   -    -- - -- -    -- -   - - - -    -  -   -   --                - --  ----   --
-  -  -  -   -     --  - -     - - --- -   -  - -     - - -  - -   -      --   - - ---    -       --
--     --  -  -  -  -   -      -- --- --     --          -- - - -  - -   -      --     - -   - --  -
-  - - -       - -       --- -         -   -  - -  - -----       - --  -      -   -      -      - --
-     - ---   -- -     -- -   --   -    --    - ---         -         -        -  -  - - ---- -    -
---  - -  -    --      - -     -           - --   ----- ---      ---  - --    --             -    --
-    -  ---   -   -  - -       -  -  - --  -  -    -   -    -  -   ---    -          -- - -    - - -
-         -  -    -  -    -  -              -  - -      -          -     --   -- - -            -  -
--   --       -  - - --   - - -    ---   -   -    --   - -    - -  - -     -    -    - -- - -   -- -
- -      -  - --  --  -       -- --   -      -- -   -                -  - - -     -  -- -     -  - -
-    -- -   -- -- - --  -    -     -    -     -   -      -      -  -           -                   -
----------------------------------------------------------------------------------------------------
