100
100
----------------------------------------------------------------------------------------------------
-           -                -     - -       -   -    - -- - -  -   -   ---  - -    -      --  --  -
-      - -- -      --- - ---     -    -        --  --       -     -   -     -   - -   -  -  - --   -
-  - - --  -- -             - -      -  -- -     -     - -  -  --  --   ---  ---- -   -    - -  - --
- - --   -  -   -   ---           -  -     - - --  -      -      - - -     ---      -        - -   -
-     -   -       -     -  --   -  - - -   -   -   --      ---   - - ----   - ---- -   - --  - - - -
-  --   --  - - -  -      -    -     -- - - -  - ---  --    - - - -  -    -- -   --   - - - -    - -
-      -     --  --  - -  - -   ----   -   - -      --          - - - - -      -  -     - -     -  -
-    --     - -        --  -  -         - -- -   - -  -      -   -      -- ---  -  -- --    --- -  -
- - - -         -    - -      -  -        -    -- -  -  -  -  - --- -   -   -- -     -   -  -    - -
- -     -   ----   - - -  --    -    -   -  - - -- - -- -- - -     -               --- -      -  - -
-      -- -     -  --  -     - -  - -       -     -   --  ---   -     - -  -- -  - -   - -    -    -
--         --   -     -   -    -    --    - -  --   -  --  ---         -  -       -   -   -   - -- -
- --     -   - -      -- --   -   - - -       -        - -  - - --    -  -  - -        -     -     -
-      - --- - -    -                      - -  -    - - -           -  -            --            -
-- --  -   -   -  -     -  -    -  -  - --   -- -   ----  - -  ---   --      - -      -  - -  --   -
--  -   --   -       -  -- -   -       --- -  ---     -  -  --   ---      -- -   --  -- -   ---    -
-       -   -   -  - -        -       -       -- -  --    -    -  -  -   -     --  -            -- -
-- --      --      - -     -   -       ---- - -         --   -     -  -   - - -- -   -   -    -   --
--    -    -   --  - -    ---- - -  - --  - -  --   -  -- -  - -  --        - -    --       -  -   -
-   -- -   -- -   -              -   -    -- -      --   - --       -  --        -- --  -   --- - --
-     -- - --  - -       -        - - - - - --  -   -   -  -- --   --  ---    -             -      -
-    -   -      --          - -  --  -    --  --    -- -   -- - - -  -    -   - -   - -    - ---   -
-   -  -  -  - -  -  -- --- -  -   - ----   -  -     - --       -  - -  -   --  --  - ---- -   --- -
- - -   -  -    -  --- -   -     -     -----  --    -          --  -       -        - --   --- -  --
-- - -   -- -- -    - - -    - - -  -    -    - -    --     -     ---  ---  -  -- - --  -  -- - -  -
-       -- -    -   --  --     -- --      --   -   -           -    -- -      -             -   -- -
-  -- -- -  --   --       -      -     -  --     - -- --      -     - -  -- -   - - -- -- -- --    -
--  - --  - -   -   --- -      -  -  -    -   - -    -    -  -      -  --   -   -   -  --  -     - -
-    -            - -   -  - -       - --  -     - -    -      -  - --    -        -        -  --  -
- -     - - -     -  -   -    - - -    -     - --   --  -  - --   - -       - --   - - --      -   -
-  -    -   -        - --   ---  - - ---     -     -  -        -        -         - -  -  -     - --
-   - - --   -- --     -  -     - -  -         --- -     --  -      -   --  --      - -- -    -    -
-  -  -        - - - - -  -  - -       -  -     - - -  --   --   -      -  -       -     -- --    --
-   -    -  -    -- -   -      -  -- -- -  --  --   -   ---  - -    -       -- - -        -  -     -
- -   -     -   - ---      -- --         - -  -  --- -- --   -  --   -             -      -   - -- -
-  -  -      -     -     ---       -         - -  --   --   -   - --- ---  --        - -   -- - -- -
--- - -----  -      -- --   -  -    -     --    --       - -     -   -  --  -     - -  -  -        -
- - -      -      -   -- -  -    --  - --  - --         - - - -    - - --       -   - -  --      ---
-  -    - --        - -   -  ---   - - - --    - -   -  -    - --       -  --   -  --  -   -  - -  -
--    - -   - -    -- ---- -     -- - -   --  ---  -     -       -    -     -  --          --   - --
-  -     - - -       -         - - - --   --   --  - -- -    --  -  -     -  -       -     -   -   -
- - --     -- -    - ----           -  -- -  -- -- --  -  - -   --- - ---   -   --  -   ---    -   -
- -   -- -   -- ---- - - -  - --   -  - --  -  - --    -   -      -  -    -   -                -  --
--   -     --           --  -   - - -      - --    -   --  -- --       -     -         -          --
- -    -    --  -----   --    - - - -    -   - -  -  --   --    ---    -  -  -    ---         -    -
-       - -       -    --  -  --  -            -       - -     -  -- -   --   -  -     -    - - -- -
-    ---- -- - --- --  - - -    - -- - - -     -- -  -   -  --  - -  - -   --  --    --    -       -
-  -   -  -  -        - - -- - - -- -       - - - -- - -    - -   -  -   --  ---    -       -  -----
-    -       - -       - -   -     --   ---   ---- - -  - -   -    --    - --     --      -        -
---    - --  -     -   -       -   -  -        -     -   -  -   -      ---   -  --    -         - --
-            -       --   ---- -       - - - -    -   --    --   -  -  -  -          -   -    -    -
-  -  -  -   --       -   - -     - - -    -   -  -- -   ---       --   -  ---    --  ---   -   -  -
--   -     -  ---   - -        -----    - -- -        - -  ---- -    - -  -    - -   -     --- -   -
- -  -     -          --- -  -          ---     -  - -- ----  -   -   -  - - - - -   ---   -      --
-   - - -    --  --          -  --  -  -   - ---    -  -     -  - - -        -  -    - - - -  ---  -
-     -  - -   -  -- ---      --  - --- -- - -- -  -      - -    -   ----- - -  - --    - - --- -- -
-         --- -  -      -       --        -      -- -- -   - - -       -- -   -    -  --    -      -
--    -        - -- --     - -- - --    - -  --      - -  ----      -    -   - ---     -  - - -  - -
-    -       ---  - --- -     -  -   -   -- -  -        -      --   -----  -  -  - -   -   -    -- -
-    --         -  -       -  -   -   --  -   --   --   -  ---   -           --         -   ---    -
-  ---  - - -  -          -  - -   --  -    - --- -   --  -  -     -  - -  --   -  ----   --   -  --
- --  -   -       -         - - -  --      -     -        --    - -    --  - -    - -   -    --   --
--  -  -  - -  -  - -  -         - - -  -         -   --      -   - --   - -   - - - - -    -  -- --
- -    -  --  -  ---- -  - - --   -    -   -    -   - --   - -        -         - -- -  --   - -   -
- - - - -   -        -  -- - - ---      -      -- -  - --        -  --- -- - - - -   --   - -    - -
- -- --- -  -  -           - -   -         -    -  - - - -     -     - - - -   --- ---    - - -- - -
- -- -        -  ---      -           -  - -  -  -   -- --- -       - -      -    - --  -  --- --- -
-  --                     - - -    - -  -  -  --     -    - -  -- - -   -  ---   --     - -     -  -
- -  -           - - --           -  - -  - -    -      --      -        -     -     --     -  - - -
-- -       -    ---   -  - -   ---       -- -  -     -   - -       - -- -  -  -    -- - -   - -    -
-     - -     -    --    - -- --  -     --     -  - -  --       --                -          --   --
-       --  - ----- -   --   -  - -  -- -  -- --    -        - --    -  -  - - - -  -  --        - -
-     -  --- - -   -- -    - -   - -   -- -  --- -     -   -  -     - -       -  ---- -   -   --   -
--   -  -        - -- --- - -  -  -  -  --  -   -       -   -    ---             --      -      -  -
-  --  -   -  -   -- - -   - -  ----  -     - -- -             -  --  - -  -  -  - -  -- - - - -  --
-        --        - - --      -  -      ---    -    - -    --    -  -   - -   -- -  -   -- -      -
- --    -   -    - --      -- --    -  - -  -  -    -       -  - -  -       -  - - --  - -    --   -
--              - -      -   - -      - - -  -   - -  -   -       -     ---   -  - - --   --   -   -
-- -  -           - -    - -      -    -  -     -   --    -    -    -            -- -              -
-   -  - -   -      -   --  -- -        -  - -      -   -  -     -     - -   -- -           - -   --
-   -        -   - - - -   -      --    -   --- -  -   - -  -     - - - --     ---  --  -       -  -
-   -  -  -- -  -   --   - - - - - -   - -  -              ----    -- -    -- -  -      -  - - - - -
-  - -  - -    -  -- - -  -  -       - -   -   --  -       - -  -  ---     - - -   -         -   ---
- -- - - -    - --    --  - -- -- -   - - - --       --  - - -      -   - - -- - - -               -
- -  - -  --     -  - -   -     -    - -   -  ---          - -- --  --      -         --- -    --  -
--  ---   -   -  -  -- -    --       -      -    -  - -     -  -  --     -    -     -- - -  -- -   -
-- - -      -  - --                -      -  -  -  - -     -          - -         --  -- --  --   --
-- - - ---   -        -- -   - -     --     -   -       -      -   -   - -   - ---     -   -- -   --
-     ---  -     ---        -  -   -  --   -  -  -----     --   -  --  -           -  -   --   - - -
-   -      -   --      - ---   -     -      --  -   -          - - -  -     -  - ---  -       -  - -
- --   -   -- -   -- -- -  - -    --   - -    - ---    -   -- - --   - -   - - -      -   --   -  --
-   ---          -    - --    - -  --  -  - -   -       -     - -- - -  -  - --    -       -  - -- -
- -- -  - -- -- -- -     - -  -           -    -      ---- -     --       --- -  ---     -   --- - -
-- -  -   - --       - -     - -   --- -   -   -    -- -     -     -          --      - ----  -   --
-    -       --- -    - - -   -  -   - - -  ----      -  --          -          -  -      - -    - -
-  --           - -    -    -  - -     - -      -  - -    -  --- - -  -           -     -     -    -
- -   - --  -  - -  -      - ---- -  --  -  - -- -   -- -- --  -       --- - - -      -       -    -
-   -         --          - -       -  -  -  --       --  -     -  - --   -      -          -      -
----------------------------------------------------------------------------------------------------
