100
100
----------------------------------------------------------------------------------------------------
-         --     - - - - - -   - --         -- -   -     -  - - -   --- -    - -  -    -    -  --  -
- - --- -   -  -         -       - - -   -- -   -     --   -       -     -   - --  -   -         - -
-  -    - -   -- -- --     -  - - - -                      -   -- -   ---      - -    -  - --  - - -
--     -           -   - -  --   -                --   -  -      - -      -- -  -   - -           --
-  - -     - - -      -  - -             - -  -   - -   -   -  -- -   -- -  - ---  -    - - - ---  -
- -    -    -     ---- -    --     - --   - -      - -     - -  - -  -- ---- - - --    --- -- - -  -
-   -   --   -              -        -- -   -  - -     -- -   - -   -   -    -  -  --- --  -  -    -
- -  - -  --  --   -   -    --  - - -   - --  - -       - -   -  - -           -    -  - -  - -   --
-- - -   -     - -   - -  -     -    -    -        ----     --   - -  -    - -    -    - --    - - -
-    -- - -      - -   - - --      - -  -  - ---  --  -        ---   ---   --     --    - -- -- - --
--   --  -   -- - -         -     - -   -     -  --        -  --     - -    -    --- - -       - - -
-   -  --  -- - - ---- - - --    -        --   ---   - -  --   - --    -      -    ---   -- ---    -
-  -- -        -- -      - -  -     - --   ---  - -     -   -     -      -     -- --   --- -     - -
--       -  -  - - - -   - -    --- -    -  -     -    --           -   - - -     - -     - --- -  -
-  -- --  -  -        -   -   - --        -      --     -       -  -  --   -  --     --         - --
----      - --  --     -- ---  -  -     -        -  - --          -      ----     -    -    -      -
-  - -      ----   ---  -          -- - -      -- - -   -   -         -        - - - - -  - -- -   -
-             -      -   - --  --    -   -  - -- -  -  -  -  -- - --   - - -   - -    - -      --- -
-   -  -     -        --  -   - -      --   -    --      -   --    - -       -   --   --  - -   -- -
-   -   -    -    --  -       --          -  --  ----  -   --  --        - --- -- - - -  - -       -
-      -- - -   -    -  -        --        -   - - ---  -        -     --          --  -   -    ----
- -    -   - -    --    -  -         -    -      -     -      - -- -   -       ----       -- -- -  -
- --       -    -    -    -    - -- -         ---      -   -  ---    -  -- -    --  --      - - - --
-   -  ---  --      -  -  --     -- --   -    --     -- - -- -   - -- -       -     -   ---- -    --
- - -  -      -     -       -- - - - -     -  -   -      -       -  --      -  -     --    -       -
-   - - --     -  -   --   -   -         -     -    ----  --  - -  -    -- -- - ----      --    -- -
-  - --   - -   --     -   -  -   -   -   -- -   --  -  --  -         -       -  - -  -   ---      -
-  -              - --  -   -  --   -    -   - -   -  --- --- - -      -- -- - --  -    - -        -
- -   - - -- -   - -       - -  -    -    -       - - -           -- -      -                     --
-   -- -     -   -          -    -    -  - -     -    -       -   - -               -  -        - --
-    - - - - - -   -- ---    - -  -  -     - - - -- - - ---  --  -    -     ---  --  -- - -  -     -
-  --  - -      -      -  -   -    --- -  - -  - -   -     -  -- -- -           -   - -  - - --  - -
- -- - -      - --      -- -  - --   -  -  -      --    -- -- - ---   -- - - --  -           -     -
-  -  -    -  -  -    -     - -   ---        -- - --- --  -- ---  - --  --     -   -  -  --     -- -
---  -   -       -- -     -     --   -   -  - - -    -  --        -    --  -- -   ---     - -  -   -
-  -   - -  --  --- -   -  --  -  - -  -   --   -  -      -  - --      -         - -  ---  -    -  -
-    --        - -      - -  -  -    - -    -     -  --     --   --  -- -     -  - --  - - --  - - -
-        -  - -  -  -      -- - - -   -     -  -   -- -  - -        -  -    -    - -- -   -    -  --
-   -       - - -   -       -  --     - -     -  -    -              - --  -- - -  -   -  -    -- --
- -- -  -  -   -  -  ---  -    ----- -      - --     - -     ---   - -- - -   - -         - -      -
--      - -       -  -  -                -   -   -   -  -   --  -  --        - -   -   - ---     - -
- - -    --  - -      -   -    --   - -       -  - -             -- -        - -   -         --    -
- --   - -         -   -   -           -- -        -        -  - -  - --    - --     --  --- - - ---
-        -     -   -     --   - -           - -  -  ---   -  - - - ----         -   ---        -  --
- - -       --   -     -- -      - -  -    - --  - -    -   --- -    - - - --      --   -  -- - -  -
- -- -  -   -            -    --- - --  -- -      -    - -     ---          - --  -  --  -   - -   -
- -     -     -     - -        -   -     -   --- ---      -- -      -       - -    --  -   ---  -  -
-   - -  -      ----   -  - -  -     -       -   -    -     -       ---  --  - -   - -  -  -     - -
-     -   --  -     -  -      - -- - - -   - -    -- - -   ---   --     -   - - --    -  - -  - - --
- - -      -      --    - --       -     - --      -     -     - - - -      -  -      - --    ---  -
--    -- -- - -     - - - -    --- -   -     --  - - -- - -    -   -   -   -   -  -  -   -  -     --
- -  -  - ----       --    - -    -   - - --    - -          -     - --            --   -      -  --
-     -         -    -        -   --   -           -   -  --  - -        --     -   ---    -   --  -
--         --  - -   - -     -   -   -  --  --    -        -   -   - - -- - - -     -        -     -
- -   - -  -       --      -        - --- --    - -     -    ---        - -  -  -      --  -    -- -
- -     ---    -- - -   ---  -     -    - - ----    -   ---  -    -             -           - -    -
-   --- ----  -        --   -  -      -      -  -- --     - -  ---     - - -  -       -   --   --  -
-   -       ---     --     -    -         - -   -  -  - -  -    -         - -    - -     --        -
-   -  --     -   - --    - - - --- ---     - -  -  --       --  -      --- -      -   -    -  --  -
- -   - ---     --    -- -   -- - --   -  ---  - - -   --  --  -   -    -  --  -  -  -  -  -   -   -
-  -       -- -   - - - -- - --     --     -  -         ---  - - --   -   - -  - --      -     - ---
- -      -  -         --    -- -  --- -  -     - - --       - - -   - - - - --- - - - ---   - -    -
- - -  --  -- ---     - -       - -  --  - -   -   --  -- -- - ----    - -    - -    -    -- -     -
-  -     -     - - -   -  -  -- -  - - - - -  - -- -         -   --       -   -         -   -  -- --
-      - - - -   - -- - ---    - --  --            - ---  -    -   - -    -- - -     -      -      -
- -  -- -         -    ---- - -       -  -    -         - - ---- ---     -   --  -- -  --    -    --
- -- - - - - -- -  -    --     -        - - -       -    - -    -  -- - --- - -   -   -- --        -
-  - --  - --- --    - ---   ---   - --      - - -     -  -             -  -- - - -     --  - ---  -
-   - - -- -     -  --  -   -   -----   --  -- --   - ---- --      -        - - --   - -   -       -
-- -- - -   - -   - -             --- -        -  - -   ---   --    - --- -    --  -   --  -  - -  -
- -    - - -  -  - -  - --    - -     -  --    - -- --        -      - -    - -   -  -- -     -    -
--   - -    ----     --           - -  -        -  - -  -  -- -  -   -    -    - -   ---   -    -  -
----      - -  -    -     -     -- -  -      -   -   -  -      ---   -   - --- - - - -    - - -    -
-   - - --   --   -       - -    -    - - -    -  -   -          -      --   - -  -     -   -   - --
-        - -   ---  -      --   -   -     -   - - - --  -      --  - -  - -   -              - -   -
-     - ----         ----   --       - -- - ---   - -               -- ----   - - - -       -  -   -
- -       - -  -- -   - -- -    - --   --        - -- -  -   -   - - -  - -  -   -    - -- -- -  - -
-     -    --  -    - - -  --      -      -  -- -    -- - --   - -   -    - --   ---    -   - -   --
- --     -   -      -   -   -  ---    ---  -   -   -    -         -  - --    -  -     - -- -   - - -
- --      - -           -   ---   -  -          --  --- --      -      -    - -  -    -          ---
-  --  -  -  --      -        -        --      - -  -    -- -    -    ---        -   ---     -     -
-  -  - -          -- -   -    - ----     ---  -   -         -         -     - -      --    -  -  --
- -  - -- -           -   -    -      -    - -         - --    - -    -  -       - ---- -  --     --
- -- -  -  - -  -     -               -        - ---    -   -  - -   - -   - -  --  -           -  -
-   - -- -        - -- -----       -    -  -    - -  -       -   - -     -      -  -  -- -- -   -  -
--      --- --   -  -        - - --   - - - -   -  --   -  - -    -   -  -    -   -  -     --    - -
-   -  -  - -  - - - -    ---  -    - -   --- -   - -        -    - -   --  - -   - -  -     --    -
-     ----        -    -       ---    -   -    -    -- ---  -  --   - -   -    - -  -       -      -
- ---  -- -   - ----    -  --      --  --    -   - -  -  -- -    - --      -  - -  -- -- --- --- - -
--     -   -        - -              -   ---     -   -     -     - -    -           - --       - - -
-    --  - -   - - -    - - -     -  - --  -     -     --- -     - --     -   -          -       - -
-   -  -    -     -      -- -     ---                -   - -    -   -    ---  - -- - ---      -    -
---  - -- - - -  -- -----     -  -    -  --- - -      -  -- -   -----  --   -  - -          - --   -
--  - -- - -   - -- -  -   -   -     - -    -     -- --      --      -  --         - -- -   -      -
- ----    --          -        -  -     --  ------ --   ---   --   - - -       -    - -    -   -  --
- - -     -  - --  - -  - - -  -     -    --      - - -- -  -     -    -   - - -              --  --
-    - --   - -  -           -             -   -  -  --      -      --  -  -  - -  --   - ----- -  -
- --  -        -   -  --   --  - - -  - -   - -  -- -    - --  -  -   -    -         -    -     -  -
----------------------------------------------------------------------------------------------------
