100
100
----------------------------------------------------------------------------------------------------
-   -  - - -   -    -  - - -  - -    - - --              -      - --              -      -  --  -- -
---  - -    --- --  -  -  -     - - - -     ---  -     --  ------ - - --        -   --         - - -
-   --- - -- -    -    - --- ---      -   -             --   --  --  -  -  - --      - --  -----   -
--          -   - -  -    -     -    --  - -    -  -      -    - ---   -            - - --   -    --
-- ---  -  -- - -  - - --      -   -   -   --     -         --    - --    -      -  -     --       -
- -   - -     - --     -- -   -- -    -- -       -        -     -- -       - -   -     -    - - ----
- ---  -     - - - --     -    -   -        - - -- -- - -   -       --- -      --- -    -   -  -   -
- -  - -   - - -  --    -  -  -     - -   -     - -   -  -  - --      -  - - -   - -   -   -    -- -
- - -     - ---  -    --    - -- -  - -     -  -   -     -   -         - - --  -        -- --  - - -
-  -  - -     -      -  - - -    - -- -     - - ---  -- - - -         - -  -   - -            - -  -
-   - --   -   -  -   -    --     -    --     -     -    -  - -         - - --  -   -- -  ----     -
--  -   - -  -   - -    -      -  -   - -- - - -    - --- -   -    --  -   -        - -  - --  -   -
- -  -  -   - -     -  -         - - -  -- ---    ---  -    -   -      -  -      -   -  -     - -  -
-   -   --- -      - -       - -           -- ---    - -  -        -      -         -  --  -       -
--        -  -  --- - -  ---     -  -  - - -   -         ---    --  --- - - -- - -  - -     ---  - -
-    -  --   -- -   -      --     - -     - - -- -   -  -  -   - -       - -  - -    - - - -   -  --
-   -        -   - -  --   -   -     -  --  -      -   - -     - -  -   --  -     - -       -      -
-      - --  - -    - -   --- -- ---- --  -  - -  -     --         -   -  --     -    -   -   -    -
-   - -   -  -    -          --    -  ---       -   --      ---      -   -    -    - -         -   -
-   --  --      -            -  - -  ----      - -      -     -  - --- -     - -   -   - -    -  - -
-      -     -   - -  -  - -    -      - --  -    --  - - -- - -        -   -      - -- -  - -   - -
-    -         --    -  - -   -  - - -    -  -                -  -   --    --  -  -- - - - ------  -
- ---   -      - - -   --   -     - -       -- - -  -- - --  -    -- - - -  -     -   - -   - - -- -
- --       -     -   --  ----            --  -    -        -     - -   - -     -    ---    -  -  - -
-        - -   -       --    -   -----  -            -  -  --   ---    -     -       -    -  -     -
-  --  ----     -     - -     - -    -    -       -   -  - --   - -     -  - - -   -      -      ---
-     --    - ---- -   --    -   -  -  -  -   -      - -   -    -  -   -- -   -    -  -         -  -
- -      -  -    -  ---  -  -  ---  - -  - -   -     - -- -- - -- -     - -  -    -- - --- -   - - -
-       --  -     -  -  - -  -       -         -  --  -  -  -     -    ----        ---- --  --   - -
- -  -     --   - -  -        --    - - -      ---- -   -    - --- -  -  -    -       -         -  -
- --   - -   -    ---       -- - -  -  -    -  - -  -     -       - -- -- -       --    - - -- -  --
-  - - - -     -  -    -  --  -     - -        -    - - -          -    -   -    -  ---      -     -
- -- ---- -- -              -    --     -- ----  -  -- -   --   - -         -     -    ---         -
- - -   - -  - -- --- - -   --    --               -- --    - -   -   - -  -  -  -- - -    -  -- - -
-- -  -   -   - -    - -   -  -  -      - -  --  - - - ----     -     - -          -- ---    -  -- -
-      - -  --   -    -   -        -       --  -  - - -     -   -     -- --  - ---          -- -   -
--       ---    - - - ---  --   ---- -  -     -- -   -  -  - - -    -  --       -       --     -   -
-- -  --         --  -   - - - -   - - -           - -      -     -    --         -  - -   -  -  - -
-   --     - -- -     -- -  --- -         -  -- -- -  -  --   - -    -  - - -  -  - -    -  - - -- -
-  --             -- - -  --  - - -  -  --- - - -    -  -         -  -  - -    -  ---  --- -      --
-- -   -   --        -    -  -- --  - -      -  -- -       -    ---  -- -  --- --    -   - -  - -- -
- -   - --  -    --    -   - - -  - -            -  -     - -   -      --  -   -   - -  -  -  - - --
-- -   -  -  -       --   -     -- -  - --            -- ---       ---  ---       - -  ---   -     -
-      -     - -   -  -  -     -- -  -- --     -     -    -- - - --         -    ---- -          - -
--   -     -- -            -         -     --    - -   -     - -   -    - -             - -  - - - -
- -    -         -  - -      -- -    -  -  - - --    --   -   -    -- - -  -  -  -  -  - --   -    -
-   -- -- ---  -  -        - -     - -      -  -         -- -         -   - --   - -  -    -    -  -
-    -   ---  --         -        -     -   -   --   -   -  - -   - --  -   -   -     - - -- -    --
-  -  -            -     --   -      -   --    -    --   - -   -     -    ---- -       --   -      -
-  -      --- -  -   - -  -   - --- -- -    - -  -     - - -   -- -      -     -   -    ----       -
- - -      -     --     -  -   -  -   -  -- -        - -- --   -- - - -    --  - -       -- ----  --
-     --  - -   --    -   --  -   -  --       -   -   -         -    -  --  - -   - -      -  -- - -
- - - - ---    --- - - -  -- --- -    -   - -  -    - -- -        ---  --     - --   -    -  -    --
-     -    -  -    -             ---  - - -   - --   -  -  -          - -   ----  ---  - - ----  - -
-    -   -   - --     -   - - -  -        -    -   -- -- -  -- -         --            -          --
- -  -  -      -- -          - -             - -   - -  - -      - -  -          - --- -- - --   - -
-     -   -   -  - -  -    --  - - -  -          - - -  -  -- - - --   ----     -     --      -    -
- - -          -  -  - - - -           -   - - - -   -  -  -    --  -  - -    -   -  -    - - -    -
-   -- ----   --      ----- -   -  -    - - - - - -   - ----                ---     - - -  - - -   -
-      -     -   -- -         - --    --     --  - -   -- -  -  --    -     -  -  -        -  -   --
--   -  ------ - -- -- --     ---  --   -   -      -      --    -     - -  -     -  - --     -  -  -
-    -   -    -   -  - -  -       -  -    -  -     - --    -- ---           -       -    -   - - - -
-- --    -  - - -   -           ---  - -  - - --   - -   -         --  -     - ---  - --  - -     --
- - - - -  -     -- - - -      -         -      -   - -   - - ---    --- -- --   -  - --- -  -     -
- -            -    -   --   --    -   --    -  -- -   -    --           -      -   --   --   -   --
- - -   - -    -    ---    - -       - --   -  - -  -         ---- -    - -        -  -     - -    -
- -- -  -    - - -    --    -       - -   --         ---    -     -   --   -       -      -    --- -
- -  -          -  -- -  -- -    - -- -    - -    - - -     -         -     - - -  - --  - -----   -
-  -   - -               -    - -      - ---   --     -  -  --   - -- - -   - - -      - -         -
-  -    -- -   ---      -  --    -    --    --        -   -- -   -    -     -- -  - -     - - - -  -
- - -    ----     -   --  - -  -   - --   -- - -- -- -  --   -  -   - --  -  -- - - -- -  - - - -  -
-   --        -    -- -  -  -- --    -       -      --     -       -  -- - --    ---   -    -     --
-   -    - -  -   -   -     -      -  -  -     --- - - -  -       -  - - -- - -  -   - - - --  --- -
-      -      -     - - - -    -     -   -- - -- -     -  - --- -     -  -    - - - - -       --  --
--        -  -   --           --      - -    - -- --     -           --- - -- -             - -    -
- -   - - -- -  -    - - -- -  - -      --- -- - --      -  - ---   -       -    - -               -
-  -- -    -- ----      -   -     -      -            -    - --    --   - - --     --   --     --  -
- - - - - -        - -   ---   -- -  -       --  -  - -      - -       -     - --    -  - --     ---
- -    ---   -  ---    - -   -    -   - -      -- --      - --- -- -   - -    - -  -    -    --    -
- - -   -    -- -    - -  -  -  - - -   --   --  -         -   -   -- --  -- -  -    -  -    -     -
-         - -     - --         - -  - --  -- -   -  -         -         -      -- --   - - -- ---- -
-   - -             -     - -    --  - - - -- -   -           --   -       --   -- ---  --     -  --
- - -   -  -      -  --        - -      -  -   - - -  -      - -- - - -  - - -   -  -       - - -  -
-   -      --  --       -    -- - -          - -  -     - -      -       - -    -     -  ----    - -
- ---           -- ----     - - -   --  --  -- - - - -  --     -   -    -   -- -  -          -------
-- ---    --- -- - -    -     -   --       - -- -  -       ---   -  ----  - - -  -  -    -  --     -
--  -  -   - -      - -  -       -    -- --    --    -- -   - --   -     ---- - -    --  -    --   -
-   -- -      -    - -   --    -  --    -  -    -  -- -    --  - - --     -  - --    -     -  -  - -
- -     -- -   -- - -  - - - -   -  ----   -  -- - - -         -   -  - - -  --        ---   -   - -
-     -   -    -  -        --  -   -  --   --     - - -   -  - ---  -  -  - -        ---    -      -
-   ---     --         -   -      -     --- -     -            -       -   -  -   -  -  --     - - -
-      -    -  --     - --    -      --    - - -       -        --      - - - - -  - -- - -  -    --
-        -- -   -  -           --   -        -  -    -      -       -    --  -   - -- - -  -  -- - -
--  - - -- - -  -    -  --  --  -    -     --   -     ---- -  --     -    --  - ---      -     --  -
- -    - - -  -- - - -- --    -    -- ---    -       -    -  -  - -  -        ---- -    -   ---   --
- --   --  -  -     --  -   - -   -  -        -   -- - ----      --      -    -     --  -  - - - - -
-     -       --    -   -  -- - - - -  ---  --    -   -    - -    -  -  -         -    - -   -- -  -
-   -   - -  -                 - -    -   -         - -- -    - -    -- -     - -  -  -  -     -   -
----------------------------------------------------------------------------------------------------
