100
100
----------------------------------------------------------------------------------------------------
-        -  -             - - ---    -       -   -  -   -         -  --  -      --   - --- -   -   -
--   -   -    -  ---    - - -    --  - -          -- -- - -   --- --      -   -       -            -
-       -   --  -      - -- - - -  -  --      -    --    -          - -      -      - -   -  - - - -
-- -- - ---   -  - -  -   - - -- - - -    --  - - ---    -- --- -      -   -   --     -        -   -
-   -      -   --       -       - -       -  - -  -         -       --    - -  -    - -- -- - -- - -
-  -     -  -- -    -     - -           -      - - - -- - -  -- ---      -    -         -    --    -
-  -     -       - --     -- -  --   --   -  --   - -       -  - --  -- ---  -- ------- --     --  -
--- -  - -  -- -     ---- -   - - -   -  -  -      - - -  - - -     -     --       -  - -  --      -
-   -  -    -    -  -  -   --   -  -- -         - - - -  -- -  -     -  --    -      - - -   -   - -
- -      --   -  -        -     -     --  -  --     -- -    -    -   -    -- -- - -   --   --      -
--- --  --  --  - -    -   -    - - -   -    ---  -  - --   -  --   -    --  -- -- --  -      -- - -
-   - -  -   -     --    --  --   -     --  - -  -     ---  --    -  -     -- --- --  -         - --
--    -    ---        -     -     --    - --   --- -         -        -      -    -      -  - - -  -
-  - -    -   - - - -   ----   - -- --                   --     --    -   - -  - -  -   -   - -  ---
-  -  --  -           --    -  -   -   -  -  --           - - -      - - --                 -      -
-   -  -       - -- -  -  -  --    --  --    - -   - -  -    -    - -- -  -  -    -    -  -   -   --
-  -     -  --  -    -   ---- - -    -    -     -  -   ---  -  -   -  - -- - - -- -      --        -
-       -         -     - - -  -  --     - ----  -    -  - -  ---    - -    -   --  - --    -    - -
- - ---- -    -- -    --      --     -    -     -- --  --       -  --   -     --- -      --    --  -
-- -    -    -  - -  -          -  -  -  -     - --   -     - -  --   -  -  --   ----- - --  - - - -
-  - -  --    ----  -- -- -- -      -                -  - -   -  -    - - - -              -   - - -
-- -- ---    - --  -    -     -  -   - --   - -- -   -            -- ---      -    -- --  -- --    -
-        -- - -  -   ---    --  -   -         - -        - -  -      - -  ----        - --- --   - -
-         --  -    -- -  -  -  --              -       - --  - -       -     --  -  -      -- -  - -
-    -  - - - -- --    - -   -  -  - --       - ---  - - -  -  -  - - -- - --     -    --        - -
- -      --- -  - - --  -    - -          -   -  --- --    -  -      -   -   --    --    - --     --
-  -  -   ---        -     --   --      -     -    -   ---  - -  --        -  --  -    -  -   -- - -
- - -      -     --    -   - - - -- - -- -   -  -       -  - - --   --- --- -    --     --         -
-  --    -  -     - -  -       -     -----      - -   -      -     -  --    - - -     -   -   --   -
- -    ---- -    -- - -  - -  - -  -   -        -  -   ---             - -    -  -  - --  --       -
-  --  --   -    -     -  - --- -   -    ---  -   -     -   - -- - --      - -    -  -  -  -     - -
--  --     -  - -      -        -   --  -    -  -    --     -   -   -      ---  --- - --   -     ---
-    -- -- --   - - -  --- -  --    -   -   --  - -   -  -- -     - -               -        - -  --
-        - ---    - --       -  - -     -    -  - -      -  - --     --   -- -  -      -   --- --  -
- --   --  - -         -   - -         -  -   - -    - -  -    -  --   -     - --              -   -
--   - -  -    -   -  -    -    -    -     -      -  -- -  --     - -        -      -    -         -
--   -      -    - --- --   - - - - -  -     - - -  -     - -          --- -    -   -      -   -- --
-  - - -      - --   -  ---  -     - - --  - --   -  ---   - -   -  -  --  -   -  - -   - -       --
-  --        -- -   -   -       --  -    -     ---   -    --   --  - -       -        -  -   -     -
-- -   --   -              --         -- -    -    -    -  -  --  -   -    -  -    ----       - -  -
-  -     -  -        -   --    -     -  -     -        ---  -  -  - -       -- -  -     ---   - - --
-  - -- -   -    -  -   -- -  -    -    -   -   --   - -  -  -     --     - -   ---  - ---  --   - -
- -    -     - - -    - -  -      -   -   - -- - -      -      - --   - -  -    -   -      -    ----
--   -  - -    -  --        --  -   -            -       - --- --   -        -   - - - -      -    -
-      - - - --   -       -   -  --         -  -       -   -   - -    --       -   - - - - -     - -
-   ---- -       - --    -    --- ----  - ---- - - -        --   - -- -       -        - -  -      -
--    -- - - --    -  -- -                    -      ------  -   -   -         - -      -     ---- -
- -       -- --  -    -    -  -  - -- - - -  ---         --  -   - -  - -  -  -   - - -    -  -    -
-       -  - -  - -  - - - --    -               -     -      - -- -                   ---      ----
-  -  -    - -    -   -     -    -- --    -   --  -    -   -  --           -   -  - -    -       - -
-         - -      -       --  --   -   -  -       -      - - ---  --  ---         -     -- - -    -
- -    -   - - - -    - -     -   --  - --      -     - --  -   -    -       ---  --- --    -    - -
-  ---      --- -  ---   - -   -  - ---  -          - - -- --           -      --     -  -  -  -  --
- - -- -  ---  -  -           - - -      -  -  -   -  --      -     - -- -      -    -- -        - -
-   --  --      -- -     - - -- -- -   -    -  - -  --   ----   -   - -  --  -  -        -   - -  --
-    --   - -   -  ---- -          -           - -   -  - -   -  -  -   -  -   -  --   -   --      -
- -     - -  --   -      -- ----  -- -          --  - - -   -     --  - --- -  -  -   -    -      --
-    -- -       -      - -- -  - -   - - - -       --  -       -       -            - - -  - -  -  -
- -         ----- -   -- --    --      -    -    - -        --      ---- -  -  - -  -      -      --
-    --   -- -      -      - --          - - --  -  - --     -    -          -- -    -   -  - -    -
-- - -  --    -- --    -  -     -  -  -      -          -    - - - -   --- -   - -- -- --    -  - --
- -       - - --         -- -   - - -       -    --   -    -                    - -   - -  ---     -
-       -   - - - -     -      -     --  - -  --            --    - - -      -  -     -  -   -    --
- --- -       - -           --         - - -    --   -- -     - -       - - - -    -      --  - -  -
--   - --  ---    - -    -     -       -         -               -  -  -- -  -    - -    -- - - ----
- -     - -   -----   -    -  -            -     - -    -  -- - - -  -     --  ----        - -  -  -
- -  -             --   --   -   -    --   - -     --  -  --  - - --      -   -     -  --- - -    --
-   --  --    ---   - ---   -  --- -- - -  --         - -         -   - -   - --     - -        - --
--       -       - - -          -        - - --  --    ---   -   -       - --   -   -       -    - -
-  -     -     ---  -  -  - - -- ---- -   -     --    -  ---  ------ -    -   -    - -          -  -
- - ----     ---   -    -   -  --  --   --  ---    --   -   --             -   -- --       --  -   -
-  -  -         --      -- - --   -  ---   -  -  -      - -    - -  - - -      - -  -  --      - - -
--      --  - - - ---       -  - - -   -  -  -  -- ---                 --         -      --    -   -
-    -- -       -   - -- - -      -  --- -- --- -- - -  -   -     -  - --      -     -----  -- - - -
-- - - - - -- -         -   - --       - - -  -   - -  - --            -     -  --   -  --         -
-  -- --    - -    - - - - -  -  -  -  --  --   ---  - -  --    - -    -     -    -  --- -     -   -
- -   -     - - -      -    -- - -           -         - - - -          ---         -    -    --  --
-    -- -  -    -    - --    -  -     -    -   --      --    -- -      - - -  -     ---      ---   -
-   -      - -- --- --- - - - -    - --- -         - --   --  -   -- ---    - --     -    --    -  -
-    - -  -      - -  - -       --  -  - -    -  -   -          -  - -     -   - -  -   -     -- - -
- - - -       -    -      - -       -- - - -  -- --  -- --- -  --   - ---   - -   -      --    -- --
- - -    - -    - -  -  --   -- -  --- -- -     -    - - -    - -   --       ----  -    - -      - -
--          -- --   - -     -  - ---     - -  --   - -     -  --  --  ---  -     - -  ---    --- - -
-      - --     -       -  -   -         --     - - --  --  --   - - - -     --  -- --  ---   ---  -
-    --       -  -  -       --- -    -            -  -- -   -- -  -- - -   --- --  -  ---    -    --
-      -    -  -  --   -  -  -- -    -- ----   -   -      - -     -   -         - -       - -- -----
- --     - - -  --     -- -  - -   -        -  - -  -   -  -- - --   --    -        - --- -  - -   -
-- - -   -    -   -  -  -     -    -    --    -- -       --- -  - -    --  - --     - -   --- -- - -
---  --   -      - -    -  -  - -            --  ---     -  - --   --       -      -    -   - -    -
-   - - --- -  - -  - - ------        --- - -  -     --    --- - --  ---    --    - -    - -      --
- -- - -   -     -         --    -      -     --  -      --         -  -      -  -   - -  -  -     -
-   -  - -  - --      -  - - ---    -    -     --          -- -    -  -- -   -  -  -   -- -     -  -
--      -  - -- --    - - - --  - - -  -    -- -     --        - -  -  -  -- -- ---    ---       - -
-  --   - --   -    -       -   -  -  - - -   -  - -         - - --  --    -   - -     --      -   -
- -   -  -- -  --      -- -  - - -  - - -   -  --      -- --   - - - -     -- --  -  - --  -- - -  -
--  -    - -- -                  -    -  - -         -  -  -   -  -    - - - -   --  - - - -  -   --
- ----  -- --         - -   -  - -    -    --           -   --    -   --  - - -     -  -  -     -- -
-    -           -    -   -    -   -  - -          -  -        -   -    -  --  -                   -
----------------------------------------------------------------------------------------------------
