100
100
----------------------------------------------------------------------------------------------------
- -    -       -    -          -  -  -        -  -     -           - - --     -    -     -     -   -
-     -  - -   -   - -  -   ---  -    - -----   -   --  -     - --- -    --      -  --   -  - - -- -
-    -  --  -  - -    --   -      -    - -     --            -    -    - -   - -          - --  -  -
- --    -  -     - -         -      -- -   - --    -- -            - --   -  -- -  -    -       - --
-- -  -    -     - --  -  ---  ---  -   -         -      -    ---  -      --      -   -- - -  -    -
--  -      -    - -    - -        -  --   - ----  - -        - -- -- - -         -    -  - -    -  -
-   - -     --   -----     - - - -           -- ---  -  ---  -         - -   ---  - -    --      - -
-   - -        --      --        - -   -   -          --  - -    - -- -    -     --    --  -- -  - -
- -  - --        --  -          --   -   -  -  --       - -- -  -    -  -   - -    - -   -  - -   --
----     -  - - -- --    -    -  -   - - ---  -- -   -            - - - -    --  -          -   -- -
-  -   -     -  --   -    - --    - -   -  --     -     - -     -   -   -- -   -   -   -   -   -   -
--  - --   --  -  --      ---  -   -- -  -   -     - --   --    -           -   - --       - --    -
-  -- -  -       -  -   -     -   -     ------     -   --  -- - -   -- - -   --   - -- -    -- -   -
---   --- -  - -- --  -   -     --  -          - - - ---   ---   -   -  --   - - - - -       --  - -
-   --      - - -    -  --   ---   -      -  -        -  - - - - -    - -   -       -  - -      -  -
- - -   - --- -    -   -   ---    -- -   -        -   - -   -         -     -   - --  - --         -
-    - -      -       -      - -  -    - - - -  - - - -   --  - --  - -- -     -   - -         - - -
--   - -- -   -   -      -----     - - --  -     - -    -   - -    - - -     -   -   - -- -- --- ---
-        - -    - --  --   -  --     - --       -- --     -     ---       -    -   --  - -   -   - -
-   -    -        - -    -  --          - -- --  -        - - -                 -   --   -     --  -
-  -  -     -- - -  -  ---     -      -     -  --     - -   -  ---        - -   - -- - --     - -- -
--   -- -  --- - --  -   -    --  -- -     -  - -   ----  - - - - -  -   -    - - -      -       - -
- --  -  --    - -   --       -      --   - - - -  -  - -    -       -   --  --  --        -   - - -
- -   -   - - -  -  -          - -      -  - -     -     -        -         -    -   -             -
-  --   - - ----      - - --     - -- -  -- - - ---   -     --    - - - -     - -- - -  -      - - -
--   -   ---    -   --                     -  -    --    -       -  -     -   -    -   -  --     - -
-   --   -   ---        - -   - - - --   -  - - -    - --  - -      -   - -     -         -    -   -
- - - --   - -   -  -- -     -  -- -    -      -              -      --    - - -    -    - -    -  -
- - - -   -   -      - - -  -   ---    -       -  -  -   -- -      - - -    -    --    -  - - --   -
-    --   - -     -     - -   --    -   -- --  -  -   --                - -  ---        -        - -
--- -- -  --  - - - --   --    - --   -   -  -- -  -  -  ---            -    - -   -- -- - -     - -
-  -   -  -    -- -   -        -     ---- - -      - -- - -   --- -    --      -  -- -   -   -   - -
-      -- - -    -    -  -  - --- -- -       -      -      ---    - -  -  -   -         -- - - -- --
--  - - -- -  ---           -   -        --    - -   - ----  - -     -    -   ---  - -  - -- -     -
- - - -     --    -   ----     -  -  --  --  --       -- -   --- - -   --   --     -  -- -   - --  -
---    ---    --  ---  - -   -- -   -   -   -   -    - - - -     - ---   - - - - -  -    -   - -  --
-   - - - --    -   - --    - --    -   -- -       -  -    -     -      -     - -  - --  -    -    -
-- -   ----  - - -          -    -  - ---  -- -          - -  --   - -- --    -- -   -   -   -  -- -
--   -   -- -    -   -   -    -----    -     -      -  --   -- -- -   - -   -        -   - -  -- - -
- -               ----- -      -     - - -   -    --- - -   -     ---         -   -    - -     -   -
--           -      - --   --             -    -     - - --  -         -    --- - -          - - - -
- --        -      -        -  --   -       -           -  -   -       -  -     -   ---    --    - -
-   --    -  -      -       -  -- - ----- -   - -  -  ---      - -   -    ---- -- -   -   - ----   -
- -     --   - -  -   - - --- -  -    - -     - - -- --  -  -- --            -        ----- -- - - -
--  -     --       -  -   --- -       -   -     -   -    -     -     -    -   -    - ---       - - -
-     - - - -    -         -      -       -   -  -- --   -  -  ---      -- --    ---     -  - -    -
-- -  -    --   -    -  ---  --  - - - --- -       -    -   -  ----  - -      ---  ---     -   -   -
-   -       -   -  -      - - -- -      --   -    -     -   - -    - -  -- -- -    -    -    - - - -
- -  -     -   --       --   -  - - -       -    --    - -  - -   -- ----         -       - --     -
-   - -   -      ---    - --  -     -  --     --   --    --                 ---   -        --  -   -
-- -- - -  - -- - -   --  - -     -   -   - - - -  -- - -- - --  ---   -   -   -  --      -        -
-  --    - - -  -   -     -   --   - ----    -  -           -           -   -   -    -  -   -  -   -
-    -    -  --           -   -   - -     -  -    ---  -  - - -   -  - -  ---      -  --  -    -   -
--     -   -    - ---  -    - -- - - - - -            ---    -     --    -          - -  -  - -   --
-  - --        -        --    -    --             --  --   ---- - -  -  - --  - - -   - - -     -- -
-      --     -     -- - - - - ---- - -  --     -  --     -- - --       -   -              --     --
- - --     -      --    -       - -    -      -     -- -         -  -  --  - -     --    -  -      -
-      -   -  - --  --     - -    -  --  -- --         --    -      -  -          -  - -       -   -
- -      -   -   -       - -       -   -    -- - -  -     - -    - -     - -           - --- -  -  -
-   --   -- - --   -    - --   -    -    -   -      ---  - - --  -       -   - - -     -   -  -  ---
-     --    -   ----  -   -  ---        - --  - - -        -      - -- - -- -  -  ---   -   - ---  -
-- -    --   -     -     - -  - -- -       -   -           - - ---           -- - -     - --   - - -
- -    - - -    ---   - -  - -     -  ----   - --  - -- -   -- --    -    --  -  -   -- -    - -  --
-- ---     -   - --     -- --  -- -    - -   -   -     -  - -     -      -  - -      -  - -       --
-             -   --  ---    -   -       -       -         -    -    - - -   - --  -    - -   --  --
-  ---  -  - -   -    -  --- - --   -- -  -- - - - - -  -   -   -      --            --     -    ---
-   -   -   - -  - -   -    -- -  -    -  - - -  --       -- -        -   -    - ----- -  -    -   -
- --   -  -- - -      -   --     -  -   -  --- - -  -   -       - -       -  -                 - - -
-    -      - -- - --  - - --- -   -- -         -       -   -        -- --- --- - - - -   -        -
--- --- -    - -   -    -  --  --   - -  - -   - -   -      -    -  - -- - -  ---   - -    ---     -
-  --  -   - -        --      - ---            - - -         -   -  --   - -       -  - --     -  --
---  --     - -      -  -   - - -  -   - -     -     -  -   -  --  - -  --   -  -- - - - - -  -    -
- --    - -     - ----   --     --  -     -       - ---       -  --     ---  - - -     -  -    -   -
-        -    -- -   - -   -   --  - -  -  -- - -- -      - --      --      --    -          -     -
-  -    -  ---  --- - -  --        -   - - -  -  - - --      - - -        -  -- --  - -   -- -    --
-   - ---  -          --   -  - -    - -  - --   -          -      -  --   -- - - - -- -           -
-  -  -      -   -- -   -  -- - - -   -  -  - - --- -        -  -   - -  ---    - -     --    --   -
-   -  - ----  -   - -          -  --  -   -- -    -   -  -  -       - -    -  -- -   -  -- --     -
- -   -  -   - -    - --  --     -      -      - - -  --- -  - --  -        - --  -      -    ---- -
-  --         - ---   --   -      -- -  - -  - - --        ---     - - --  --  - -     -  --    -  -
--          --  --   - - -      -  - -   ---   -     - - -         -      ----   - --  -     - -  --
--      -     - - - --     -            -   --     -   --    - -               -      -  -     -   -
-    - - -   --   -  -  -      -     -  -  -- ---  --          -- -  -    -    - -            --  --
-  -  -   ----     --       -    -     -      - -     ---  -  -    ------           -  -    -      -
-- -   - -     - - -- -   --     -  -  -    -- - - ----      --               ----    --  -  -    --
--   -     -   - -    -  -       -   --    -  --       -   -  -- - --  -   --     - -              -
- -  - -  - -            - - -       - -   - -      -  -  ---   - -     - -    -    - - - --  -  - -
-  --  --         - -     -   --    --  -                    -- - -- - - -  - -    -  -    -  -  - -
-  --  -  -    -   -   - - - - - ---  ----       -    -- --    -        -   - -   -     - - -      -
-     -     -     -- -  -       -  -   ---   -- -  - -       -  -  -  -       - - --    ---   --  --
-   -- -  -  -  ---        - - -  -       - -   -   -   -     -   - --  -   -   -- -  -    -- - -- -
--    -  - -- --  -- - -  --    -     ----   - ---- --  -             -    --   --   - - --   -    -
-   -     --      --    -   -      -  -  - -  -  -     - ---   --  -- -- -     - ---- -     --  -  -
-- - - -    - -       --    - -     - - -  -   -   -  -- --  -          -  -   -        -   -- - - -
-    --   -      - -   --   - -    - --   - --  --     -   - - ---- - --       ------ -          ---
-     --   -    -- -       --          -    -     --           -       -- -      -   -   -  -- -   -
-- - -   --  -  - -  ---     -         -   -- -     -      ---    -  -    -        -  -     -      -
-            - - --      -     -   - --   -   -        - -    -     ---    -    -    --  - --  -   -
----------------------------------------------------------------------------------------------------
