100
100
----------------------------------------------------------------------------------------------------
- - -            -  -       --      --       -     -   - -   --   -    -      -     -    -         -
- -      - - -    -      -    -          -   - - -   -  --                 -   -  -  --    -  --   -
--   --   -        --  -   - - --       -  -   - --     -  -        - -- --   -  ----  --- -  -    -
-    -   --    -  -  -   - -   - --- --    --    -  -     -   -  ---      --     -  -- - - -  -    -
-    -  - --  --   -   -  - -          - -     --           -- --     ---  - --         -   -  -   -
--   -         -      -- - - ---- -----    --  - -- - -           -- -   -  - -  --    - -       - -
--   - -                     --     -  --- -   -   --    --   - -     -    --       -     -  - -  --
-   - --- -- -- - --  -- -- -   ---   - - -   - -  -        -          -   -   --  -    - --     - -
-    -         - -    -  - -  - -    --     -   - -     - - - - -  -  -  -       - -  - - -    --  -
-    - -   -- -  --         - --     --      - - -     -  -  --   --      --    -  - -      -   -  -
-    -- - - --  -  - - -     -- - --       -- -     ---- - -       -  - -     -  -        - -    - -
-   -- - --- -  -   -   -   -  --   -     -  -  - - -            -     - -- --  -- -     -    --   -
-    -    - -    -        - -   -      - -  --         - - -- ---  ---  -            -   -       - -
--   - -          --  -    -   -    -    -     ---   -  -    - - --         ---   -  --       --  --
-- --- -- -    -         --            -  -- --  -- --    -       -  - -   - - --      -- -   - - --
-- -  -    - -   -- --   - -   ---   -  --           - -- -  --  -    -    -        ---    --- -   -
--   -            - ----     - -- -- --          --      -       -   -        ---  -    --         -
---  - --     -- ----        -        - -- -  --        -   -       -  -  -          -  -  --      -
-- -  -  ----- -  -        --    -    -   - -  -     -  - -        -  ---  ---  -    --- -      -- -
-         -  -- - - -----           -   -            -  -  --    --       -         -    - ----    -
- --         - -- -   -   - -  -    - - ----    - -       -  --- -        --  -   ----     - --    -
- -   - ---     --      - -      -    -   --         --  -      - -       --  - -         -    -   -
---  -   - -- - --   -  -   - -   -   -         --      -  - - -      -  --  - -    -- ---  ----   -
- --- --     -     -  -  -   - - --       - -  -  -            -            -   -  -  --- - - -    -
--     -  --- - -     -- --      ---          -   - -   -----   -   - - - -  - -   -      -  -  -  -
-   -- -- -  -             - --    -         - --  - -               - -   -- --               --  -
- -   - - - --  - -  -  -      -    - -    - -  - - --      -  --  -   -  - -    -   -- --   -  - --
- - -- -        - - - -      -    -   --  -      --  -- -   -     - -     -  - -    - --  --  --  --
- -      - -    --- -- --      -  - - --   - -  -- --  -   - -- - -    -            -   --   - - - -
-    ---  - --     - -   -    - -           -    -     -  - -     -   -  --  -    -       -----    -
--   -     - --   --  - - -      --  --        ----     ---   --    -       -   -   -- ---   -  -- -
- -    - ---  ---   -      --     -     ---  - --      --         -- -   --- -   - - --    -   - ---
-         -    -  -  -- --  -     --  -           -  --- - -    -   --       ----  -     - - -- -  -
-- - --      - --  - --- -       - -       -- - -     -- -   --    -  --      -   - - -    -  -  ---
-   - -- -                 -- -      -           - - -  -- -   --           -  --     -   - - -   --
--  -       - - -   -  - -    -     --      - -    -  -   - -----  - - -   - -    -  -    -- --   --
-   - -- --- -      -  -  - -      -  --    -  - - ---              -          -    -     -  - --  -
-   - -        -        --- --- -   -     ---   - -    -          -  - - --   --   - -  --   -     -
-      - -          -      -  -  -     -         -----   - -- -- ---    --    ---  - --     ---  - -
- - -  -   -   --- -    -        - - -   -    ---       -- --  -   -  - -  - -   -  --  -     -   --
--   -   ---  - -  - - -  - -   -    -  --- -  -      --   ----- - -  -   - --   --   --    -   -- -
-- - ---           -     --    -  -         -   -               - -  -   -        - -     -- -     -
-     -   -    -  -   -    - -      -   -- -  - -  -    -   ---   -  ----  --     - --  -  - - -   -
-         - --   -         -  -  -     -           - -    -  -  - ----         - - -- -       -  - -
-  -     --- -   -     ---- -   -  -  --   -   - -- -   -     -   -    ---   -  --  -       - --   -
- --  -   -   -  -       -    - -  -   -     -  ---  - - -          -  -  -   -  -   -  -  - -    --
-     - --      -- -----    -- -      - - -   --       -  -  - -   -      - -  -  - -  --       -  -
--    -    - -- -   -   - -  -   -  -  - --  --  --  -  - -  -   -  -  -     -       -    - -   -  -
- -    -     - - -      - ---   -   -         ---  -  -  - -        -      -     -   - --  -  ---- -
- - -     -- -   -- - -   - - - -      --      --      - - -    -      ----  - -   -  - -- -      --
- -- -- --- -  -- --    - -         -   -    -  -    - -   - -  -   -  -  -  -  --- -  --   -  - - -
-     - -     -    -       - - ---      -    -  -     -     -         - -  - --      --  -    - - --
-- -      --  -   --  --    -          -  -  -               -- --  -  - - -     --  --   -   -    -
-    -- -  - - -          -     - ---- -  -   --         - -    -  - -  - - -     -    --         --
- --    -         -- -    -  -      - -     -        - - -    - -  -  --- -   -  --- -   -   -  -  -
--      -- -- --  --    --  -    -  -- -        --         -- -       - -     -   -   -- -      -- -
-     --      - -- -      --          - - -   -   - -  -  --       -    -  ---      -    - - --  ---
-    -  --  -     - --- -    -  -           -   -       --   --   - -  - -       --  - -         - -
- --      -      ---     - -  -     -  -----  -   -   --       -  ----    - -  -    -     -        -
-   --- -     ---  -- - --  -  -- - -   -   - -   -     --- - - --  --  - - ---   -- --    -    -- -
- -         -      ---    -    --           - -   -  -- -   -    -    -- -      -    -       -     -
--           -- -     -         -   --    -    -   --   -   -      --    -   --  --    - -  - -   --
-  ---  --  - - -- --  -- -  ---       - -      - ----  - --       - - -  -     - -  --   ---  - - -
-- -       --   - -  -     -    --    --  -  -    -   - - - -  --- -        ---              --  - -
-  - --      -    -   -- -     -   -- -  - -  - --   --  -  - --     - -     --  -  -   --  -   -  -
--         - -   --     --- -       -       -   --  -     -   --  -    - - -- -  --  - -      -  - -
---  -  --     -          -    --  -   -    -          - -  -   -  -      -    - - -       --   -- -
-  -      - -    -- -  - -  --   --- -       -   - -- -   -   -   - -     ---     - -   -- - -     -
- -      - -    - ---- -          -  - -     -   -   - --    -   --         - --- -- -    -   -  ---
-  --       - -      --    -- - - -  --     -- ----- -    - --  ----      -  -    - - -  -- -  - - -
- - --  --- -    --  -      ----  - -    - -       -    -     -----     - -  --   - -  -  - --     -
- - -  --  - - -  -- - - - -     -          --   -     -    -   --          -      -- ---         --
-    - -   -     -    -       - -      --   -    -  -   - ---  -   --  - --------  -    -     - -  -
-   -  -- - - - -      - --   -   -  -  -  -   -   -  -      - -- -   -     --   - - --  --   --   -
--      --  -- -       -     -     - - - -  - -  -       -  - -  -  --    -   -  -   --   - - -   --
--  - -  - -     -          - -     -         --   -   -  -   -          -   --  --- -         -   -
--        - -           -      -    -  -  - -- - -            -     -   -  --  -     --    - -  -- -
--     -     --  --   -  --   - --   -      -      -      -       --     --  -  -    - -- - - --   -
-   -  - - - - - -- --  --  -           - -   ---    -  - -  ---    ----        -        - -    -  -
-  -     -  -   -  -    - - ---  - -   - -  -   --  -         -- --     --  --          -   - -    -
-  -  -         -  --   -- -  - -    -      --- --  - -  - -  -  -- - - - -   -  -   ---      - - --
-  -      - - -     - -  - --  -   - -     - -        --   ---    -  --     --    - -  -    -   -  -
--     - - - -  -  --   -- -   - -  -      - -- -- -     - -   --- - - -  ----    -  --   -  -  - --
-- -- --      - - - -    -  -        -     -   -     - -   -   -   -    -      ---         -    -  -
--     --  --    -    -  ---  --- ----    -  -  -  -   -  -     --   - -   ---     -    - --  - -  -
-   -     -       - -  --     - -       -   -       -  - -   --- -    -  -- -   - -   -    --  -   -
-   - -  ------ - -   -               -      - -   - -     --       -  - -  ---     --      --     -
- - -   -      -         --  -   -  --- -    -  --  -    --    --- -   --  - -   -     -  -   --   -
- - -    -     - - --          --   -     -  -       -      --     --    -   ---  - ---- -        --
-        - - -         -   -  -    - - -- - -- ---        -     --  - - -- --    -- -  -  -   -  - -
-    --            -   -  -    ---    - -  -- -   -  -   - --   - --  -   - --  -  - -  ---   --   -
--     -- -   -     -   -   -     -- -- -       -    -     -- -        -      ---     -    --   - --
--    -  -   -  - -   -      ----  -  - - -        --   -          --     --   --    - -      - - --
- -                   -- -  - -   -     -- --   - -   -      -    -    --- - -    -  --   --- - - --
-    --  -- - - - -    -         - -     -        - -- - - -   --   -    --  -   --           --   -
- - -      -           --     - -  -    -    -- -   ---  -- -     --- ------         -   -         -
-- ----     -  -    --  - -- -- -  - --  - -   - - -   --  -    - -- -           -------  -   -    -
- -   -  -  -         --    -         - -     -  - - -   - - -   - -   ----  -               -     -
----------------------------------------------------------------------------------------------------
