100
100
----------------------------------------------------------------------------------------------------
-  -     - - -  ---  -  -  -- -    -   -   --    - -  --   -    -  --        -           -         -
-        -  --  ---  --       --   - - - --        -    -  -        -  --       -       --    -    -
-  -  -    -  - ---   -    -   --    -  -  - --- -- -     --  -   --  - - -       --       -- --   -
-   -    -  -   --  -  -      -  -   - - -          --- --  - -     -       -   ---     --     -   -
-    -     - --    -  - -              --  - -    -          -    -  ---  -   - - -   -    - -- -  -
-     --    --  ---       -  -   - --    ---     -  -- -- --- -   - -   - -    - -- -   -  -     - -
--              -    -    -  -     -      -   --          --    - - - -  -          -      -     ---
-     -  --- - - --    -  -   --   -   - - -   -        - --  ---   -  - -  -  --   -  --  --  -   -
- ---     - - --   -         - -----    -- - -- - -  -   -  - - - -- -         --   ---   -  - -  --
--           --    - --  -- ---  -  --   - -       -    -  -     -        -        - -     -  - -  -
-  -   - -  - --   --    --    -- -  -    -   --  -  -     ---     -   ----   -- -  -  -  -   - -- -
-   -   - -       -      - -       -  -     ---   -      - -     -     -  ---- -  -     -  -  -    -
--  -   - -  -   -           - ---  -- --  -      ----   -- ---- -    -          -   -  - -    -   -
-  -   --      - ---    -   -      - -- - --    - -    - -- -  -  - -    -     -  -    -   --      -
- --  -  --     -      ---    - --       -  -    -  -   --    -     -- - -   -     -   --    --  - -
-  -   -     - -  --       - --- -   --     - --   -        --   -     --     - ----         - -   -
- --     - -       -   -   ---  -    -     - - - ---   -   -  -    -         --    -    -- - -   - -
--  - --- - - -  -  - -      -  -    --  -   -      - - -   ----- -  -    - --   -   -- -    -     -
- - --      --    -   - -  ----  - - --- -- -   -      --  -      - --   -- -   -       -     - - --
- --   ---  -    -  -- -    -  - -       --    --    -  -   -   -   --     -     - -  - - - --  -  -
- --    - -      -  - -- -    -- - -        - -         -   --  -  -   --    - -- - -- -  -    - - -
--   --  --    - -   --  -  -- - - - -    --         -   -  -    -     - -    -          --      - -
-  --      -- -    -    - - -- - -      - -   --   - -        -- -   - --   - - -  - -      -    ---
- -  --  -     - -  - - -  -  - -   -        -- -  - -- -         -       --     -- - - - -        -
-    --           -     ---      -  - - -  -  -  -  --     --   -- -  -      ---  -   - -   - - -  -
- -     -      -   --  - - - -   -     - -  --   -    ---  -      -     -- -   - -   ---        -- -
--   ---     -    - - ---           -       -        -      -  -- - -   -      - ----    - -     - -
-    -  -   -  - -   -   -  - -      -   -   -  --   - -  -  --   - --  -     - -   --    --       -
----        -   ---       --  -  -- -    -    --   --   ---   -     -----      - -    - -   - -    -
- -  - -- -- - -      -     -              - -   - --      -      ---         - -  ---- -          -
-         -      -    -- -   --   ---     -  -  -      -   --  - -      - ---   -     -         ----
-             -     - -    -    -- -    - -  -   -   -    -- ---     - -        -    -          - --
-  - - -    - - - -   -        - -     - -- -  -- -    -    - ---    -  -    -   -  - ---   --- -- -
- - -  -   -   - -  -   -       -   -   -   -     ----  -      -    - - - -        --         -    -
-     -     ---        - - --  - - ---  --     -   -  -      -  - - --   - - --    --   -- --   -- -
-      ---  -    --  --  -   -    -  -  -       - - -     -- - -  -   - --   -   - - --  -  -    - -
--- - -         - -   - ----- -  -  -  -     -        -  - - -   -  --  -    - -    --          -- -
-      - -      --    -     - ----      -- --- - -            -  -  -  --  - -     -   --  - -    --
-                -- -               -              -    ----- - -            -- -    -   -    -- - -
-     -- - -  --   -   --  - -   -  - - - -    -  - - --  -  --- --- - -   -   --- -  -   - -   -- -
-   --  -  -     -   -    --        - - --  ---   - -- - -  - -           - -  -  -     -- -   --  -
--  -  -- - -        -  -   -   -   - -          -- - -   - -  - -               -  ---- -----    --
- - -   ---  - -             - -   - -  ----   - - -  --      -  - -      -- -        --    --- -  -
-   -    --        --- -     - - --           --          -         -  --   -   -----      -     ---
-  -   -  -  ----    - -                --   -- -     ----  -      - - - --  -         -     -- -- -
-           -    ---   - --               -       -- -  - --- - -   - -          -   -       -   - -
-    -         -      - -- - ---  --  - -  -  - - -    -  -  -   -  -   - -  -   - - -     -  -    -
-  --  -- - - --- - -      -    -       - -    -  - - -  -  - -      - --   - --- - ---   -  - --  -
-    - - - -     - -  -  -  - -     - -    -  -  -   - - -     --- -- -  --  - --  -    -    -    --
-  --- -  -   --  -  -  -   -   - - -     - -- - - -      -      -- -        - --   --  -  -    -- -
---      -  - -     -     -        -  -  -   -   -      - -- - -     - --    -      - -   - -  -  --
-      -  -      -  -       - -- - -  ---    -  -  --  -- -- -     -  -  - -      -  -- --   - --- -
-       - -   -    -  -  - -     - -            -   - - -     --    -            - -   -  - -    - -
-   - ---      - - -              - - -      -  - -- --      -   --               -     -   --   ---
--   -    --      - - - --          -    --    - - -   --   -     - - --     - - -  -  -           -
- -- -  -     - - -        -     ------  - - -  ---   -  -         -- - -- - -   -- -  - -  -   ----
- - -  -  - -     - ------- --        - - --          - - - -   - -  -   -  - - -       -  -       -
- - - ---  -    -    --       -   ----    - - ---   - -   -  --- - -   - - -  -   ------- -  ----- -
-   - -  --  -       - -  --  -     -   -        -    --      -     --   -    --   -  -   -        -
-    - ---- -  - -  -  -  -     -   -     -     --- - - - -  - - -    -  -  - -  -  -  --  -  -  - -
- -- - -        -           -- --  - --  -          -       -- - - - --  -       -   - --  - - --  -
--       --    -  -  --    - -  - -            -   --         - -  --     ---  -   -     -  - - -  -
-  -     -     - -       - -    - --     --  ---  --   -  -  -- -    --     -  -----    -          -
--            - - -       - -      -  ---             --    -  - -  - -                 --   -  -- -
- -    -        -   -  ----     -  - -    - - -- - -- -          - - -          - - --- -- -    -- -
-  --- -          -   -    -- - --- -      -  - -     -- -   -  -  - -  -               -    -  -  -
-- -- - - - -     --  -  - -       - -   - - -   -       -  ---   - ---- -      - ---- -   -       -
--  - --   -  - - -  - -   - -     --   -      - --   -         -  --     - -       -         -   --
--  - -    - -     -   -   ---      -   -     ---    - - -  --   -   --     -- - -         ---  -- -
-  -  - ---   - -   --- ---         --  ---    --    - -   -        ----- -    - -   -  -          -
- - -   ---  -    --   - -    --    - -       -       ----   -  --    --- --     - -  -       --   -
-  -  -    -  - - - --   - - -   -- -  - - -  --  - -   -     - -- -            - -  -  - --   - - -
-  -    -- -- -   --        -     -  -    -  -     --     --       -   - - --- ----       -    -  --
-     -     -     - - - - -  - -    -          --   -          --   -   -    -           -    -    -
--  -           -    -  --  -    -     - --   -  --  - - -  -- --     -- --   -- -  --   -  - -  - -
-  -  -----                  -       ---    - --  -  ---      -- - - -   -  --  - -      - -   -   -
--   -      --    --- --      --        -   -    -      ---         -     -    - -    -   - --  -  -
- -    -- -   -    -     -- --  -     - - -    - -      - - -     -     -- -        -     -  -     -
- - -      --   --      --     - - - -   --  --  - ---- - -   - - - - -   --   - -   --  -- - -    -
-     -  --  -     --- -  --    -      -  -            -    -    - - -- - - - -   ---      -   -   -
-      -       -    -    - - ----          --    -         -      -   --- -        -- -     ---  - -
-  -     -   -   --- ----- --  -  -  - - -        -      -       -  -     -   -  -- - - -      - - -
-   - -   -- -       - -     -   - --   --- - - -       -          -     -  - -       - -          -
-  -      -        -  - - - -  -   - -       -    -- - - -   --    -   -   ---  --    -  -    - -  -
--   - --   -    -    -    -   -  -       -      -   - --- - -      ---         -   - - --      -  -
- --     --- --          -   -     - -   - -  -- --    -    -  -      ---   -  -  -  ---- - -   -  -
-    -  - -     ----     -    --   - - --            --       -                 -     - -     -   --
- ---     --     - -      -        -- -   -  -  -        - --    --   -- -    -   --   -  - -  -   -
--   -  --- - - --- -- - -    -      - - --       -- - --   --  ---  -- -  -          -  --   - ----
-  --       - - -   -  -      -   -       - --  -- -  -- -   -  -  - -      -- - - --- -    - -    -
-   -- --    --      -    -  -    -   -  -            --   -  -       -   -    -  - -  --- ----    -
-     - -  - - -     - -      - - - --   --     -            - - -         ---- - -  --  --  -- - --
- -  -     ---    -     -      -         -- - -- -   -        -  - -   --          -    -   -- -   -
- -       -    --    --    - - -- - -   -    -    -  -   - -- - -          -  -  -       -   -    --
-  --   - -            -- - --- -      --    - -- ----   -   -   -- -  -    -  -  -    -  -     -- -
-  -              -  - - -- -  - ---  - --- -  -  - -- - - -   --   -   - --  -  --  -      -- -  --
-     -  -     -- -      - -   - --  -        -    --        -    -  -     ---      -  -  --   - - -
-  -    -  -      - --     - -      ------ --    --      --   -          -    - -  -     -     -   -
----------------------------------------------------------------------------------------------------
