100
100
----------------------------------------------------------------------------------------------------
-  -    - -           -- ---  -         -   -  - --- -    - -   --  -  --     -        -   - -  -  -
- -    - - -  -- --    - -        - -  -      -     - ---     - -  --  -       ---    -  - -    -  -
-  -  -     ---   -- -- -   -  --    -  - - -     -     --    -               - -   --   - - --  - -
-  -     - -    - -     -      - -   --    ---   -  -- -    - - -    - -      -- -       - - -- -  -
-  -   - --- - -   - --- - - -   - -  -        -    -    -- - - - --- -    --   -  - ---- - -      -
--   - - - -  -         --    --  - -  -    -          -   - - --       -          - - - -  -     --
-  --   - -  --    -  -    -- - -- -    -  -    ---  --   -   -      --    -  -          -  -   - --
-  -  -  - -   -   -     - ---   - -    -    --   -       --   --- -     --    --  - -       -     -
- -    -   -       -  -  -         --- -  - -    - -    --         -- --   ----       --- --  -   --
- -  -   -- - --  - --- -- -      -     -   --       --   ----    -       -  - -  - -   -  -    -  -
-- - --   - -   - - -  --  -   - -  -   -   -  --  - -         -  -- - -      -   - -         -- - -
-     --  -           - -            -  - --    -- - - - -   -  -     - --              -   -    - -
-- -    - -- -- -   - -    - ------      -            - -           -      - ----   -  -  --   -----
-     -   - -   -- - -- --     - -  -  -   -     -        -  -       -- ----       -    --    -- - -
-  --    -  --- -     -      - -  -    ---- -     -- -   --  - --     - --     --               -  -
-       --    -   --  - - ---  -   -   - -               -   -  - -         - -    -- - - -   --- --
-    --    -    -        -    - ---- - -  - ---  -  - -  -                -    -- -   -      -  - --
- --  -  -    -    --- - - -               --   - - --- -  ----  - ---  -       - -      -   - --  -
-    -    -      -     --    -   -- -     -- -         -     -  -              -   -       ---     -
-- --   -  - - --   --         -    - --    ---- --   -  --   -   - -    --                --   -  -
-  --   -        - -  - -  -  - -     -  -   -  -   - --      - -       -  -  -   -   - - -       --
--          -   -  -  --    -      ---        -    -   --       -  ---   -   -    -    -      -- ---
- -  -          --       - - -   --        -  ----   -   - - - -  -          -- -   -- -  -   -    -
-    -  -       -  - - - - -   ---        -  -   - --  -       - - --- -   --  -  ----      -- --- -
-- - -  -  --  -   --  -            -   --   ---  -                -  -       -    ---    -    -   -
-   -     ---  -    ---  -  --   -  - -         -  -- --    --   - -  - -  -    --          -   -- -
-   -  -   -  - -- -    -        - - -   -  - -  - -   - - -  -- -- --  -     -   - --  --    --   -
-        -     -- -   ---     - - - --     -  - -- --      --   --         -      -  -    -    -   -
-      -           -   -     -         -     -       -  -   --  -     -     - - - --  -   - -  -   -
- --- -- --   -   -         - -  -   -  - -   ------- - -- -   - - -   -              - -     -  - -
-- - -- -  - - - -  -   ---    -- -  -   -- -      - - -   -      -      -  -   -   -  - - -  -    -
-   -  -   -- --  -    -  -  -   -  --                -   - --  --   --             --- - -      - -
-  -  ----    - --- -- --     - -- - -      - -   ---     -    -  -  -  - -      - -         - - - -
--  -  --    - -     -   - ---        -     -   --   --  -- -   - - --  -      -     - - - - -     -
-     - -     -       - -  --   --  -         -               --   - - -   - -  ----      --    -  -
--       - -  -    -  - -    -       -- -                    - -  ----     -      -     --    - -  -
-  -    - - - -                   -       -   -  -  -   -    --         -     - --     -  -    -   -
-       -     --   --    ------- - -- - - --     -    -   -  - -   -- - - -     -            -   - -
-  -           - --   ---   - - - - -- - -    --   -  -      -   -- - - -  -- -       -   - - - - --
-        --- - -   - -    -  -  -           --       -       - -  -       - -   -       - -- - - - -
-     -- -   -             -   -  -- -  - -- -   -  - - - --  - - - -       --   -- ---     - -    -
-   -  -        -        -  - - - - - ---    - -     --- - -    -- -      ----   - -  -  ----  - - -
- -   - -   -- ----       -- -    -  -   --    -    - - - -       - -- -      -  --    - -    -   --
-   - -  -  -   --   -     - - --  -                -      -  - -   -- -   -- --   -    -- - -     -
-          - - - -  -  --   - -- -   -  -- -    - -  -- - --     -        -   - -     -    - -     -
-  --     -  -- - -  -        --  --  -- -  -       -        -  -    -     -   -  - -     - -   - --
-- - --       -       -  -  --       -        --   --    -- -- --  -- -  -- -    - -- -            -
--   -    -  -    - - -      -- -       ------ -  --            -      - --          -- -  ----- ---
-    -  -    - - -- - - --- -   - - -  -   - -    -    -- --- --  ---    -  -   -      --       -  -
--        -  - -       -   -   -      - - -    - - --   -- - -        -- -  - ---- - -   - -   - - -
-    -  -  --    - ---           - --      - ---- - - - -     ---  --  --  -     -  -   -    - -- --
- -   --  -        -   ---- -      -  -- -  -  - - -- - - --  --  -   - - -  --       -  -   - - - -
-   ---  -     - -   -    - -  - - -  -   - -  --        -     -   -     -          -  -   -     ---
- -      - ----      -- -   - -  - - - - - -  -- -     -- - ---   -   -  - -- ----- - -   -  -     -
-   - --  -    - - --     -- -   -    -  -- --    --   - --      -- -  - --     -- --  -  -    -----
-   - -  -   -      - --  -- -       -      ---      - -  -  -      --      - --     -     - -    --
--      -      - - -- --   - - ---  -     -       --  - -   -- --    ---   -  -    --  -  -     -  -
-  -   - -   -  ---      -   - - -    -   -- --         -  -  -- --- - - --      --    -- --  -    -
-- --  --  -  -  -      -   -   ---    - --        -  -    - - ---   - - - -       --  - -  -     --
-  -  - -  - -    -  - -    -  - -- -    - -   - -  -     - --    - -     --  -  --  - -     -     -
- -- -   -          ----   -- --   --   - -        -     -     ----- - --      -- - -       -   -  -
- -  --   - ---  -    -  -  -  - - -  - - -- -   -  --      - - -       -  -    --  -    -  -    - -
-  -    - - -  --   -  - ---       -    --    -    -  -    -      -- --           -- -   -     -   -
- -- ---- -       - -   --- -  -     - - -  -        --   -   - - -    -          -   -   -  -   - -
-    --   - - - -     --   - -  - -      --    - -               - -    -       - - --- ---      - -
-   -- -- -      -- --    -- - -- -    --          - --  --   -- --  -   --  - -   -        -  -  --
--    -- - -          ---  -    -   -   --  --   - --   -    - - -     - -    - --     --   -    - -
- -    - -   -   -   --   - - ---  - -    -- - -   --         -  -  -  -      -   -     -  -  -    -
-  -    ----    - -  -   -   --     -          --  - --       --    --     -- ---  -  -            -
- --   - -       -    --  - -  -  -  --   -  - -  -     -         -       - -  ---- -       --- -  -
--   - -- --- -   -   - - -       --    - -  -    -    ---- -  --- - -    - --      --      -      -
-    - --            -  -  - -      - -- -     ----- -- - -- -- -           -   --    -- --   -  - -
--     -     - -- --    -   --   ---  -  --     - -           -      --   -         -      -  -   --
-           - -   - --- -      -  -           -           -    -   - -        -- - -- -  - - - --  -
--    - - - - -  - -    -   -       -   -        --    - -     --  -   ---  -     -      - - - -   -
-  - -  --  -    -- - -   - -- -   - -- - -  -       - -  ---     - -    -   --   -  -     -- --   -
--   - -      - -   --   -   - -            -  -- -  -- --      -     --  - - -  -   -          -  -
---      -   - -      - - ---    -- - --  --     -       - -    --  -    - ---   -   -      ---    -
-   -      -   -  -     --     - -    -    -    - - ---  - - --  -  - -      -    - - -          - -
- --   -   - -  -     -   - --      --  - -     -       --      -  -  -   - -  -   -- -        -- --
-     -        -  -    - -  - -    --- -     -   --        --    - -   - --    --    -   -  -      -
-        -  --    -  -             ---     -  --          - -    -- -      -- -     -    ----- -   -
-- -- --   - -    -     --     --         -  -    -      --   - -         -    -                - --
-     -     -     - -    -      --- ---   - - -- - -    -  -  ---- --    -    -    -- -   --   - - -
-        ---  -   -     -    --  -    --  -     - -         --             -  --  -  -- -     - - --
-  - --      -    -        -    - -  -      - -       - -  -    --  - - -   - - ---   -     -- --- -
--  --  - --     -  -  --  - -      -- -  -     -   - -    -  -   -    -       -  -          - --  -
-   -   - - --     ---     -- -  -       -    -   --    -  -  -  -- -    - - ---   -- - - ---- -   -
- -      - -    -- --   --- -      -   -    - --  --   -  - --  - - --  -   -  -       -    - -- - -
-- -      -    - - -   -   - -  -  - -  - -  -  --    -   --  -   -  -            -  - --       -  -
-      - -        -  -- -    -     -   -  - -   -- --   -     -   -   - ---     --         -      --
--- - --  --    -   -  --       - -       -  --   -    -     -     - -    -             ---        -
-              --   -     -     -  -  - -      --        - - -  -  - - - -- -    -  -   --      -  -
-- -  - - -   -   - -       -   -- - -            --    -  -  --- - -- -    -  -  -     -- --   - --
-  -   -   --  --   - - - - - -   -   -   - -     - - --  - -        -  -      --  -      -  - - - -
--    - --- -    --   -      -  -  --- -     -  ---    -     - -- - - -   -   -  -- --     -  - - --
- -  -   -  - --   -- - - -  -   - -- -  - - --     --    -- -  -  - -       ---   -    -- -  -  - -
- -                      -  -   -     - -      --     - -- -       -     -         -      - - --   -
----------------------------------------------------------------------------------------------------
