100
100
----------------------------------------------------------------------------------------------------
- -  ---      -   -   - -   - - --  -    -         -   -  -   ---- - ---   -  -   -- -- -   -      -
- --      ----     - - --      --  --   -        -   -     -      -- -       - -   -   -   - - -  --
- -  --      - -  - -        -      - -  -   - --   -   -  - - --- -- --  -      -  -   -     -  - -
-  -   -  -    - -      - -   - --     -  - - -   -   - -  -      -- -   -  - - - -     -   -- --  -
- - --   -     -- - -- - - - -                - -         - --  -     -    - -   -     - -   -    --
-  -    -    - -    -        -    - - -  -  -   - -  -- ----         -      -    -  --  -        - -
-   -  - - - -   --     - --   --   ---     --- --        - -    -      -     - -   -    -- - - -  -
-   -   -- --- --    -      - - -          -       --   --  - --   -  -        --       -      --  -
-    -   - -   -   -       ---   -     -     - - -  - - - - - --  - -   - -  -     -    -    -     -
- ---   -- -       --   -    ---   -                 -       - - -     -    --  - -- -- - -       --
- -     -        -          -    - -  --  --- - - --  ---           -    -    -  -     -  -  -     -
-- - --- --  -   - -  -   - -    - -                 -  - - -    -   - -  -   -     -  - -  -    - -
-- -      --       -  -    - ----   ----   -     - -          - --  --  -  -- - - - -   --   --    -
- -  -  -    -   --  -      -   -        - -   -    -- -   -- -    -  -  --    -  -          -     -
-  ---- -    -- -    ---   - - --  -      -  - -- -     -  - - - -   -   -  - -     --  --      - --
--      - -  --   -      --  -   -  -  ---       - - -  -     - -  -   ---  -  -  - -- - - --- -- --
-   -  - -    -- -  - -    -      -- --   -      - - -  -  -   -   -   -- --     -     - -- -   -  -
--   - - -  -----       -     --   -- --- -         -  -  -  -  -         -   --   -    -      -  --
---     - - - -        --   --  ----          - -           -       - - -- --   --  - - -   -    - -
-  --    --- - -   -  - - - -- -    -  - ---  -    -  -       - -       --   -       - -       -   -
-  -      - - -         - - - -   - - -   --   --  - - -  -         - --      --    -          - - -
- - - -    - -  --    --  -   ---   - ----        - -     -    -   -     --  -   --          -- - --
- -    -    - -          -  --   - - - -  -  - - -          -        -- -  --               - --   -
-            -  -   -- - -    -    - -       -    -- -  -  -  -- -  -  -      -    --  -- -   -- - -
-  - - ---  -  -    -   -   --  --    - -- - -  - --   -  -- - - - -         ----  - -- -  --  -   -
- ----- --   - -   - -    -- -   --    -   -        --  -  --- -  -- --   - - -- - -   -  - -    - -
--   - -            -   -  -          --   -      -      - -  -  -  -        -      ----      - -  -
-     -  -          - -   -  -- -   -     - --  -- - -       -   --    - -  -  - -   -    -        -
- -  -- -     ---      - -  --  -    -  --   -    - -       -   -       -    -       -    --  --   -
-   -    --    --   -  -  ---  -- - -- -   -- ----    -  --    -   -      - -  -     --   -   - -  -
-       - -  - - -        -  --    -   -       -      - -   - -          -        -  -    -        -
- -  -     -       -- -    -- -   --  -   -  -           - -- - ---    -      -  -      -   --  - --
-- -   - - -      -   -    -    -  - -   - - -    - - -  - - -    - - - -  -- - -   -  -  - - --  --
-         - -- -         -- --       -  - -   ---   -  - -   - -    -   --      -        - -  - -- -
-  - ---     - --     --  -  -       - -  - -- -   --  - ----   - - -- - --        ---  -- - -  - --
-       -      -   - -- -  -    -- --       -                -      --   - - -    - -          -  --
- - --- -        - -    -     - -     -  -     --  - --  ---    -- -            -    -       -     -
- -- --- -   -   - -       ----   -    -   -  -   -               -    - -  -    -    -      -  -  -
-       --   - - -- -   -  - -   -     --  -         --- -    - -    - -       -  -        - - - - -
-   ---- - - -  -  -    --    -    ----     --   -  -  -    -    -  - -  - --- -  -  -  - --    -  -
- -        - - - -  -    --   -  -      -    --       -   -   - - -  --   -   - -  -   -  -   -  - -
-     -- -- -    -- -     --    - -      -- -    --    ---     -       -    -      --    -  - -   --
-  -       -  --- --  -     - -    -    -    -  -     -    -  - --      --    - --   -           - -
-  -  - - -       -  -   -- -  - -      -  --   -  -- - -     -- ---  -- - - --     - -  - -   - - -
- -  - - -     --  ----     -       -           -  -  --   ---     - -           -  - -            -
- ---  --    -  -    -  -  -   ---                    -   -          -   -   ----   -     -  -    --
- -    -- -  --- -- -   - -- -- -  -- - - -         -  -      -  -  -    -     -   --- - -     -   -
- --- ---   -  --    -     - --   --   -     -    - -    -   - - - -   -- ----   -    -      - -  --
- -      -   --- -         -    --- -               -  -  - -   - -  - -      - - - - -- --     -- -
-    -    --      ---  -----            ---   - - -       - -  -  --      -    -  --- ---          -
- -- -          --    -     --   -- -  -      -  -  - -- -    -  - -- -   -  -            -- --    -
- -  -  -  ---       -  -     --  -    -  - - -   -     -   -    -   - - -   --      -    --     - -
-   -  -     - -  -  - -        --  -             -   -    - --  ---  -       -- - -- -   - -      -
--   --   -- - -- -   -    -  -   -       -       ---- -           - -- -  -   - --    -       - ---
- --     -  -  -    ---        - -     - -      -    -         -- - --     --  - -  --- --  -      -
-  - -  -    -  -  --              -   ----          - -- -    --     ----    -    --   -     - ----
- -    --        --   --          --           - --   -    -  ---    -  -  -  -        - -  - -   --
- - -  --  -     - - -  -   - --  - -   ---  ----  -  --    -       - -  - - - - -    --- -   -  - -
--      -    - -      -  --    -   - -   -  -  -         -   - --     ---    - -  -- --    - --   --
-  -- -    -  -    - - -  --  - --  -  -        - -     --   --      -        -     - --- -- -    --
- -     -- - -  -----  --   -      - -   --- --   ---- - - - -     -         --  -    - -       - --
- - -      -- -       - -   --          -     - -     -    - - - -    - - ---     ---       -     --
- -     -      - --      -  - - --     -      --  --  -- - -  -   -   -  -           -    --  --  --
-   -- -- -- -   -  -       ----   -  -   - -   -   -     -      -  -         --      - -- - - -   -
---   - ---   -   - - -  --               -   -             --- - -- --  ---      -  -   - -  -    -
-- - -    -    -  -- - - -- -     - -   --  - -     -   -   ---    - -  -- - ---     -- - -        -
--  --    -     -   -  - -          -- -        -- - -   -- ---- --        --           -          -
-   -     -   -  --       -  -  -    - - -  -    - - - -        -     - -   -   -   -  -  -- ---   -
- - --   -        -  - ---      -           - -    --     -          --  --     - --  ---    -    --
-    -- --   -   -    -    -  - - - ---      - -  -     -  --   --- -- --    - -    -              -
-  --    -   --  -  -        - -   -- -   -  --     -    -- - -    -  - - - -  -        - ---      -
-     --  -   -   -  -  --     -       --     -  -    -  - - - ---         -  -   - - - - -    - - -
- -      - -   ---   - -    -   -  -          -  - -  -      -      -     -     -   - -  -        --
-   --    - - -  -      - --- -       - -- -    -    - -  - -     -  - -  -   -    -  - -      -   -
--       - -- -    - - -  -     -    --- -    -   -- --       -       -    -  - - --   -     -  -  -
-      ---- --         -  -     - --     -- -   -   - --      -  --  - -    -  ---   -   ---      --
- - -  - -   - - -   -     - --  - --    -  - -   - - - - -  -  -    -  -  - - -   - --      -     -
- -- -     - - -  - -   - -      - -  -   - -     - -           --   -   -  - -- - -   -     -  -- -
-- -   -  - -  -  -- --    - -  -      --   - --  - -  - -   -- -    -    -    -     --    --   -- -
--   -    --  --     - -- - -  ---  - -    -     --  --        -       -     - -   -  -    -    -  -
-  -        -- - - -- -       - - -- -  --- - -     -      --   -         - -    -   -  --  --    --
----    - --- -  - - ---   - - -   - --      - -  --        ---  - - -  --   ---    -     -  ---   -
-   - - -     --    - -- -   -    -  - -    -- -     -  -       -  -    -       - - --  -    -   ---
-- - - - ---  - -   -     - -- -    - -  - -  -       -   -  -   -   - --   -  --   -  --- - --- - -
-  - -    -   -   ----  -   - -        - - -            -  -  --- ---    - -       -         -  -  -
-- - -   -  - --- - -- --  -  -  - -    - -    -   - - --  --  --    - - -  -- -  -       -   -   --
-    --     --  - -          -- --    --  -    -  - - - --           --   -   -      -    - -- - - -
-         -      -  -   --    -    -   - - - -- -- --    -- - -  -     --  -   --  --     --     - -
- -  --    --     -  --- - -   - --      - - -  -- --   - -  - -     - -  -          ---       -  --
-  -    -- -    -   -  -  -  -   -    -   -   --     -   - --     -           - -  -- --- --       -
- -       - -    -   -    --      - - - --  - - --      -  -- - --    -  --   -           --- --- --
- --- -  -   -      - --- -  --  -          - -      - - --       -  --  --- -       - -     -  -  -
-    - -   - -   - - -   -     -       -    -  --  -   - - -  - ----    -     -- -  - - -      -  --
-       - - -    -    --- -  - - -     -   -- -   -     - - -  - -    -  - - - -       -       - - -
-- --   --- - -  -    -  -     - -   - -     - - --   -- -  -       -     -  - -  -   -  -         -
--  -- -   - -      -              - -    - -   - -- -   - - - -    -    - ---        - -          -
---  - ---       - ---  ----  -  - -  - -- -    -        -    -          -    -   -    -   -    -  -
-   --     -   - -----  ---    -    -  -    -      ---    - --  -   -   -       - - -- -       -   -
----------------------------------------------------------------------------------------------------
