100
100
----------------------------------------------------------------------------------------------------
-     --  - ---   -  -         -            -         -      - -     --   --    - -     -  -- -  - -
-   -     -       ---    - -  -   -- -    -    - -         --    --- - - - -      -  -             -
-      -    - -  --      - - - -     -     --                -   --   -    -- -  -     -  --- -   --
-   - ---   -      -- ----- -    ---       -    -- -       -  - - - -   -    - --        -   -  -  -
- --     --- -   -          -----       - -      -   - - --       -    -   -    - -     -   - -   --
-  --               -   -         -   -             - -         -   - -       -  -   ---   -    - --
- -     -   -         -    - --   --- -   --   -- -       - -  - - -- -    -      -        -    -  -
- - -      -  -      -    -    -         -         - --   -  -   - -       -- -     - -  --- - - ---
- --     -    --   -- - -  -  -  --    -      -- --  -  - -   --- -   --- -     -  - - -        -- -
- -  - --            -  --  -           -- --  -     -    -       -- -   -   -  --  -  --    -     -
-  -    - -      - --  -  - - -   --  -   -      -  - -  -    --  -    ----       --       --   -  -
-  -   -  -  -  -  --    -  -          --       --   -        -     --        - -  -    --    -  - -
---    -- - - -  -- - --   - --       -      - ---    --      - - -     ---   -  -   -     - --   --
-   --            -  - - -      -     ---       -       - -        - -     - - -    --    --    -  -
---    - --   -- -- --         - - --     - - -   ---   -  - -   - -- - -  - - --- - - ---  - -- - -
- -- -      -  -  - -    ---             - -   - -      - -  - --  - --  -   -   -  -  -   -       -
-          - - -   - -- --      - ---    - -  -      --  -    ---      -  -   --   - -  -- -- ---  -
-      -     - --  -    -  - -         ---      -          -      -     --- --     -   - -  --    --
-     - -     -  --      -  - - -               -  -      - - -    -- -      -   -  -  - - -- - -- -
-    -  -      -   -- -  -- -   - --        -     -    --    -  -        ----       -     - - - -  -
-   - -   ---       - - - ---  - --- - --   - -     - -  --  -   - --           -- - --- -    -- - -
-    -   - -   - ---- --   - -  -      -  - ---   -     -   -   -   - - -  - - -     - --     -- ---
-    -  -  - -         - --    -  -  -             -- ---   -     -    --      -   -   -   --      -
-  -   --      -   --  - -     --              -   -     --    --  -        --       -  --  -- -- --
--  -  - - -  -     -  -     -       -       --   -     ----     -  -    - --    - -    --      -- -
-      - -           --   -  ---  -- -  -      --     -    - -           -   -      -- --- -- - -- -
-- -  --  --       -- --- - -    -  ---   --   -  -    - --      -   -    -    -     --        -  --
-    -   - -  -  --- - --   - -- - -  -              - -    -   -- -        - -   --     -   -     -
-   -  - - - - --     --  -  -  -    --   -  --  - -   - -      -  -        -     --  -    --      -
-- - - --  - - -       - -    -    - - -   -      - -  - --        - -  -   --  -- - -   -- -  -   -
-  - ---    -  ---     - --  -    -  -   -    - - - --  -    -  -  -- - -     -  -         - ---   -
- - -   -  -   -    - - -- -       --  -   -  --  - - -   -- - ---   -  - ---     -  -  -- -   - - -
-  ---  -- -   - ---  - - -- - --- -   - -  -    -  -     -       -     -  - -  -      -   -    -  -
-         - ---      --     - -   --       - - - -      - - - -   -      -  --     - -      --    --
- - --    -        -    --   -     -   --      - ----      -  -    --  - -    -       -     - --   -
- -          -   -       -   -   -  -  -       - -- --      -   ---    -      -    -  -- -- -  -  --
--  -  -       ---  - --  -        -   -   -           -   -  -  -   --  ---  -   -          -  - --
-  -  -  - - -     --   -- --   --- --   - -  -      -    -- - -     -     - -   -       -   -  -  -
-  -    -  - -  - -  - -    -      - -     -    -   --   -         - -    -  -    - -     -        -
--     -- -   -- -  -    ---    -       - - -  - -  -  -      - -- --       --  -     -   -  -- -  -
- -               -   - ---   - -     -   -  -   - -        -  - -  -   --   -      -   --         -
-    -  - --  - -   --  -  -  --       -   -    - - -    -   -    - -       -    - -      ---  -   -
-        -  -    -  -  -    --  -  - -  -   --    - - -- - - -      -    --- -     - -  -  -  -- - -
--  --  - -- - --- --         -    - -  -     -     -     - - ----  -  -     -- -    -  --  --     -
- -  - -      -  -   - - ---    - - - - - -   - - -    -- - -      -      -  -  -    -   - - -     -
--- -- - - --  -     -  -    - -          -  -   -   - -   -       - -  -  - ---  -- -  - --       -
-       -   -   -       -   - -  --      --- - - ---     -- - -  -      - - -                   -- -
- -- -   -  -- --   - -       ----     -         - -- --       -  -  -          -- -   -  -- ----- -
-    -    -  -  -        --    -   - - -- -  -        -  - --  - - -    -      --  - - --  -  ---  -
-    -   - - - --  - -  ---    --   - -  - - - - ---  -       -  -  -   -   - - - --  -  -   -     -
- --   - - --  --   - --  -   - - --      --    -   -   - -      -    -   -   --           - ---   -
--    - -       -- ---   - -        --    --  -      - -  -      - - --     -  - -  -   ---- -     -
-  -  -   -   -     - -       --  -   -  - ----   -  - - -  -     --   - -- -  --- -    --- - -    -
-- -  - --         -- - -      -  -  --  -  - --   - - -      - -     -    -        -   ---  --    -
-  -- -       - --   ---       -- -       --     --        -   -  - -  --     --  -             -  -
-      ----      - ---  -          ---     ----     -  -- -  -- - ----  - --      -      - -- -  - -
-       -  -- -   -   - --               -- -  -    - -  -  - - -    -  --    -- - - -     -      --
- --  --       --  ---     - -      -  -         --  -  ---  -   - -   -     -      - -- --     -  -
--  --   - --  --- -   -   -   -   -    --   -  -   ---- - - --    - - -  - -    -     -   -- -    -
- --   --  - - --  --        --  -   --  --    -           - -- -   -    - - -            - - -- ---
-   - -  -    -   -       - ----              -  -  --  - - -       - --   -            -     -    -
-        - -    -      ----    -  - ---- --         -          -     -     ---  -- -    -     - - --
--  --  -   -      - - --       - -  - -  - - --       - --   - -        -           --  -      - --
-  -  -  -     -   -  -    - - -- -            -   -        -        - --   -----  -   - -    -  - -
-- -    - -  -   - - -    -- -      ---      -- ----  --     - -     -  -  - -          - -- - -   -
-    - -  -  -        --- -      - - - -           -- --  -   -   -       -   --    - ---    - --- -
-        - --  -  -   -     - -- -  -  - -     --    - - --   - --      --- -   - - -     --  - -  -
- -       -   - -  --    -     - -----     -        -     - -         -    -   -     --  -     -   -
-   --- --     --   --- - -----    -  -- -   - - ----    - -    - -   -     -   -   --  -  -   -   -
-             - -  -    -  --  - -      -      - -- -   -             -  -- - -       - -- -       -
- - - -   -    -             -   --      -    -  -  ---     - ----- -     - - - -  - -   ---       -
--       -       --  -    -   - - -    -  -  - -   -      - - -  -        - -    -    -    -   --  -
-   -       - -       -     - --      -  -    -      ---  -- -    - -   -  -  -     -   --      -- -
- -- -   - --   - - - -      -  - - - - - -              -  -          -     ---  --      - - -    -
- - -       -   - - - -  -- - - -  -    - --  - -   - -    -  -  -     - -- -    -    ----        --
--      --    - -   --   -   -       -  - -  --  -    - - -     - - -   --    - - - -  --  - -   - -
-           -   -  - -   -- -  -- --   -- -- -  --   -    -       - -- -  - - - -  -  --    ----   -
--    - - --  --- - --- -       - -    -    -         -        -   -    --       -- --   --  -   - -
-  - ---    -- -    -    - - -  - - -- -  -  -   -        -- -   -      - - -     -  -      --    --
----      -      -    -- - -  -- --   - --         -  ---      -         - -  - --   - - --   --   -
- - - -- -        -  -      -  -      -           --    - - -     - - - - -     - - -  -    -   -- -
- -    -      -  --- --- -   -   -          -  -       -  - - --- -    - -    - --   -   - -   -- --
-  -  -   -    -   -   -    -  ----- --   - --     - -   - -     -       - -      -    -  --   --  -
-       -     - -- -  - - - - --    -    -     --    -   -        -  -- -- --  ---  -  --  -     - -
-  -    - -   -  - -        --  --   -- -  -     -       - - --    --               --   --    --  -
- -- -     --- -     -- -- -  --   --     -  -  -  - -    -   -      -   -  --  -- -    -     - -  -
-       -   -      -- - - -  ---  --  - - ---  - --    -         - ---  --  --      ---- -  -    ---
--     -   - - -   -      --- - - -       ---    - -         --  - - - -  -      ---- -      - --  -
-- -  -    -    --  --   -     ---           -   - -- -     -    - -   --- - -  - -    --    --- - -
-    - - -    -- - -  -      -      --  ---   -- -  - - - --      -  -   ---  -- - -- - ---  -   - -
-   --      --   - - - --  -    -                    --    -  - -- -- -    --      - -  -  -      --
- -  -- --    --      -       -      -- -    -      -    - -  -   -  -    ---  -       - --  -  - --
- -  -    - -  - -- - - -  --  - -     -  -  -     - -  -         --- -  - -- - -      -    ---   --
--     -  -  --  ---    -   - -    --  - -    --     -   -     -  - -   -   - -     -         - -- -
-- ---  -- -   -   -       -  - -   --  -    -      -      - - -    --    -- - - -           -  -  -
-    - --  --  -- -  --  -         -  - --    -- -   - -    - - -    -   -  - ----    - -        ---
-  -- - --       - - - -     -  -    --    -   -  -    -- -     -- - -    -     ---   --  ---  -   -
-      - - --    -   - - -     -   -     -         -         -           - -      - -        - - - -
----------------------------------------------------------------------------------------------------
