100
100
----------------------------------------------------------------------------------------------------
- -    -   - -        -      -  -     -  - -       -  - -  -  -          -        -         -      -
- -  -     -   - -  -    - --    -  -  -         - -   ---  - -  -   - -  -  -    -- - --       -  -
- --       --  ---   -     - -      -  --  --   - -     -   -   -  -        -     -       --     - -
-     -    - - --    -    - -     --- -    --   -    - -- -     -        -                         -
-     - -    - -    --   - --   --      -        -     -   --      -   --   - -  - --  - - --- - - -
-- - -   --     ---- --    - --       -  -  -    -   -           -  -- -   -   -- -  --- -   -     -
-       -    -  -            -  ---        - -  -    -     -     --    - -  -    ----      -     - -
-  -     - ---  -     -  -- - -      -  - -    - -  -  - -   - -     -       -       -    - -    - -
- --   -   -       - -- -    - --  -  - -  -----     -   - -  - - -   - - -          -- - -  - - - -
-- -   -       -    --          -  -    - -  -  -- -   -  - ---- -- -  -      -     -        --  - -
- -    - -     -    - - - - -    --  -- --     --     ---  -    -     -            -   -  - -  --  -
- - ---     - - - --  -    -  -  -      --     -  -- -    -    --   -   -   - ---  -  -   -        -
- - -   -     - ---    ---           - -  -      --   - -    -   - --     --   -        -  -  -  ---
--- --- -    --  --       --  - - -  -  - ---  ---  -  - -    -  --    -        -   ---   --       -
-  - - --- --  -  -  --   - -    -   -  --     -      -              -  -                          -
-   - --    -   - --- -    -    -   - --  -   -  --  -   - -  --    - - ---      -  -  --  -- - - --
-   --  -         -   -   ---   - --    --     - --   - -   -    - -  - - -       -  -    - - - -  -
--- ---       - -   --   -    -   - --  - -- -    - -       -- --    -  -   -- -  --           - - -
-          - -        -- -- -   -- -   -- ----      -  -   ----             -  - -      -  - -    --
-    -  -   -- --  --   --  - -    - -    -  - -- - -  - -      -- - -- -     -           -  - --  -
- --    -- -  -     -  -  -- - -  - - - -    -        -    -           -    -        - --         --
-   -- -    - -- -   -    -   -  -   -   -  -  -  -   ---       -  - ----           -     -- ---   -
- -    --  - - -      -    -    -   ---   -  -   -- - --  -  -    -   ---- -     -- -   --       - -
-   -         -          - -  -  -   - ---- -   -    ---  -     --  - -- - -- - - --        -   - --
--- - - - --    - -- -       -    -       --    - --  -      --- -   -     -- --- - -  -      --  --
-     -  -    -      --- --  - -    --  --  -- -    -- - --   -      -     -  - -       -       -- -
-   - -       -    - -- -   -- -- -                -      - -  -  -  - -         - - -  --- -   ----
-  -- --    - - -- -      -  --- -  --     -  -    -- ---  ----     -    -- - ----  -  -   -    -  -
-   -           -  -             ---    -     -    -    -      -     ---   -      -   -  - -- -   --
- -- - -    - -    --- ---     -      --  -     - -  -     -  -     -  - -- - ---    -   -      - --
- -  -        - --   -   --            - -    - - -  -  -      -                 -- -   -         --
----       - -- -  --       -  -  - --          --- - -  -       -        --    - --    - -- -     -
- -  --          -- - - - -   -      --- - -----  -     -- - -      -  - -            -  -       ---
- --    -  -  - --  ---  -- -  - - --                -   - - -  - -   -  -  -  --   - --   - - -   -
-        -     -  -        -     -    -    -- --   - -      --  -  -   --      - -- -   -   - -  ---
- ----  - -     -  -     -    --   --        -    ----- -          -    -   - -    -- -     -    - -
-     -----  - -   -- -   -   - -   --     -  - --         -          -    --    -  -  -      - -  -
-     --   - ----              --  - - - --- --  -   - -  - - -    ---  --   ---   --         - - --
-    -   -- -    -      --    -     -   -  --  -                - --  --         -  - - - -   --   -
-      - -  --   --  -  -    -            -   --- -  --   - -- - -    -   - - - -- -  -     -- - - -
-     - -     - -      -  - -     --   - -          -     - - -     -   - -  -     - -- -     -    -
--- --   --  -   - --    - -    -  - -      -     - --  --   -    -    -  - -  -- -    -     --   --
-     -   -                  -   -     -  -    -  -  -  -  -     - -      -  -         -        - --
-- -         - -   -      -----  ---- -   - - ---    -- -        - - --       ---      -   -  -    -
- -    - -  -    -   --      -       - - -   - -  --    -  -            -   -  -     -  -    -     -
-      -   -   -- -      - - -   -     -- -   -      - -- --   -- - --   -  -   -  - -     -     - -
-    --  -   -- -   --   - - - -              -    --       --   -   -        -  -  --    -  --  - -
- -  --  -- -   - -   ---          --    - --   -   -   --     -- --  -         -   - - - ---      -
-   -    - --  ---- --    --   -  -            --      -          -  -  - -     -     - -      -  --
--  -  -   - --   ---       -      ---  - - --    --   - -           --     -    -- -  - - --      -
- -        - ---- -     -    --     - -          -  - -         - -- - -   --  -    -   - -  -    --
-   --  - - - - --  - --  -     --- -   ---  - - -           -     -  -         ---   - - ---    - -
-  -  -  -  -  -  -  -- - -  -   - -  -  --   -              - -   -- ---  -- -  -  --  - -    --  -
-          - -   -              -    -     -- - - -     -- -- -  -   -         - -  - --    -     --
-   -  -  - - -    -    ---- - -- -  - - --   -- -    -- - - -        - - --  -   -        - - -   -
- -   -- -  - ---- --   -   -    -  --      --    - -   -     --   -    -   -                  - - -
---  -  -              -- -- - -     -    --  ---       -  --    -    --  -  -   - -   - -  -  -   -
-     --  - -   -      -  -       -  -   -     -     - -         - -    - -  -  -            - -   -
--- - - --  --  - -- --       --  -   - - -  -  ----      -   -    -         --   -       -- - - - -
- -  -        - --   -    -- - --                 -    -----     -  -    - -  - -   - -- -    -   --
-        -      -  -- --     - - - - - -- -- -  -  --      -  - ---  -   -  -     -- -      - -  - -
-   - - --         -   - ---       -  - -    - - - -   - -- --  -      -     -   -   ---- - -  --  -
- ---   -    -----      --    - -   --  -     - -       -  -  -   - ---   -  -- --            -   --
-  - -   --      -       --    -  -     - ---    -  - -- -   - ---- --  -   -  - -    -  - - -     -
-     -    - - - -   -- -    -  --- -- -         -  - -    -- -  -    - -  -    -      - -    --  --
-   --  --     -     - -   - - -     -  -  -     -    -  -  -- - - ----   -    -   - -     ---  -- -
--- -        - -- -- -   -    --- --    -- -     --- -    -- -- -- -   - -  -    -  -   -     -    -
-     - -   - - -   - --          --     -  ---  -   -   -     -    -   --     - -        -  ---   -
- - - --         -  - -  -   - --        --  -  - -  -   - --  -  ---          --  -  -            -
- --- - ---     -- --- - - -   -  -  -      -      -      -     -   -- - - --     -   --  - -    ---
-    --- -   --- - -     -  -  -   - - --      -     -  -     ---      -- -   - - -    --    -   - -
- --- -      --- --   --     -            ----      -- -    -   - -  -     - --  -    -  -     - - -
-  -  -  - -  -- -      -      ---  --  - - -   - --      --              -   - --   -      -- -   -
-   -    --   --     --        --     - - -      -   - -    -- -    --       - --  -    --      -- -
- --   -       -- ---  - - -    -      -      - -  -  -  -            --      --  -- -- -     -    -
-        -  -  -  - - -  -    --    -  --  --      -  --- - -  - -   -   ---     -   - -       -   -
-  -        -    -  ----       -   -  - - -   - -  - - - -          -- -    -   -  - - -- -  --    -
--   - -    -     -    --    -- - -   -   -  - -- -     ------  - --   --  ---        -- - -  -    -
-  -    - - -    -   -          -    --  -   -        -   -- -   -   -        - -  -   -  -   - -  -
---- -      -      - - --  ----     -   -- -- - -  --            --- -  - ---    - - -  -   -     --
-    - --   -  -  - -  --      -  - -     - -  - -  -- - --  -      -  -  -    - - --       -  -   -
---        -- -- -         -            --   -  - -  - ---   --   -      -- -  - -  - -       - - --
-        -  -      -  -       - -  -        -    -           ----- -  --- - --     --     -    - ---
--  -  -  - -       -   - -   - --  - -   --          --           - - - -       -  --  - --       -
-- - -    - -    --    -- -    --  -    -   -          --   - -    - -    -- - -    -    - - - -   -
-  -- -   - -  ---   -     --     -  -      --           - -     -   --   - -        - -  --      --
-    -  -    -     -- -   -   - -- -  - -     - --     --  - - -  - --     -   -- -    -     ---   -
-  --    --  ----    --   -    -  - - -   -   -   -     --  -    --- -     -- -    ----  -     --  -
-    - --  -         - - -   - --      -        -      -  - -  --  -  ---   - -    - - -          --
-    - - -    - -      -    -- -  -   --  -- ---   -      --      --  -           -  - -  ---  --  -
--  -  ---             - -               -    --    -    - -    - --    -  -----        -    -    --
-- -      -   - --  -- --  -- - -  --    - - - -  - -   --   -     - --  - -  -   -    -----   --  -
-  -  --- -       -   -- -  -          -     - -  ---        --  ----- ---  -   - - --       -     -
-           -   - - - - -     ---  ----  - --        -  -     --- -- --   -     -     - -         --
---- -    -  -       -  - - -     --      - -   -  - -   -      -   -    --- --   -- -  -    -     -
-   --    -- - -   - -  -  - -      -- - -  - -     - --     -  - -   --       -   -   - --    - - -
-    -  - -  -   -     - -   -- -  --    --   - -         --   - - -  -        -       -   - -  -- -
-   - - --   - - -   -    - -   - -     -  - -- - -              - --      - -  - --  -     --  -- -
----------------------------------------------------------------------------------------------------
