100
100
----------------------------------------------------------------------------------------------------
-  -  - -   -   -  -      -       ---  -     --    - ---   -  - --   -    -    - -----      -  -   -
--  -    ----       --  -      --    -  - --    ---         ---   -   --       - ------   --   --  -
-  -  -      --    -     --     --- --- -     -  -        -     -   --   - - -  -- - -         -  --
-   -   -- -      -   ---    --        -  -          -  ---  -      -  -      --- -    - -  - -  ---
-    - - --   -    - ----        - -  -          --   -   -  -   --   --- - - -    --        --   --
-     - - - - - - ----    -   - - -        --  -   - - -  --- --   -- - -       --  --  -  -      --
--   -    -  - -   -- -- - -  -   -- -        -  -    - ---- -       --        - - -  --      - ----
-  - -      --   - -  - - - -  -   -  ---     -   -      --     - -         -   -    -   --     -  -
-    -  - -    -    - - - -   -  - - - -  -  - --   --       --           ---    -       -  --   ---
---        -     -   -- -      -  -  -     --   - -    -  --   -- -- - --     - -  - -     -       -
-       - -       --  -  -             -  -  -   -   - -   -- -    -   - ----   - - -     -   -- - -
-- -  -- - - - - - -   - -   --  - - -   - - -  -  - - -  -  -  --   --  -       ---    -     --- --
- --    - - - -      - -- --  -   -- ---  --  - -      -    - -   -   - ---      -      -   --   - -
-  -  -          -        -       -- - -   --- -    -      - -             - -  -  - -      -  --  -
-   -   - -    -   -  - -  - -   --              -- --    -- --    -- - --       -- - - -      - ---
-    --     -             -     -  -    -  -   -      ---    - -       -        - -  -   -    -  - -
-  - -- -    - - ---    -   - --   -   -            -  --    - -     --       -   --     -      -  -
--  --  -          - -- -      -- -- -           - -            -        --   --             -  -  -
--   -    -  -  -   --    -----  -   --  - - - -   -   -    -  -         -  --   --    -        -- -
-- -        - -         - -   - - --  -- -        - --      ---- -    -    -    -    - - ---   - - -
- - - - -      -  - -  --   - -    -   -      - -     -- --   -- -      -       -  - -     -       -
--   -     -  - - --     --  - -       -        - -        -  -    - -   --   -  --- -- -          -
- --   --         -    - -    -    -  -   -   --  - -  -- - -   - -      -     -     -    ----    --
-        --     - - - -  - -- ---      -    -                    -    --     -    --  -- -  -    - -
-  - - -   - -  -       -   --   -  - -  -- -   ----       -   -  --    -   -            - --- -   -
--   -    -     - -         -           - -  -          --      -- --     -    -  -  -   --  -     -
- - -   -             --    -     - -    - - --     -   - -- - -  -  -   - -  -  - -  ---- --   - --
-     - -  -   - - - -  - --     -    -- -     --     -     -- ---- - -  -   - --  -   - --        -
-  -- -  ----  -    - --  -  -  -  -         -      -   ---       ---  -    - -    - --     -- -   -
- -   -  --- -    -  -  --    - -- -  - -  -- --  - -                     - -  --   -      -       -
- - -   -    - - -   -      - -- --  -  -    -        - -        - -- - - -   -       -  - - --  - -
- -   -    -  - -  - -    - -   - ---      -   - -   - -        -  -    - -   - -      -       -   -
-         - -   - -     -- -    - -- -        - - -         --   - -      -  - -      --- -   - - --
-- ---     -  - - -- -      --   --       -  -- -   - -        --  -   -    --    ---    -- -  - ---
-  -  -     -  -  -- -   -- --  - -- --    -          - ---  ---     - -   - -  -    -   - - -  -  -
-     - -     -        -        - - - - --          ---     --  ------ -           -      -- -  - --
-        --  - - -- -       ---   --   - -        -  -   -     --  -  - - -- -       -      -  -   -
---      -    -    ----           -     - - ---   -  --     -    -  ---   -- --- -- -  -      -   --
-  - -         -    -       -  -      -   -     -       --    -  - ---  -  -     -   -- -   -  -  --
-        -   - -  - - -----  -   - - -        - ---    --   -       -     - - - -   -   -  -       -
-- - ---         - -   -    -- -- -             --           -    --   - -- - -    ---  -      -   -
-               -- -    ---  -  - -  -   -  -  -     -   -    --        --- --    -     -- -       -
-    -          - --   -     -   -      -  -- -   -      -   - -   -  -- -   -  -- -- -     -      -
-          ---  -   -    -  -     --   - --     -   -    -     -    -  -           -    -  -   -   -
- ---       -   -   - -     --  --- --     - ---  - - -- - -  -   -      --   -  -   - - -    -  - -
-   -  - -- --      - ---  -      -  -  -  -      -- -   -   - - --- - -        -  -     ---    - --
-  - -       -   -   -  --    ----  -  - -    --  -  --  ---        -  --  - --   --   -   -   -   -
-- - -   -  -- - -  -      -     - -     -  --- -   -      -      -     -    --- - -   -     - - - -
-  -    - -    -    -   - - - -         -- -           - --    -  - -  -   -           - - - -     -
-      - --   -  --         -   ----- --- -   -     -    - -        -    - -  ---      ---  -- --  -
- --  --   -- -  -     --  - --   -- -   -   - -     - --- - --   - - - -   -       -   - -     - --
--  - -   -    -    - -   -     --    -- -    -  -  -  -     -  -  -- -   - -    - -  -  -- -   ----
-    - -    -     --  -  - - -   - --  ---   -   ---  --        --    -   -     -   --  --    - -  -
-           - -         --- -   ----      --- -             -   - ---    -    --  - -- -    - -    -
-- -   - - -   ----- --- -  --  -          - -  -    -        -  - -   -- - --   - -     -         -
--   --    - - -      - - - -     - -       -  --  - -               -     - - -       -    -    - -
-           - -       -   ----     -     -- ---  ---  -- ---- - -     -     -    - --   -    -  - --
- - -----   --    ---   -      - -  ---       --- -   -- --   - -  --     --- ---    --       - -  -
-                   ----  - --- - - -   --  -       -    -   -  -- -    - -- -  -     -     ---   --
-       -  -  - ---   -- -  -   -  -  -    -  - - --  --            -  ---- ---      -  --      -  -
---  - -- -     -    -    -   --           - -  -  -   -   -   - -    -    -   --  - -   - - -   - -
- - -  -  - -  - -- --- - -       -   -  -  -  - -    - - - -            --  - --  -  --  - - -    -
-    -  -   -   -    -   - -         --  --  --  - -  --           - --     -  - -       -- --  -- -
--  - -       - - -          - -      -       -  - -     -  -  -- --   - -   -  - -  -  - --    -  -
-    - - -- ----  -      - -    -       -- -   -  -           -   - -    -   --   --      -  -     -
-  --  -- - --     -  -- -   --- ----     -        - -  - - - --    -- -- -       -      -  - -   --
-         -         - -         -  - -   -  ----   - - -    - - -     -       - -     ---  -    -- -
- - -   --  --     - -    --  -  -                  --         - -- -       --     --     -- -  -  -
-     - -    - - - -      ----    - -  -  - - -   -    ----- - - ---   -- - -  -   - - -   --   - --
-          - -  - - ---  -   - -- -  -         - -- -         - -     -  -           -  -  - -     -
- -  -- -    - - --  -    ---  - -    ------   -     --  -     - -    -            --    --     -  -
-- -      - - -  -  - ----      -    ---      -      - -- -- -  -     -  -      -   - - -   - -    -
-  -    -      --    -     -  - -  -    - -   -      -    -  ---   -       -  -   -   -  -  - - -  -
-  ---  -     -      --  - -   -  - -- - --  -   --  -   - -         -  ------  - -          -   - -
-          --- -   -   - -  -   - - --  -    - --      -       -             - - -  -              -
--  - --         -   - - --   -   ---      -- -  -      - -  -    --  --  ---     - - -     -   - --
- -    - - ----     - - -- --        ---     --   -    -  -    --    -- -- ---  - -- -             -
--     - -        -   ---- -      --    --  - - - -      - --       -  ----   -     - -  - -    - --
- -   -  ---              --  -- --   -   - -      -  --   -    -            --     --      - -   --
- - -  - -      - -  - ---  - --  - - -  -  -  -             -   - - - --  -   -- - -    -  -  --  -
- - --   - -- -    -    - -    -   - - - - -          -      -    -   - -   -   -  - -   -   -  -  -
-  -  - - - --- - --        --   -      - --  -         ---  -      - -  - -  -   -       -  -  -  -
- - - -    -   --          - - -      -     --- -  - --- -   -  ----          -    -      -  -  -  -
-  - -    - -- - -    --    - --  - - ---   -         -   --   -    --      -    - -  -       --- --
- - - -    -   - -  -  - - -  -  --- - -       -          --  - ----  -       --         --     -  -
-  - - -   - -   -  - - - -  - -          -  - - -     - - -    -- -   -  -   -- -  ------- - -  - -
--    - -        -    -  -       -- -  -     - -   -  -     --     - -    --    - -  -     -   - - -
-  - -         -  --    -  - -- ---  - - ---  -  --  -    -  -    -  -   --- -     -     - - - -   -
-         --             -  - --   -     -  -  ---- - -    -    --  - - --          --  -- -  - -  -
-   -      -  - -  --    --   -    ---  -     -   --   - --     ------ -   --   ----- -    - - - ---
-   --   -   -     ---  -  -   - -   -   -    - -    - - -   --- -      ---             -  -  -    -
- - -     -   - -   - --  -   - - -   -  - -  -        --    --- - - -       -   -- - -      -  -- -
- - -- - -  - --  - -    - --          -  -     --- - -   -- -     -   -       - -    -         -  -
- -     -                  - - -  --     --          - -        - -- -      -- -       -  -  -  - --
-    -     -             -  -  -   - - -    -   --    -  -  -   --  -   --    --     -   -  - -- - -
-  -   --      --- -   --  -   -   -  -     -- ---         --     - -   -   --      -  --  -  ---- -
-    -  -    -  --   -  ---  -   - - -    -   -   -- -    -      --- -      - --  - --- --  -- -  --
- - -         -  -- -    - --    -   -   -   -    -    -   -  -    -  -               --      -  - -
----------------------------------------------------------------------------------------------------
