100
100
----------------------------------------------------------------------------------------------------
-        --          - -          -  -  -             - -    -   --          -   -            ---  -
-   - -  -    - -  --      - -  - - - -   -  -  -   - --    -   -  -   -- --       --  -------     -
---    -  ----- ---    -  -        -    - --   --    -   -        -      --  -   -- -         -- - -
--- - -  -          -    -- -  -- -            - - -  -  -     - --         -   --    ---  --      -
--  -- --                - - -      -  --  -  - -  -     -  - -     - -    - -  - - --  --    - -  -
-- -  - - -  -      - - - -  --       --- -   -- -- ---   -    ---   - -    -  - -  -     - --    --
--- -  -   -     -    -   - -     -- - --   --- ---    -   -   -       -    - -- --  -- - - - -    -
--  -- - -    -  --  -     -  -    - -     -          --        -- - --- - -     -      - --       -
--      -  -     -   --   -     -   ----     ---    -  -   --  ---         -- -     -  -- --       -
---  - -   -        --      --   - -          -  -  -         -- -              -  - -   -  - -    -
--  - - --    -- -        --   -   -- --        -  -  - --          -- --- - -    - -    --    --- -
--  - -  -   -  -  - -           ---    - -   - -  -  -   -   -   -      -     - -     - --   -   --
-         -   -   -    --                   -    -- - - - -    -       -    -   -   - - -    -  -  -
- --   --  - -    - -     -   -  ---  -       --  -- -   - -  -   -      -  -   --- --      -      -
-    -  - -     -  - ---  - -  ---   -      - -      - ---  -- -    - -      -         -      -- - -
-       -- -          --  -   -   -      - -        -  ---  -  -  -   - -  - -    -- -   - --      -
-  --          -  -  -     - - - --     -    -  -- ---  -       - - - --    - --     --  -   --    -
- -   - - --- --   -  - -  --      - -    -          -   -   -  -  ---  ------- -   -   -        ---
-- - -      ---  -- -   --  -   -  - -      --- -    -    -    --     -  -     --   -   -          -
-  -  ---          -- -   -         -        -  -  - -- - --  -  ---     - -       -        - - - --
--            -  -- --     -- -  -- -- - - -  -  --- - --       -      - - -   - -       - -       -
- -- -       -   --     - - - -    -  -   -  -  ---       - - ---    --   - -          --  - --  - -
- - -       - -        - --   - -         - -   -  -- ---- - -     - -     -     - - -   -      -  -
- -  - -             - -   - -   - -  - -   -   --   -            -   ---  ---      --   - - -   ---
--    ----- -  -              -- --  -  -    --- -- -- - -  - -  -    -    -           --   --  - --
- -   -     - -  -    -    ---  - -      -  -     --      --   -   ---  -  ---  -  ---         --  -
-- -- --   -   -   -  -  --   -    -    -      ---  -  - -   -- --     - -  -  -  -     - - ---    -
--   -    -    - --    --  --- --      - -- -    --  ---  - -  -     -   --  -          -      -- --
-     - -  - -  - -  - -  -   -    --           -   ---    ---   -   - -- -   -    -   --  -     - -
--   - -     --  - - --  -     - -    - - -    - ----       --      - -- -     - -  - - -  -  -  - -
-  --- -    -   -   -       - --  -  -  - -      - - ---  - - -    - - -  -    --   --- -  -   -   -
-     -- -- - - -      -- - -     --- -     -  -                  ---   --  -  -       -     -     -
- - -       --   --        - -       ----- --  -- -             --       -  -- - -- --      -      -
-  - --  -               - ---        -   - -  ---- - -----    -      ---      - -- -   -  -    - --
-     -- -- ----  --- --      -      -     -   -  - --- -    -   - - -  --  -        -     - -     -
-       -       -      - -- -     -  --    -    --- - -   - -   -     -         -  - -  -    -     -
---    -        -  --    -- - ----   -    -           -  --   -- - ---    -                        -
-   - -- --         - --  -  -  - -    - - -         - -    -    -    - --    -   ---       -  -  --
--  --         --          --      --     --  -     -    - -    --     -  ---    -       - - -     -
-    -- -- -  --   -     --  -  - -  -    -  -     -  - -     -   -        -    -          -     - -
-   -  --   --   -- - ---         -       -       --- ----   - ---  - --      -    -    --    ---  -
----     --   - - - - -- - --        - -   - -  -   - -    -  --     -      - -       --- --    -  -
-      - --                  -        - --  -  -- -       - --   -  ----  -  --    - - -- -    - ---
--- -- -   -    -  -  -  --  - -   - -       -     - -    -        -    -       -  ---     -       -
-         -  -  - -           --  -    -       -  -             -  --  -- --   -  -    -- -   -  - -
-  -    -- -    -  --     - - -  -  -           --       --   - ----  -   -- -   -             -- --
- -   --    ---  -     -   -   -- -- -    -  -       - -- - -   - - -- --   -   -   -   -       -  -
- -   -   -        - -        -  -  -- -  - --  -  -    --      -     --      --- -       - -  -- --
- -  --    -    ---  --  -  -    -- -    - -    -- - -- - --     -    -  -         -  - -- -  -    -
-   -  -- -- --- -        --- -- - - -   -- - - -        - -   - - -     -  --       -   - -   - - -
-    --  - ---- -    -  -- -       - --   - - -     -  - -   - -          -     -----   -  - -     -
-      --  -       -   - -  -  -  -   - - - -   -  -  -   -   -   -   -     -     -   ---  -     - -
-  -- --    - --  - -          - - -- -   -  - - - -  - -  -- -  --  -  -  -      - -  -  ---   - --
-        -      -   -    -     - - --  --- -          - --    -   -- -     -   - - -  --- -     -  -
-      -         -   --  -      -    -        - - -       -  -   - - - -       -    --  -          -
-     -    -  -- -            - - --  -  -- ---  -     ---     - ---    -       - -    -   -- -  ---
-   -       -     -  --  -  - -   --      -  -    - -   -       -    - -        - -     - -      - -
-   -   -  --     -    --  - -- -    - -   - - -   ---- - -                -          -   - --    --
--        -  -  - --     - -- -      -    --- -     -      ---    -   -- - - ----- -- - --  - -    -
--   - -  - -     - -   --         - -- -     -  -  --   -  -- ----- - --          - -        --   -
- - -   ---    -              --     -    -      - --     --     - -     --             - -  -  -  -
-       - --    -  -    -  -- -  - --         - -  - - -  --        --  -  -   -     -- ---   ---- -
--  -- -    -   - -    -   -           - -- ---     -- - -         - - -  --  -   -  -      -      -
-       ---  -      -  ---  - --      -        -    - -  --   - -  - -  --    - - -    -- -   -  ---
-     -    --- - --       -  - -- -    -        --   -  - -        --- --  -    --          - --  --
- - - -  ---        --         -  -- -  - -- --- -- --  -  -     -   -   - --   -  - - -       - ---
-- - - - --    -- -      - - -   - -   -        ---   -   - - -    - -   -   -- - --      - -      -
-    - --   - -   -    - -      -   - -    --  -    - -  -       -  -   -  -    - -  -      -      -
--   --   -- -    - -    -   -   - -      - -   -  -    - -  --   - --    -   -    -----    --    --
-  -   -       -  - - -    - - -    - -   -  ---        -   - -     - ---  ----  --        -- - - --
- -      -- --- - -   -     -  -- -   --- -        - -  -  - - -- -     -  -       -    -        - -
-    -   --     - ---   -  -  -    - --- -  - -  - -     -     - -    -- --  - -   -   -   -- ---  -
-  - -     ---- --  -    -  -   -- - -    -  -   - - --- -- -  - -         - -  - - -  -- -     - --
--  - ---     ----   -- --     - - -   -  - - - - - --    -- - -   -  -- - -    -- -       -   -   -
- -  - - ---   -- --   -  --     - -        - --   -  -          -    --  -- --     ----- - - - -- -
-   -   -   -  -    -  -    --          --      -        -- -  -   - -  -- --     - -     - -     --
---   -  --- -  -        -  - -   - --     -- - -     -      -  - --  -     --   --  - - -   -     -
-    ---  - -     -   --        - -   -   - -    -       - -- -       -   -- - --    -           ---
--     - -    -  -  -   - - -   -          - -  - - --   -  - --   -  -   -    -  --  -  - - -- -  -
-- -    - -      --  -      -  -  -    -   - -      -   - -        - - --     - -     -- - -- -  - -
-     - -  ---  - -    --     -     -  -   -     --       --  -    - -  -   -   - --     -  --   - -
-      -      -   --   -  -         - -  -   --    -  --  -    -     -   -   - -      --  -       --
-        - -          -    --- -- - - -   --   - - - -     -        -  -  ----    --   -  -      - -
-   - -               -     -            -      -        -  -        -           -    -   -    - - -
-  -    - -- -    -   - -      - -  - ---  -- - -  -- ----  - -   --  --  --   -    -  ---    - -  -
-- - --- -     -     -        - -  ----     -  - -  - ---  - -  --   -    -- -           -   -     -
- -     - -  -  - --   - - -  -- -   -   - -  -   --     -  - -   ---                 -   -       --
- -     - -- -   -   -- - - -  -  --- -       - --       - -   - - -        ---   -      -         -
- --  ---    -  - - -  -        - -  -  -  - - --       -  -  -  - -       -  -  -   -   -  - - -  -
-   -      --         -  ---  -      - --   -    --             --     -    -      -  -  -         -
-  -  -- -          -  -        --    -      --     - -  -  --   - - -      -        -     --  -   -
-   --     - -- --  -     -  --  -  -   --- - - -       -- -    -   - - -- -     - -   -   -  -- - -
---  - - -- --      -    - -- ---   -  - -   -   -    --  - -  - -       -  --   -    -   -  --  - -
--   -- --  --   -     ---  - -     - --   - --  -        - -   -         -- -     - -   - --     --
-  -            - -  - -  -          -   - --   - --- -- -   -  -- - ---   -     -        -    -   -
- -    -  - - -  --     --  - --  --     --  -- -    -- --   - -- - -- -  -         --   - -     - -
-          -   -     -- - -- -  -  -  -       - - - -- -   - -           - --  - ---   -  -      - -
-  -  - -   -   ----          -     - - - - - - -     ---  -      --  -    - -   -  -   -   -  -   -
----------------------------------------------------------------------------------------------------
