100
100
----------------------------------------------------------------------------------------------------
- --       --      -    -        - -          -- -    - -  --    -      -   - -  -                 -
-   -  -          -  - - -  -   - -                          ---- -  -   --      - -  -- --    -----
-  -   ---   --- - --      --- -       - - --   - - -    -   -    -  - -       -- - - -     ---    -
-   - -   -      - -- -  -  --         -- -       --  -      --  -  -- - - -        -  - --  - -   -
-      --  -  --      -     - - --  --    -         -- -            -  -    ---        -        -- -
-- ----  -   -  -    -   ---       -  -- -- - -         - -- --    -       - --   -      - -  -  - -
-- -       - -       -             - -  -     ---     -    - -      -- --    -         -  -    --  -
-    ---  - - -     -      ---- - -        -   - -    --  ---  - - -        -  ---  --      -    - -
--    -     --     - ---- -     - ---    -  - -       - -   -   -    -    -    -           --  --  -
-       - - -     -    -             ---      - - -- --     -     -- -  --    -- -- -- - - -  -  - -
--  -- -        -      -- -- -- --  - - - - -- -  - - -          -   - -    -    - -         -   - -
-  --- - - -  -      -              --     -   - -----       ---- -- - ----  -   -    -  - -      --
--- -- - - - --      -  -- --- -    --       -          - -   - -    -  ---   -    - -  -   --   ---
--    -  -  -      -     - -        --    -    -   --    --   -   -    -   -  -    -  -   - --    --
-   -    --- -     --   -    --- -   - --     -       ---  -   -  - - -   --  --  -       -- -- -  -
--   --- -    - -  - -----   - - --   -   --   -    -- -       - -  -   -    -   -       -  -      -
-  -  -- -  -- -   -    -          -   -      -  - -  - ---    -             -- -   --   -  - - -  -
- -       --  - -   -  -    -- - --    -  -     -- -  --   -   --    -     -  -     -      -- -    -
-   -          -  ---   - - -       -- -  -   - - - -  -     --  - -    -    - ---    -     --  -  -
--  -    - -    -       - -      - -  - -     -  --    -   --   --   - -  -  -  -  - --  -       - -
-     --              -       -       -  --    -  ----  --     -   - - -     - - -- -  -  -- -   - -
-- --- -- ----     -    -- - - -   -- ---    - -           -       -   - - - --   -  -  -- - -  -  -
-      -   -  -    -- -  ---   - -- -  - - -     -  -   - -  - - - -- -         -  -   ---         -
--    - --  --     -               -           - - ----   -   -  --    --          - -      - --   -
-             -        -  --             - ---   - -          - -  - -       -  -            - - - -
-   - - -- -- -  --    - -      -  - -    -     -        --   -     -   --    - --  -   --       - -
- -    -   -    -     -  -   -       - --      -   --      -     - - ---     --- -         -    -- -
-- --   -                    --    --- -   -- - ---   -  -    --- -- -   --    ---       ---  --   -
--   --     -     --   ---      -    -  -    -        - - -      -       -   -  -    -      -    - -
- - -   -  -  - - - ---     -- - --   - - --     --      - -- -  ---       -   ---   -  - -  ---   -
- - -  --  -    -  -    -  - - -    --   - -   -    ---- -  -   -       --    -        ---  -      -
-  --   - ---- --      --- -  -  - -    --   -     -    - ---  - - --   -    - ------        -  - --
-- -        -  -   -   -  -  -   -  --   - -      - -  -     -    -   ---    -     - --  - -    -  -
-    -- --   - -- -     ---- -    --   -  -- -      -  -  -   -- -  -  - - -      -- -  -   ---    -
-    - -   --- - - -  -- -     - --    -  -   -  - -- --- -    - -    -  -       --              - -
--    -- -  -   -    - - --                -                   -   - --- -- -   -  -              --
- -   -   -  -   -   -- -  -- -   -   -  -     -  - -----  - -- ---            -     -     -     - -
-          - -- -    -       -             -  -            -- - -      -         - --  ------   -  -
-             -      -   - - -   ---  -- --      --  -  - -         --- -   - -       -     - -    -
-       --    - -  -  - -- -    -           - -  - -    - - --  -    -    -    ---     ---  -  -   -
-   -  -  - -      - -     -         --    --               - -  --     -          --    -  ------ -
- --       -  -  -     --    -       -   - -   -        -  --   -  -  ----      -- - -  -    - - - -
- - -- -- -       -  -  - -- --        -          --  -  - ---- --  -    - -    -        -    - -  -
-- -  -   --  -- -      - --- -     - -  -  - -     - -  -  -   --  -  -                 --      - -
--  -       -      -   -   -   - -    -  - -    -   - -       --     -   -   -- -   - -- -  -     --
-      -- - ----   -  -  --  --   -- -- - -  -  - --    - -- -      -  -   -- - - --    -       - --
-  -- -- -     --  -  -  -        ---     --   -     -          - - --   -- - -     -     -------  -
- -   - --   -   -   -   -    -- - - - -   -  --- - - -     - -          -   ---  -- -  - --      --
- -   --     --      -  --  - -    -  -      -   --   - -  - -- --    - - --    ---     -    -  -  -
-  -     - -   - --    -  --  -      - --   - - -  - -- - - - --    - -  -  - -       -  -  -      -
- - -  --- ---- -  ---- -     --   --       - --     -  -   --    -- - -  --  - -  - --- -        --
---- - -- - -    -      -  - -   - -   -- --  - -       - -  -        -  -   --- -  --  -     ---  -
- -      --  --      -    - - --           ---      ---       - ---     -  - -    -  -  - --       -
--     -        --   --             --         -  --  -- --   --   -- - -  - -  -  --  - -   -    --
-  -        --          -  -- -   -   - - - --  -  - -- - --- - -- -       -   -  -  --------  --  -
-    -   -- -  --   ---- -      -  ---   -          -    -- -- - ----  - - --  - --      -    -   --
- --  --     -- - --    -   -    -          --         --   - -    -  -        -  ----- - -   - - --
--  -  - - --       ----     -  -   --    --      - --        -  --   -  -- -  --         - -  --  -
-    -   - - - -  -    -   --  -        --      --      - - -      -    -  -     - -    -    -     -
-  --  -   - -   -   - -    -        -- - -     - - -    -   --  -- - -    --   -       --  -     --
-       - - - - - ---      --     -    -       --   --- - -    - --  -- - -  --  -  - - --   -    --
----     --   -        -       -   ---  -    -  -    --- --- - --   -  -     - - -  - -   -     -  -
-      -   - -    --    --    - ---  -  -        -  -  - -     -      -    - --- -   -  - -  -    --
-   -- --  -   -        -- -   - -     -    -  -  -   -  - -- -      -        --     -  -- -    -- -
--  - - - - -  -   -    -   -  -     -    -- - - - -    - -   --  - -    - --   -     --           -
-     - --   - --- - --      -  -          ---        - - -- -        - -        - -    -         --
- -- -     - -        --- -          -- -    -    - - - -- - --        - - - - -- -  -         -   -
-  - - - -     --        --   -     -    -    - - --  --        -  - ----     -   -       --  -   --
-  -  --  -   -    -       --      --   - -- -    --    --  -   ---    - -   -    - -  -     -    --
- - -        -  ----  -  --    -     -  -   --  - - -    - - --       ------   - -  -- - -   -   - -
-   - - --       -         - - -  -  -   - --    - -     -     -   -- - -        -   -  -  -      --
-       - -         -  - - -       -  -      -                    ----  - -  -   -----   -   -     -
--    -        --   -     -   -           ----    --   -   - - - -  -                -  -  -      --
-          -   -   -- -- - -   --    -        -   - ----  -   -    -  - -- -  - -   - -    ---     -
---  -       -  -    ---   - -     --   -   -       -  -   - -- --  - -     -- -    -- - -    -- - -
----- -   -  --   ---     -     --   -   - - - -     - -      -    -      --    - - -      - - -   -
-  -       - -      --     -- -  -        -      -   -  -  -       -      -  -  -   -- -      - -  -
--- --     -  -    ---  -   -     -- - ---       -  -       - - -- -    -  --             - - -    -
- -    - - -   --- -  -  - -  -    -     ----  - -         -      - - --    - -  - - -- ----     ---
- -  - -        --    --- - -  -    -  -   -      -  -- -        -   - - - -  -   -  -         -   -
-    - - -   - -  - -  - --   ---   -   ---        --  -      -  --       - -     -     -   -   - --
- - --      -- -        --     -- - - -      -   -- -     --   - -   --  -   - --  ---    -       --
-        -    --        - ---           -         - --  -      ----  -      -   -           -      -
-       -  -   - -  -  --- - -  -     -        -  - -      -- -    - -  --   -  - - - --  - - -    -
- -   --   -      --       -       -   -  -    -    - -    -   --- - - -        -  - --    ----   --
- - -     -  --  -   -     -- --  -  -     - - -  - --   - -       --   - -  -    -       --       -
--   ----     -  - - - -        -   -    ---   -       --   -             - - --   - --     --   ---
-    --    -     - --       - --  --   --   --     -  -   --   - ---  -     -- -  -      ---   -   -
- --        ----      -      -   -   -    - -    ---    -    -- -  - -  - -    ----- - -   -  -    -
-  - ---   - - -         -  -     -- -  -    - -    ---  - -     --     -- -   -    - -  --    --- -
-    --- -   -- -     - - - - - -   -  -- --   -   -    --     -  -- --  --   -    -     - ---     -
-  - -- -   -  -  --  ----     --          -   -     --     -  - -     -   - --  -   -  - -       --
-- - -        -       - -    -   ---  -- - - --    -  - - - -     -       -   -     -   - -       --
--      --  -    -       -  - - -   -- - -   -    -- -        -   -  -   - -     -- -- - -    -- - -
-         - - --     -- --    -- -   -    ---   - -  - - -  -          - - - -   - --      - -     -
- - -    --- -  --         -      - -    -  - -   -   -    - -   -  - -- - - -  - -  --     -      -
-   - --   --- -   ---  - -    --  -  - --       - -  - - - -- -     - -   -   -   -     -  ----   -
-    -   -      -                    -------    --  -             - - --            - -   --       -
----------------------------------------------------------------------------------------------------
