100
100
----------------------------------------------------------------------------------------------------
- -----     - -      --    -- -   ---   --  -    -     -  -  - -     -  -   --   -  -          -   -
-  -  - -  --   -- --   -  -  ----      - - -   -      -   -- -      - - --       -     --    -   --
-     -- - -  -   -   --             - --- - --      --  - -    -      --        -  -   -          -
-- - -    - -  --   -   -  --  ----  -         -  -  -  -  -- - - --    -   -   --- --  ---  ---  --
-    -- -  -   -    - -      -     -         -- -          -   -  -       -- --    ---     - -  -- -
-  --  - -        -  -  - --   - - - - -     - -                     --         --  - - -   -   -  -
-      -- -  - -   -       - --   -         - -  -   ---  -     --  ---       -   - -    ---       -
- -- -     -   -  - --      -   -   -   --    --  -  -  -   - -  - -   - -    - -     -  -   -   - -
-  -   -  -  -  -  - ----     --  -  -   -   -  -      ---   - -       -              -- -  -    - -
----- --   -   -    -   --     - - -     --- -- -   - -- -  - -    -    -- -- - -  -    -    -     -
-             -   --  -    ---- -   ----         --    -  -      -   ---     -- -   -       ------ -
--- --    -- -       --     -      -   - -      - -      -   -- - - -    -       ---  --  --   -   -
-      -- -  -    ---    - -    --  -       -     -     - - ----  --- -     - -   -           -   --
- -    --   - -  -  - -  - - - -  - --  - -  --- --          -   -  -     --       -  -        -  --
-  - -     - -         -      -- - -- -  -     -        - -  - - --  -          -   - -      -    --
- -- ---             -   -   -    -       -   -   -                    --  -    --  -   -  -   - - -
-  --      ---   - - -         -- - - --    -    --- - -     -  - -       -   -    -  - -          -
-      --   - -          - -- -- - ---   --   - -       - -- -- -           -  --  -  -    - -  -  -
--          -- --     --   - - - -        -  -- -   --           ---- - - - -    -     - - -    -- -
-   -- -  - - - -   -            -        ---   - - -  -    --  -    -   -  -  -    -   --   -    --
-    -  -   - -  --- - -- -  - -   - -- -    --      -- ---    -  - -      --     -- --    --      -
- ---  - -      -   - -   -    -- -- -  - --     -      -     - ---     --    - ---- -  -  -   - - -
---     - --             -   --      -   - --   - - -- - --          - -  - -           -- -   --  -
-  -- -    - - ---  -    -  -  --  -         - -   -  -  --  -  -  -   -  -   ---   --  -   -     --
- -   - --     -   -   - -   -   - -    --- -   - -        - -  -    -   --- -                     -
---  - -   --    - --    -- -- -    -   - -- -     -  -- ---    -   -- -    - -- -- -   -   ---    -
-  -   - -    -     --  -    -- - - -       -        -  -        - -  --    -    - -            -- -
-- - -   - -    ----     -  - -  -   -   -       - -      - -    --  -   -     -  - --   -         -
--      -     -  -   -- - - --    -    -   -   - -- -  --    -   -  - -      -- --      --    --  --
-    -       --   -       -- --- --  -   --  - - -      -         - - - -- -    -- -  --  ---    - -
-     -  ---        -      -        -  -      - - -   -   - -         --      -      -  -    -  -- -
- --- --    -    -  -   -- - - - - -   ---      - -      - --    - -     - -    - -    - --    -   -
-         -   -   -   - ----   --        - - -- -   -     - - -  ---   - --  -   --  --- -- - -  - -
-  -- -  -     -  -  -   -  --   -  -   -   -     -          --- -  -       -  -   - --            -
-      -      -  - -          - - - -   --  - -  -   ----  -    -  -     --          -   -  -    - -
- - - -   -     -    - -  --     -      - --  -    -  -   -  - -- ---  -- - -   -  -   -  -    - - -
-     - - -   --  -    - - - -- - -  --- -     -- -   -    -      --  --      -  --      -   - -   -
--   -     - - ---  --      -      - -      --    - --     -   - - - -     - - -  - ---   -- -     -
-    - - -    -- -    -   -     --   -    -    -   -  -- -   -   - -- -     -  -- -     --  - -    -
- - - -- ---   --   --      ---     --    -   --  --   -     --- -- - -  -   -  - - --   - -  - -  -
-   --      - -   -  -   - -       -     - -- --- - - ---       -    -  -          - -  - - - - -- -
- -   ----  -- -  -          -  -   - -     - -     --  -  -   -- -- ---  - -   --     - - -  - -  -
-   -   -    -   -  -       - -      - - - -- --- --     -                   --   - - -         -- -
- -  - -   -       -----     - -  -          --       - - -   -   -   --  -  - -- - -  - - -     ---
-    - --    -  ---     -  -     - - -  -        - ---  - ----  - ----  - - -         - - -  -- -- -
- - - --    -    -      --- -  -  -   -               --   -- -      ---- - - -- --   -    -   -   -
- - - - - - ------ --  - ---    --  -    --      --   -          -        - - - -     -    -    -  -
-  - - - -      --   - -    - - -  - -     -      --    ----     -  -  - --     ----    -        - -
--   - -       -        -  -  - -  -    - -  -     -      -   -- -  - -      -   -- -              -
--   --       - ----  --  - --   - --  -    -  -  - --   -       - -    -  -        - - - --- -    -
-     -  -  -        -       - - -  -    --  -  -  - ---  ----  -    -  -  -   -   -       --      -
- -- --     -   - - -      -   - -    -     -   -   - -  -    -  -  - -   - -    - ---    -  --  - -
- -   -   --  -  -   -- -- --   -- - --  -         - --       - -   -      - --- - -            -  -
--     - -  ---     - -       -  -        - --   -     --                    --  -- -  - - - - -- --
- - - -    -  -  -  -    -- -  - -   -----  - -      -  -   - -  -     - ---- -   - -       - -    -
-    -      -   -             -    --  --            -  -   -      -          -         -          -
-    --   ---    -     --    --  -   - - -       - - -  --   - -   -    --- - -  - - - - --   ---  -
- - -- ---    - -         ---   --  -  --   -     --     -       -  - -  -     - - -    -       - --
-   - -  ----  - -- -   - -        -- -        -  -     -       - ---            --      - -       -
-- -             --    - -  -   -- - -- -  -  - -   -  -- -   --       -   --      - --      -  -- -
---- - ---  -        --    --   --      -- -      --  -      --      -- -        -    --- -   -    -
-       -       -        -     -          -  - -- ---   - -  ----- - - --    --   - -      -    -  -
--    -   --   - -      - - - - -          ---   - -  -  -     - -          -  - - - - --          -
-  -  -   -  -       -  -----         -   -- ----- - - - --  -   --  --  -          - - -  -       -
-- -  ----  -      - -          - - --  -- -      -   -    -      -- --     -- - --     -  -       -
- - --   -    --  -- -     -      -        -- -   - - --   - - - -  -  -     - - -  -     -   -  ---
--  ---   ---            -    ---  -    -    - -- -      -    -   --     -       - - -- -  --      -
-     -      -    -     ---  -    -- -    --    - -  -  -    -   -      -   -- --   -     -  --    -
--- -    -    - -   -  - -  -- -- -   - --    --    ---     -    -  - --   --      -  -    -  -    -
- - --   -    --       -  -- -    -  - -  -      --     --    -       - -  -  -    -   -   ---     -
-     -          -    -        - -- - --  -   --    -- -  --        - - - - - - -        - --   -  -
-  -      -     -    ---   -   -    - --  - - --      --     -   -  - - - -       --  -  - - -     -
-  -  - -  - ---      -     - --           ---    --    -    -  --  --   -     -- --  -   - --- -- -
-   -  -        -- -  - -       -  -        -- --      -    -               - - -   - - -- -- -  - -
- -      - -     - ----           - -  -    -   -  --   -   - -- -   -  -  -   -      ---       -- -
- -      -  -     --    --  --    -  -   -- - - -- -  -               -  -   -   -     -  - -      -
--   - - -  -- --      --      ---   -   -- ---    --      -       -   -       -- --             - -
- ---     -   -       - -    -    --  - --     -          - -      -     -    -    ---  -- --      -
-- -    -   -      -- -       --           -        -  -   -   -     - -  - -       - -  -  --  -  -
-         --    -      -  --      -  - --   -    - -- -    - -      -      ---     -   - -    --  --
-      -   - -    -    --   -- --         --- -       - - ---     -- --  - -   -- ---  --    -     -
--- ---  -    -     - --  -          - - -- -     - -  - --  --  -     - -- --  -           - -    -
-  -   -     -   -    - -        -  --       - -   - - -   -   -   - --    -  -  -  - -    -- -  - -
- -   -  -  -- --- -  ---  - - - -  -- ---              - - --   -       --  -      - -    - -     -
----- - - -   -  --  - -    -   --  -  -       -- -   -      - -  -     -   -- -  -     --- --    --
----         --     -    -   -    - -    -    -  -  -  -   - -     - -   --- --  -   - - -      -- -
----    -     --  -   -- --       - -    -  --   -  --    -    ---    -  -     -   -  -    -       -
--    -  - - -  - - -        - -    -         -   ---  - -- ---    --  -  -      -    --    - -- - -
-     -    -  -----               -        -    -    -- -  -  -           -  - -    --  -       - --
--     - -   -             --   -- - -- -     -   -    ---      - ---   -   -- -  - - -    -   -   -
---- -    - ----- -- -- -  -     -      - --     -   --     -        -     -   - --  - --   -  --  -
- ----  -    --   --      - --     - - - -     -   - -     -  -    - - - -- -        -  ---  -     -
-      -   -  -- -     -  -    -          - -   -- - - -- -  -   - -- -    -      - --       ---   -
---    -        -   --   -    - -  -- - --   ---     --- -    - -    -   - -- -   -   - --       - -
- - - -- - - ----      -- -  -- --    -        -  -   -  --    - -        -  -  -    - -   -   -   -
- -   -  --- -    -   ---    - - - -- -- ----      --     - -   -  ----        -      -- -  - -    -
--   -- -    ---  -   -      -    - -  -               - - --   --      - - -    -  --    - -      -
-  -  - - -  -        ----   - -   - - -          -   --  - -     --   -        ---   -   - - -    -
----------------------------------------------------------------------------------------------------
