100
100
----------------------------------------------------------------------------------------------------
-      -            - -  -  -- - -   --  - -   -    -    -    -  -  -  - -       - -         -     -
---      -    -   -  -                  --   --   -- -   - --  -      --      --     --       -  - -
- ---   - ---  -  - -  - --   - -         -     -   -  -  -    - --      - -- - -          -   - - -
- --       --   ---      -    -   --  -  -    - -     - -    -    -- - --- -        - -   -  - -- --
--      - -     - - --- -     - -      - --     --- - - -    -       -     - -- -   -   -- -  --   -
-   -        - -        - -    -   - -        -   ---- --   -  --  -    --    -    - -     -   -   -
--      -  ---        -    - -   -       -       --  -       --      --   - --   - -   -    --  -  -
- -             ---     -   --   -      -  -- - - ---  -  -    --   --- ---    -    -      - -    --
- ---    - --  --   -  -      -- --  -- --  - -  - - -   --- -   -      -    -- -     -  -  -- - ---
- ---  - -  -    --   - - -     -     - -  -  ---   -- --   --  ---   -              - --       - --
- -   - -  -  --- -----    -  -   -    --          --  -  -- -   -         -           -      ---- -
-   -   --   -          -      -     --               -  -  -    - - ----    -   --  -  - -    -   -
---          -- -   - - --  -  -   -      ---    -  -   --     -  -  -    --   -  -  --    -  -    -
-     - --   -    - -  - -     - --   -         --   -      -- -          -     -    - -       - - -
-- - - --   - -    --- -         -  -   -- --- -          - -      -      -      -    - -- -   -   -
-  -    ---     -      - -  --      -    -     ---    --    -  - -      -    -    - -       --     -
--  -   -  -- -     -     -     -         -       - --  -   --     -      - -  -  - - - --    --  --
-  -     -- --   --- -- --  -  --  -  -      -   -    -   -    --  -   --    -     - - - -- --- -  -
-- - -  --  -        -  --   -- -- -    -- -- --    - -- -- -- -- - -       -- -   -    -  -  -  - -
--     ---- - - --  -     - -     -    -- - - -    -- -    -- -  --   -  -   -    -  -- --      -  -
--   -- -    -  -     -   --       -  -      -  -             -     -    -       -  -         - -- -
--       -- -   -   -          --   - -   - -  -   --          - -   -        --     -    --- ---  -
-- - -  -   -       -    -  -      --      -   --   -         - -   -- - -   -      -- --      -   -
-        - -   - - - ---  -       - -   -      -   -  -   --   - - -           -   -- -     - - -- -
--  -  -  -      -      -   - - -   -      - - -   -       - - -  - ----        - -   -  -  - -- - -
-     -  -  -  - -     -      -          - - -- -     --         ---       ---   - -- - - -     -  -
-      -    - ---      -    - - - -   ---  - --   -   - - -   -     --- -    -     -      -   -  - -
-     -- --   -   -  -   ---   -  --   - -   --      -       -    --           -          --  ---  -
-   - -   -    --- --  -        -    -           - -  -      --         -    -  -  - -       -    --
-      --  - -  -     -     -       - -      - ---       -- - -     -   - -  -    - ---- --  - -   -
-  -   -  - -       -    --  -  ---  -- --             -  --  -        -    - -- -  - -  --- -     -
--   --      -- -            - - - - - --   - -      - -    -  - -  --- -  - -   --    -- - - -    -
-    -      -    --- -      --- -      -  - - - -  - --  -- --  -     -        -      - -   -    - -
-       --    -    - --       -  - -    ----- -   -    -         -      -   --   -  --- - -    - - -
- -   - - -  -      -  -- -     ----   - - - -  --  --   -   -  -   -    - - ---  -                -
- - - --   -   - -         - -    -  - -   -    - -     --   - - --   -    -  -   -- --  -- -- -   -
-   -   -- - -     -    - -   - --      -      -  --  -      ---- - -  - -- -   -   -   -     - -- -
-- - -- - -    -  -  -     -   -  ---    -- - -  - - - -      -   - - -        -   - ---- -- - - - -
-  -- -   - -  -   - -    -     -   -   - -   --   - -      - -     -- -    -- --         -   - -  -
-- - -  - --  - -  --  -    --- -  -  - - - -   - - -     - -     -  - -      -      -  -  -- -   --
- - -  -    -         --  - - - - - -  -  -   -       --  - -   ---- -   --       -      --   - - --
-  -  -     -  -   --  --     -  -       -   -   ---- --  - - -     -   - - -  -     -   -- --- ----
-  -     --    ---       --- - - -      - -    --     -   ----  ----   --  -  -  - - --     -      -
-  -  -    -      -  -   -   - -   -    -   -      -    -   -     -   - - - -   --  - --   -  -- - -
---    -  --    --- - -- -  - ---   ---- -  --    --     -    -       -- -    --  --- -  - - - -   -
-   -- --      -    -  - -   - --                          - -  - -     -   -- -    - -   -    -  --
- --            -   -  -    ---  ----   -- - - -    - -    - -         - -     -  -        -     - -
-       - -     -    -- - -    -- -  -   -              - - -  - -- - --  -- -- --  -   -- - --    -
-    --   -      - -  -    --   --  --    -      -   --   -- --- -   -          --  --      -     --
-   -    --  -       -   --     - - - - -         --     ---       --        -  -          --   - --
-  -  - ----   - -    -       --  -   - ---   -  -  -      -   - -   --    -  -     ---   - -  -   -
-  -      -  -   -    -  -  -  -   -     --- -   -     - -   - -   - - - -  --  -       -       -  -
--   - -  -       -- --  -  -----   -   -     --    - -     -   -    -  -  -     -  -   -   -      -
-   --- -  - - --       - -   --  -  -     -- - - -- -- -  -          - -  -  -  --   - - - --     -
-    -  -   --     --   -  - - - -  --           -        - -       - --  --- -   -     -  -----   -
-  -   -  - -    -- - -- - -      -    -     -       -  - -       -      - - -      - -  - -   -   -
-     - -   --  -     - -  -  -  -  --    ----    -    --   -       -    -   - -  --           -  --
- --   ---   -   -   -- -  ---    -    -      -  ---     -  -   -   -     -  --  -    -         -  -
--   - -  -   - -- -  -  -  ---  -        -  - - --  -  -       -     ---     --    -  -- - -  -   -
- --  --                        -  - - -      -- -     -      ---  --     - -   -    -       -  -  -
-  - -  -  -  -- - -   -      - -   -- -- --  - --     - -   -        -    -     -  - -         -  -
--    -   - -    - --  -   --    -          -  --   - -- - -  --    - - - --     -- -      -       -
-     - -   -                --    -  -   -   -   -   - --        -     -  - - -    - -  -   -     -
--- -----  --     - -   -  - - --      - -- - -- --     -  - -   -    -  -    -          -   -   - -
--       ---      - -     -     --   -      -          -  -       - - -    ---- - - --  ---  - -- --
-  ---- - - ---  - - -  - --- --   -         -    -  --  -- - -                - - - -     -       -
- --        -        - -     -     -- --  - -- -   - -   -   -     ----     --- - -     - --    -  -
--      -   --    - - - -- -      -     -- -     -     -      -- -        - -         -     -   -- -
-    -  -        - -  - -    -   --   -        -  -- --      -    ---  -  - -  -    -          -   -
- -         -- -    --  -- -     -    -  -      - -- -  -- -   -- - --   -  --  -  -  -   -        -
---  -   --   -       - -   -  -        -   -  -  -    - -  ----  -   -   -   ---- --  -    ---    -
-        -     -       -  -     -- -   - -                     -       --  --  -- - --  - -       --
- - --- -    - --     -   -      - -- --   - - ---    ---- --      -  -       - - -       -  -   - -
-  - - - --- -    -  -- - - - -     -      - -   -- --        ---  -      -   --        -   -  - - -
-  -    -   - - -  -  -   -  -      - -   -        -- - -- -      --  - -  --     -         - -    -
-    -    --     ----   ----   - -  -   -  - -- -    - - --  -  --      -             -   -     -- -
- -   - --        -          --    -  -      -     --   -  --  - -      - - - -     - -   --       -
-    --     -- --      -   -  -      -    -   - --  --- - - ---  - -    -   -- - - -  - - -     -- -
--        -  -  -   -- -   -    -- -  -- -    -   -   -     -     -   - - -  - -- -  -     ---    --
-   --  -    -    -  --  - -  -   - -  -    - -   --     -   - -- -    - -- -  - - -- - --       - -
---  -  ---    -          -     --      - -        -     - - --   - ---- -   -- -   - --  --- -    -
-  --    -- -  -     --   -  - -    - ---     - --  - - -      -   -  - - - -   -- - -  -      - - -
- -   --  --     -       --   ---- -       -   ----  --  - - ----   ---      - -   -       ----    -
- - -   -     - - - -- -    - --      -   -  -   -  -  -- -    -  -     -  - - -- - -  -   --  -  --
- -  -- -      - -        -- - -   --       -      -      - -   - -      -     -     -   --  --- - -
-           -    -   -- -   ---  - -  -     -    -    -  -- -       - -   -    -    -- - -   -   - -
- -- - -  -  - - - -   -  - -  -   ---  -  -- --   --- -       -  -       -  -   -   - - -         -
-          - -  -  -- -- - -  -   --    - - -           -       - - - -    -   -   -     -  -  - ---
- - -  -  -   - --     - - --       -  -      -    --       - ---  ----- --  -  -   -- -  - --   - -
-     - -   --     -- - -   -        - --              - --      -   --   ----   -    -  -    -  - -
- -    --  -     - -   -    -   --       -   -        -- - -   -  -  -    -     -- -   -      -    -
-- --    -   - -   -      -  -- -  -       -   --       -- --    - -     -  --  -   - -  -  - - -  -
-    ----     - --         -      ---- -     --  - - ----    -   - -- -        --      -  -- -   ---
-  -     -     -     -   - -      ---      --   --     -- -- -  -  -- -   - - -    -   -    ---    -
- -   --  -  --- --  -- - -  - ---   -     -   -       -- - --    -       - -       - -   -   --   -
---    ---          -    - -  -   --   -    - --  --           - -      - ---  - -  -    -  -- --  -
-         - -    -  -- -  - -        -    --   -  --    --   -   - -      -   -   - --      - -  - -
- -     -    - -   -   - -    ----    - -- -    -    -- -        -             -  -                -
----------------------------------------------------------------------------------------------------
