100
100
----------------------------------------------------------------------------------------------------
-    ---      -  -    -  - --  -     - -  -    - -         -     -----  - -  -   - -  -  -      -  -
-           -    -   - ---  -      -  - -    - --   ---      --   ----     --  --            - --  -
--  -        -     - - --  - --    -  -   -      -   - -          ----                  -  -       -
-    ---  - -         --  -           -     -  -   -- - -- -     ------   -    - -- - -   --  -    -
-   - -   -  ----          ----   --            - -- -  --  -  -  -  -    - - - -           -    - -
-           -  -       -- - -   - - --  -  - -   --        -   -   -    ---  - - -        -    -   -
-   - --- -   - -  ----   - - -   - -   -  -       --  -   ---      -     -   --     - -- ---      -
-       -     -  - -   --     - -           -   -    -   -      - ----  -- - -  -- -  - -  -   --  -
- ---  -  -   - - -- --  - - -    -  - -       --  -- -  --- -   - -    -   -   -   -    -     --  -
-  --       -   --    -   -- - -   ---  - -   ---   -  -   -    -   -          --   --     -     - -
-   - - --  ----        -    - --    --    -    -    -             ---       - - -- ----      ---- -
--    -         -   - -  -  -    -    -     -   -   - -  --  - -      -    - -  - --        -- -  --
-   -   - - ---        -     -     -      -- -  -     ----    --  --  -     - -       -  --     -- -
- - -  - -  -    -  -     --   -      -  -  -    -       -    - -     -- - --   -  - ----   -   -  -
-  - -- --   --  -    - --       -     --   --      - -          -           -- - -- - -      -    -
----  -- - --- -  -     -        --     ---           - -  -   --   -   ---   -  - - - - - -  - -  -
-  - --         -- --  - - -   -        -   - -  -  - -- -   -    - - -     - -  -  -  --- -   -   -
- - -  -     ---- -     -    -      -  -  -  -  - ---     --  - -       --  -  -- -      --        -
-  -- -       - ---               --  -     -  --- -  -            -    - -   -    - --- -      -  -
-    -      - -    - --     -       -       -    - -  -- - -  - --- -   - --     -  - -   -- -     -
-      -  - --  - -       -    -      --  -  ---  -              - - --- -      - -    - --     - --
-   -- -   -       --  --- --     - -    -- -   -   - -  -   --    -     -  -  -   - -- -   ----   -
-       - -    --     -        -    ---      -        --- --   -     -  --  -  - -    -   -     - --
--     -  --  -   -      --- -          -  --        -   -       -- - -   ---    - -   - --- - -   -
-- -       - -  - - -        -     -          -          --     -----  - - -  -  -  -       --     -
--   -  -  -      - -          --- -  -     -  - -   -  -      -        -      - --  -   -     -  --
-- -    - -  -      -   - - --   -   --   - -    --   -----  -- - -       -  - -- --   -  -      - -
- - -      -  -    - --         ---- - -   --       --  - - -   --     -    --      - -       -    -
- - -  - -  --   -    -     - -  - -  -        -  -  - --      -      - ---       --  -    - -  -- -
-  - --  --      --   -    -  --  -       -  -   -   - - -  -  -    --     - -    - -  - - -- -    -
--           -      -    -     - -    --- - -    -     - - -- --  - -    -     -    --  - -    -   -
-  --   --    -  -  -       -  --   -        - -  -  -  --    -   -  -   - - - -        --   --    -
-    -- -  -      -        -- ----  -   -- -    -   - - -    - ----  --   -     --                 -
--  - - -    ------     -  -- - - --  --   --     -- - --   --   --    -   -           --        - -
--    --  --   --  -- -   - - --   -      -    -  - --  - -  -  --  -- -- --  --     -- - -- -     -
-     -  --  --      -             - -  -  - --  -  - -        - --     -   -   -     - - - - -   --
-  --  --  -     -  -  - --        -     -  --   -   - - --     -  -   -  -- --   -    -    -      -
-  --    -         -- ---  --   -    ----    -   -       -    -------  -  -   - --    - -  -  - -  -
---  - -        -  - -  -- -  -  -  -    -- -        -    -        - -  --     - -   --    -      --
-- -   --   -          -    ---         -   - -  -        - -  -  --   -- -- - - -  --   -  -  -   -
-- - --- -- -  -  -  -- -    -  - -    -   -- -  - -    -   -- -    -   - --   -  --     - -       -
-      -  --  - -   --      - -  -       -  - --       - -      -- -     -   --      - -     - - - -
--     - -      ---  -  --   - -     -  -- -  -   - -- --   -     -- - -  --  - -       -     -    -
- --  -  -         -  -    - -     -  -       - -   -   -- --  -   -        - - - - -- ---     - ---
-    -  -- -    ---    -     - --  -  -         -      -   -  -  - -  --       ---        - -   -  -
-   - -    -   --  ---- --   -- -     --  ---  -- -        -       -    -      - - -- ---  - --  - -
- --  - - -    - -    --- -    -      - --       - -    - -  - -   -           -        -    --   --
- -  --  -  -       - -  - -   -      ---   - ----     -- -- -  -  -   --- -    - -  -     -    - --
-                 --  ----    - -      -  -           - - -  - -  - - -       -   -  -   --    --- -
--     --- -- -             -            -  --    --    - -  -  -  --  --                  -   -   -
-  - - -     -   -  -     - - -    -  --- --     -   -   -   -         -  - -    -   -    -        -
-        - -     - -  - - -  --  -       --    --    -        -- ----  ---- -  - - - -  -  -- -  ---
-   -   -- -     -   - -  --    -   - -   - -- -   -  -   -   - -    --       - --       -  -   -  -
--  ----     - -     - -  -  --  - -       -       - -        -   - -  -    -    - -   - --       --
-- - -      -  -  -  --  -  --    -  - --      -        --  -- -  -  -  - -   -- -      -  -- --   -
-           -    --   -  -    -     --   - -          --   - -   -  - --   - - --     -  -  - - ----
-      -           --  -    --   -   -       -- -- -     -  - -   -   -      -- --       ---       -
-   - -   -    -         -- -    -- -   -   - -  --   ---    -    ---  -    -      --  --  - --  ---
-    -  -    -- - -   --    - -       --- -   -      -       -    - --  -   - - - -   -- - --    - -
-  -      - -      -   -   -  - - -      -   --    --   - -      - ---     -   -         - - --- - -
- -- - ----    - -- --      - -     -    -              -  -    ---      --   -- -    - -      -- --
--- - --    -   -- - -- -  --    -   -            -   -- ---      - ---        - - - -  --    -    -
-    - -            - --  -   -     ---    --  -- -  -  -   - --    -  -     - -   - - - ---- - -  -
-  --  -    -  - - --      -    --      -            --   -  - - - - -- -    - -    - -         -- -
-  -  -             --         -- --  -   -  - - -     -- - - - -  -       -  - - - ---   --  --   -
-- -       -  -  -     - -   --      -  -   - -      -  -  ---  -- --    -     -            -  - ---
-   -    -- -        - - --     -  -    -- -- -       - - -     - -  -  -      - -  --     -- -    -
--  -  -- -  -   -  -- -   -  -   -   -  -   -    ---    - -  - - -- - -    -  -  -     -      - - -
-    -   - -   - -    -     --   - --- -       -- --  --    -   - - -    --  -- - - - -        -   -
-  --  ---     -    - - -    -----  -  -    -----    - -    -      - --    --       ---     -   -- -
-     -   - -  - -    - -  - -   -- - - -  -  -  --  -   -  - -   -   -   -- --- -----  ---   -  - -
-                     -  -    - -       -  --- - --- - - -  - - --  -     - -          --   --  - --
-  -- --  ---  --  -  - -  -     -   -    -  -  ---- -- -  - - -- - - -   -        ---- - - - -    -
-     -        -         --  - -  - -  - -   -     - -       -     -   -   ---  --    -- -- -      -
- --        -    -       -  - - -     --  -   - -          -- --     --  -     --    -       - -  --
-    - - -     -   -   -     -         -     -    - -- -- - ----   -    -  -  - - - -  -   - - - - -
--   - -  - --     ----  -  - --    -   -   --   - -   - - -   - - - -  -- -- -  --- -    --  - -- -
-           -            -- -  - -   -  -  -  -   -     -     - --  - - -          - - -    -   - --
-   --  -  -- - -   --  - -         ---   -  - -   ---  -  -  --     -- -     -        - -    -   --
-  ----    -   --- -    -   --  -   -- -   -   - --  --  - -               ---  --    --  -- - - - -
-  -   -    --        -  -    - - --  -   -- -  ---  - -  --   --  -- -        -  -- -     - - --  -
-       - -- -  -   - - -   -   -        - - --    -   --      - -     -   -- -    -   -   --      -
- ----      ----      - - --      --   -       -       -   -    - -    -     -  --     -     ---   -
--    - - -  -    - -   - -  ---    --    -       -      -  -        -     -   -   -   ---  -  -   -
-- - - -  - - -- -       ---  -  -  -  -    -   -  - -  - --  -    -  - - -        -      -    -  --
-  - - -      --    -   - -  - --- -  -  - -  -  --  -- - - - --      -    --      -        -      -
--- -   -    -   -  - -    --     - -       -    -    -- -  -     -  -         --       -   - ---  -
-- - -   - - - -    -  ---- -  --   -  -- -- --  - -  - -   -   -    --  -  --    -          -  -  -
-  - -- -  -       -      -   --- - -- --  --   - -           -    -      -  -  -  - -     - - -  --
--  -  -        - --    ---- --    -  -- - -         -  -  -    - --  - -  -           -  - - -    -
-- ---- -                     --     - -- ---  -   -  -  -           -   - - -     -  - -   -   - --
- - --     -  -   -     -  -  -   -- - -   -  --   -    --    -  -  -   -     -   --        -      -
-   -  -- -    --- -     -     - -    -  -         - - - - -          -   - -  -     -  -  -   -   -
-   -  - - -- --     -     --   -      - --    --    -  -       --     -    -  - - - ---  -    -   -
-        - - -   -   -- ---       -   -  -    -   - - -- - -- ---        - -   - -       -- - -    -
- -       ---  --    -   -   -     -  --- - - -- --  -      - - -     -  -  --        - ---  -   - -
-  -  -- - -      -     - - -  -  -  - -  -   -    - --  --    - -   -    -   - -- ---        -   --
-        - -   --    -    -  -    - - - -   -              -          -         -      -----    -- -
----------------------------------------------------------------------------------------------------
