100
100
----------------------------------------------------------------------------------------------------
-  -    -    -  - --   -     -       --         -         -        - - -   ---  -    -             -
-     -        - -   -  ---   --- ---    --      - -   -- -- - - -   -   - -      - -    -  - -    -
-  -  ---         -  -   -- --        ---   -  - --    - -   ---    -        --   - -  - -      -  -
-       -  - - --  --  - - - ----- - -  - -  -  -     -          --         -     -     --     - ---
--   -  -   --     --  -  ---  -    - --- --   - -   -     -    -  --  - - -  -   -   -      -  -- -
-     -      ---  -      -  -   - --    -  -- ---          --  -     - -  ----    -  -   -   --    -
- - - --   -      ---       -    -   - -  -  -  -   -    --    -     - - -    - -    - -  -  ---  --
-- --        -  -    - - -   -   - -  - -  -- -   - -  -    - - - -- --  ---- - --    -  -       ---
-     -  - -        -     - -   -    - ---  -   -    -    - - - - -     - - - - -  -   --- - ----  -
- - -       -   --  -----         -     -  --- -- -  -    -      -   -     -   -  --  - -   - - -  -
-  -  -          -       ---- ---  --               -           -       - -    -    - --         - -
-  - - --        -     - --  - -   - -  ---   -     ---      --  -   -     -       -     --   ---  -
-- - --  - --- -       -        - - - -        - --     -------   -   - --            -        --- -
-  - -   -   --  -   - - --      ---     --   -  -    -      -   -- - --                -- --      -
-      -  -   -    --        --- - -  -     -  -      -    - -      -  -         -  -  --   --     -
- -  - --     --           - - -   - - -      - ---   --       -   - -      -     --  - -- --- -  --
-  -  -  -  -         --          --   - -         ---   -- - -  -       -- --        -  -    -    -
- --     -  -      - -       - -  -- -   -   -  -     -  ---- -    -    - --  -     -  --  - -- -  -
-  - -  -  -         -    --- - -   --    -  - ---   - -  - - -    - - -    -  -         - - - --- -
-      - -  - --  -   --                 -- -     - ---    - -   -- -  - -   - -   -  -       -    -
-  -- ---- -  -  -   -  -  ------ -         -   -  -   -- -- -    -  ----       --     --  - --  ---
- - -       -   - - --  - -         - -----    -- ----   -     -   -     -        -  --  --        -
-  -   -----        -  -   -      ---  ---   --- -   -- -   - -       -     -    -  -    -  ---- ---
- - --      -   -  -     ---   - -         --   --    -  - -      - -    --    -  -      -   -   - -
- --   - -    -  -   --  --    --- ----  - -  --- -  --          --   -       - ----  --       -   -
-   - - - -     -        -   -   -  - ---  -    -  --     -         -   --- --    -  --- -     -  --
-         -  - - -- -   - -     --            -- - -  -- - -- - -   - -  -  -  -    - - -          -
-   --  - -    -           - --  -      - -  - ----      -       -           -     -    --   - -  --
-             - -  -- - --- -   -       -   - -   - --   -  -  -   - -- -   -- -      -  - -   --- -
- - --  - -      - -  - -  -  -  ----- - -           -  -- -   --  -- -     -  ---  - -      -- -  -
---    -  -  -             -  - -    ---     - - - -     --   -         -    -   - -    --  -      -
-          -- -        -- -- -  -   -    -          -  -           ---  -- -  -- -    - ---  - --- -
---- - - -  -    -    -  -      --   -   -  -    -- -     -        --    -       -     -    --     -
-     -     --      -  ---   - - ---    -      -   -- -         -      -  --  --   --  - -       - -
-       - -  -         -- -- -      --- - --- -   - - -- ---   -   -- ---   ---         - - -      -
-- -    --   -   ---    -  - - - -     --  - ---   - ----  - - -   -  -  -   -    -   --  - -  --  -
-   -      -- -- -   -   -  ----  -  - -       -    -    - - --- -  --- - -   --   --  -  -   --   -
----   - -  -- - -       -       -        -          -    --  - -- -       --      - -   -   -   - -
--  --   -   --      -   --  - ----- -      -   --  -- -   -  -    - ---   -     -- -- --       - --
-    --   --     - ---     -       - -         --  -     -       - --  -  - -- -  -     --   -- -  -
- --    -         -    --  - - ---- -  -            - -  --          -- -   -        - -      - - --
- -  -- - ---- -     --   -  --    -  -   -  - --- - -      -- -   -  -  -      -- -   -  ---- -   -
-  - - -    --       - -  - - --- - -  -    --      --     - -  -   -- -  -    -  -    -   --   -  -
-    - - -- -     --        - -  -      ---     --    -- --          -- --   -  -- - -  -     -  - -
-  - - --   -  -   - -   -- -   -    --  -  -     -  -  - - - --- -- - - - --      -        ---  - -
-   ---  -   -     -        ----    -  -         - -- ---     -         -- ---      -    --     - --
---  -    -  - -- -    - --   - -   - -   --   - - -     --   - -  ---  - -   - -    -   -         -
-   -  -   - -  - -  -  -       -      - --- -- - -  - -- ---- ---         -  -           --  --   -
-    --  -      -            --  -  - -  ---     -   - --- - -     - -  -----   --    -  -        --
--   --    -  --    --    -       --      --      --- -         -   -   -    - -     - -  -  -  -- -
-      --  -  - -           - -- -      -    -  -        - -      -  -   -- - - -      - -   ---   -
- - - -  -    -     -   ----   -  -                --     -     -  - -  -      -  -  --  -   - --- -
-   - -   -        -  -- --   - -  -  - --  -- - -      - -   - - -----   - ----     - -    -   -- -
-    --  --       -- -   -       -- - - -     - -  -   -    -- -- - --          - -- ---        -  -
-      -   - - - -    - - -  --     -      -  -- -    - -             -  - --    - -    -  --- - ---
- -- -  - ---  -  -  -  -  - -  -  -- -- - -  -     - - --     -    -         --  -   -   --    - --
--  - -      -   - - --   -   ---  -       -            - -   -- -       -   - -- ---    -  - - - --
-  -    -     --  -    --   -     - -        - -     - -    -  -    --   ---     --   - - --      --
- -  -    ---   --     -  - - ---       ---      -   - -   - -      -    -- -   -   - --- - --     -
-    -----  -   -- -   -     - -     -    -    --    -   - - -    - -    - -  -  -      -- - --  - -
-         --   -       --- -      -    ---      -   -  -            - -  -   --- -  --    - -      -
-   - -        - -   -  -   -       - --      ---- -- -      -  -        -      - --         - -- --
- -  -      --       -   -  -         -   -         - -  -   --- -   -  -  - -- -                  -
- -      --     ---   - -   -      - ---  -       --  - --        - -    -      -  --    -  - - -  -
-       ----    ----- -  --     -  -- -  -                  ---                - -  -         -    -
-    - -   -   --         ----        --   --    -                   --      -   -  - -- - -       -
- - - -     -     -----  - -   -       - -  -  -- -      -   -       -  -   - -  - --     -  -- -  -
- - -   - --            -    --- - - -   - - -   - -- - -  -   -- -    - -         -       -  -    -
-     -  - - - - --       -      - --   -  -   - -          -   -- --      -- ----   --  -         -
--    --  -  -      - -     --        -  ----    -  - --  -  -    -       -  ---   -       -      --
- - -  - -     -   -      -     -- --  -   -  -   - --    -    - --  - - -- -     --    -   - --   -
- --      - -- --  -    ----   -   - - -             - - - -  -         -      - - - - --     -  - -
-  - -   -          -   -    - --   -  -    -       - - -  - -      -   -  -   -      -- -   -   - -
-       - -       -  --   ---  - -    -  --      - -  -  -  --    - -   -  -  - --  -- -    -- -   -
-- - -  -  -     -     -          - -       - - --        - - - -  - -      -  -   - -  --    -    -
-               -  - - -- ---   --  - -    --          -  ---  -      -    -  -  -  -     - ----   -
---- -    -     - -  -- -     - -  -- -  --    ---   -   -          -  --      ---   -    - -  -   -
-           -  -    --        --  -   - -    -   -       - -- -- --   -              - ---       - -
-  --  - -     - - - -   -    --- -    -      - -- -    -- -      - - -  -     --- ----  - -  - -  -
-       -- -----   - - -  -  -        -     --     -- --   -    - - -  - -    --  -    -  -        -
-  --                - --  ----  -      -   --       -- -  - --  - -  -  -   - -     --        -   -
-    - --  -   - - - - -  --  --       -  -   -- -  -    ---      -   -   -- - - -   - - -- - - -  -
-  -            -      ---    - --   -   -  - -  - -- -    - -  -- --   - -     -     -   ---      -
-  - -- - - ---   - --  -    -     -  -       -- - -     - --  -         -     -    --           - -
-     -  -                -  ---       -              -    -  -     ---      -   - -     - -   -   -
-        -  --    --  - -  -         --      ---- --- -     -  -  --    -            -- -   -   -  -
-     -   -  -     -    ---        -     --      - - - -    - - -      - - - -- - -- -     -----   -
-    -  -  -   - ---     -----  -   -              - -    -   - -   -- --   -   --   - ---      -  -
- --   -     -   - - -  -  -  - -  - -    - --      -  -- --   -     - -     -    - -      -   -   -
- -  - -  -       - - -  -- -  -     --      -- -   - -  -- --   - - - -  -- ---    - - -          -
-  - - -   - -  -     -   -   -       --- -     - -    -   -    -  - --  --      --       - - - -  -
- -  -           -- -- -     --- -     --   -     - -     -  -    -         --  -   -- -        -  -
-    - - - --                 -        -              -- -  - - - -  --    -     -   -     ---     -
-   -- -       -  -     -  --     - - -    -- -- - -    - - -  -  -    -  -- ----   -  -  - - --  --
- ----- - - -    --   - - -       -  - - -  -    - - - -- -   - --   -  -        - -   --    -     -
- -   -   -  -            --- -- - -       -- - -             -   --- - --- --       - --  -    -  -
-- --   --   - --  -    -  ---     - -  --   - --     --  -  -  - -     - --       - - -     -     -
-        - -    - - - -     - - - -    -     -  - -  -    - - -      - -   -  -        -   -  - -  -
----------------------------------------------------------------------------------------------------
