100
100
----------------------------------------------------------------------------------------------------
-  - -   -  -    -  - - - -     -        -    --   -   - -          -- --       ---   --     -- -  -
---     - - -      -    --    -  - --   --      -- -       -     -  -          --    -  -  --    - -
--  -      -   --    - -             -     ---      -     -  -      -   --       -- - -   -   --  --
-       -   -  - -   - --   -  - --   -   -  -   -- -  -   -  -    -      - -             -- -     -
-        ---- -  - -  - - --   - -   -  -         -  -- -    -    --  -- - -    -   -     -    --- -
--   -- ---     -  -    -   -      -       -  - --       -   - -    -- -     --- - --   -    -     -
- -   -  --   - --     -  - - -  - - -   - -        ------   -  --                 -   -     --   --
-  -    -   -  -  -- --  - -  -   -           - -  - -     - - - ---  ---    - -     - -    -  - - -
-   -  -  -    -         -     - -  -- -  - ----     -  ---   --         --    - - - --     -      -
-     -- -  --  --  -    - ----  - - --    -    -           -- -- --  --  -   -   -   -  -   -- -- -
- - --  - -  -           - -   -   --  -  -   -     -    -   - - -  --   -    -- -   -    ----     -
--     - -  -       -      - ---   - --  ---     -- -  --      -- -    --    -          -     -  ---
--    -   -----  - - -      - - -      -      -         -  -   - -  ---          -       -     -   -
-- -  -- - -  -- - -   - - -  --- - -   -  - -   --            -      -     ---     -    -- -   ----
-  - --         -      -  -          - - -   - -  ---    -  - -  - -        -  -  -      - - --    -
-   --   -   - -    -          -  -    - - -    -   -  --  -  -      -  --   ---   -    -  - - -- --
- --  -  -    -  -    -- - -  -  -  --     - - -  -    -  -  ----      - -- -     - --        -  - -
--    -- - -  -   - -    --    - -  -    -- -- - - - -    -  -         - - -  - -    -  -     -- - -
-  --  -     -   ---  - -           --  -     --  --        --- -     -   -    - ----      ---     -
--  - - - -   -     - -    - -      - -  --    - - - - -  -    -    - - ---    - --     - -   -    -
- ----    - -   - - -     -    - -- -  -  ---  -           --   - -   -     --  -         - -      -
-    -  - -            - - -    -- -   -        ---  -   -      ---  - -   -   -  -   -        --  -
-- --   -    -    - -  -  -  - -  --  - -- -- ----  - --  --    --   - - -    -   - -  -    - -    -
- -  --   - -             -  -    --  -      -          -- --    - --    --    -- -- -     -     - -
- - -- -- -- --- - --     -   -  -    --   -     -      -      --   - -    -  -    - -  -   -- -  --
-      - - --       -   -   -- -  -  -- ---        -    -   - - ---  -  --  ---     -  -    -- --  -
-        -     -     - -    -               -   -   -    -   - -  -- -    -    - -- - ---  -  - -  -
-    - -  --- -   - --   -- --  --   - -            -    --  -  -      --- - -  - -      --  -   - -
-  - --              -  -- -   -     -  -   --- -- -  -    -  - -----     -  --      -    -   --   -
- - - -  -   --   --  - -    - - - --  ----- -         -   -- -      -  - -     - -  -  -  - --   --
-- -  - -  -         - -       - -         - --- -      ----  - - -      - ----  -  -     --      --
- --      - --- -    -             -  - --       - -   --     -   - -  -  - -   - -  --          - -
--- -- - -      --  -   --       -  -  -   -  - -   -  -     -  --          -- - -  -            ---
-    - -   - - -     - -- -   -  --     - -   - - -   -         -  - --  -   -    --       -   -   -
-  --        -     --- ---   - - -   -    -      - -         -- - -  --  - --        - -   -- -    -
-       - -  --- -    -    -- -  -   - ---  --  - - -           ---   - - -     -   -  - -- - - -  -
--  ----  -   -      --  - --  -- -   -           -  - --   -      - -      - --       -      -    -
- -    -         -   --  -     -   --        - -     -- ---- --  ---   -       -  --         - -   -
-- -        - -  - -   - -  --  -     --  -  -     -  - -  --    -         - -    -   - -   -   -  -
-  -   -- -         -      -        --   -  -    - -  -- -  - --   - -     -    -   -    -    -  - -
- - -  -  -   -          --    -  -- -     -    -      -- -   -     -  - -        -  - -- --       -
- -  - - - -         -    - --         - - -    -   - ----- -    --  --    -   - --           -    -
-          -  - -      -   - ---  -   -   -  - -     - -     --     - --        -    -  -         --
--   - - - - -   -  -  -  - -   -      --   --    --- - -  -        --   -    ------ -  -   -      -
-       -         -  - - -  -  -  -  -    -      - -  - -  --  -  - -      -     -  - -  -      -- -
-    -       -  -      -    -   -- --  -  - - -  - -   - -   ---  -    - -  -  - -  -   - -  -   ---
- --        -  - -    - --     --    - -- - ---   -        - - ---- -- - --   --   -   -     ---   -
-     - -  -    -   -  -   - -    ----  -   ---     -        -         -    -         -   ---  -  --
- --        -  -  -     - -- -   -                     -  -    -           --     -    -   -- - -- -
--    -  -- -   -  -  ----          - ---   -    -  -          - -    -  --   -      - ---    - -  -
--    - -  -   -       - - --- -    - - - - -     -  - -  -- -    --   -      -  --  ---   --- - - -
-  -    -   -  - -  - -        - -  - -     ----    -- - -     -    --   -- --  --    - -  -  --- --
--        -    -               - --   --   --       - -     -   -     -- -     -    --  - - - -   --
-       -     -    -   -    -- --  -  - - -  - - - ---   - -  - -  - -   - -         -   - -- -    -
-   -     ---      - -   - -   - -- -    - -  -   - - --   --        --- -  ---           - -   -- -
-- --    -  -  -    - -      --- - -        -   - - -            -    -       -     --   ---     - -
-  -  -- - -      -- - --- -  --     ---   -  -- -   - -    - --   -  -   --  -   -   -       -  ---
-- - --   -  -  -   -  -   -      - - - ----     -        -- -   - -    - - -  -       -   - -     -
-   -   -  - -    - -    -   -- -             - --     -- - - --         -    -- -   -  - - - -    -
-    -           -        -   -        -  -- -    --         - -    -       -    -   -         - ---
-      -  - -  -  ---   - - -   --  --   -  --- -    - -- -- --     - - - -  - - ---     -  - -   --
- - --    -      - -   -   -  --- -  ---  -          - - -     -  --      ----       -  - --   - ---
- - -   --    --     - -- -  - -        - -   - -       - --   --  - -   -      - - --    -- --    -
---       -    -      -  - -       -  ----      -- -  --     --  -      -  -   - -  -  - -     - - -
- -       - -    --     --    --   -     - --   - -      -         - - -          -   -- - - -     -
- -   -  --  -- -- -- ---    - - -   -     - -       -    -  -    -    -  --  - -  - -        - - --
- ---     - ---  --- --  -  --  - -    -- -  - - -   -     -   --- - - --           - -- -  -    - -
-  --  --   --         -    -       - -   -- - -   -    - - -- --   -        --   --- - -   -      -
--- -    --   -  -   -   -    -    -       -  -      -    --- - -  - -  - --         --  - -  - - --
-     -       ---- -   - -   - -       -   --      -   -     -    - -- ---    --- - -  -           -
----  -  --  -       - --  -   - -   --    - --  -     -  -  --     -- --    -  -     --     -     -
- -- -        -  -- - -  ----       -   - -  --   -             -          --- --   -   -   - - -  -
-    --      - -    -   - -    --  ----   - -  - -  -      - -       -  --   -- -  -          -    -
- -- - ---  ---   -- -    -    -    -    - -- -    - -  -- -  -     - --  - -  -  -- -  -   -      -
--   --     -  - -       -- -- -   -    - ----- -  -  -   -    --     ---- -  - -  -    -    -     -
-   - ---    -   - -  --  - -     --  -- --    -    -  -- -     - --- -    - -- -   -  -          --
- - --                - --      -   -  -   --   ----     -       -     -            -- -  - -   - --
-    --       -  ----- -    -     -    -   -        --   -   -  -- --- -      -       -     -  - - -
-  - - - -   - -  - -        -   -    -- - -      --- ---   -- --- -        - - -- -- - - -- - --- -
- --     - ----  ---      -    -    --   -        -       -   - --   -     - -     - --         - --
- --  --     -       -  -  - --  -- -           -         - --   -   -   -  -       -     -     -- -
-      - ---   -  -  - --    - -   - --            ---   ---  -   --            -   - -     --     -
-   --  - -                -  -   -   -  --          -    -   - - -  ---     - -    - - ---  - -  --
-  -   -     ----        - --    --     -    --   ---       - -    -       -  --     - - --    - - -
--     -           - - -   -  -          - - -     ---     -  - -- - -- - -     -    -- ---   -    -
- -        -   -----      -  -      --     -  --    - - - - -    - - - -    -  - - -  --    -   -  -
-    -    -  --        -         -   -    ----  - -    -   - -  - -      -    -  -  - -   --- -    -
- - --  -   -   - - - -    - -     -                  --  -  --   -  - - -- -- -      -- - ---- -  -
-         -    -  -     - -  - --    -   - -    -         -  -     -   -     - -     - --  -    -- -
-    --     - - - -- -   - - -      - -- - --   -   -   -   -      -   --  -  -      - -    - -- ---
-         - -  - -   - - -    - - -  --    -     -  ---    -    -     - - -   -  --    - -         -
- -- - -- --     - -       - -   - -   - - -          --  ---       - -  ---   --     - --   -  -  -
- -          --  --- --  -     -   -       -  - -    -   - ----- -   -- -- -    --- --        -    -
- -  -  -  -    - -          - ---  -- - -             -     -  - ---  -      -  - -    -  -  -  ---
-     - -- --  -       -   - --  -           -   -   -  -   -      - -- -- -- - ----      - -      -
- - -   -   -- -  - - --       --  - - -         --  - -  - -      - -   -      -      -    -      -
--    - - --- -       --            -    -   -   -  --     - --  - --    -   -   ---    -   -   -- -
-    -   -  -- -    -   -         -    - -   -  -     -  -      -   -           -  - -      -  -   -
----------------------------------------------------------------------------------------------------
