100
100
----------------------------------------------------------------------------------------------------
-  -     - --    -   - -              -       - - -                -  -   -  - -   - -     -    -  -
- -     -     -            - - - - -     -     -  -  -   --- ----    -  -  -     - - -    - ---- - -
-- -      ---      -      - - - - - -- -- -     --   ---      -  - -            --      - - -  --- -
-  -   ---    - -  - -  -     --      -   - -  -  -     --         - -    -   --       -- -- --   --
-  --    - -  -  -- -           - -  -      --- -- --  -   -       -  --  -   --      - - -    -   -
--    - - --         --    - - -  -- -  -     - - - -    -  --  - - -   -      -   -  -            -
-  -   - -    -          - -    ----   -   --   -    -  - -- --  - - -   -                ----     -
--       -- --    -       -  -     - -- -- --- - -    -     -   -      -  ---   - ---   -      - - -
-  -    -  -  --   - -  --  -  - - ---        ---   -      --  -  - -    -         - -  --- -      -
-   -  -     - ---  -    - -    -       -- --    - - -  -- -   --- -- -       --  - -   -  - - -   -
--- -  - - -       -  --    -   --   -  - - -  --           -    -    -           --     -   --  - -
-    --  ---- -  -   -          -  - ---  -     -       -    - - - - -  - - --  -   -- -- - -      -
--  -            -       - -     -  - -  -  -   -  -       - - -   - -  -  -  -- - -  -- -    - -  -
- - - -    -  -       -   -   - -   -   - -     --- -          -  - - --  -      -  --     -       -
- -          -  - -   -    --   --        - -  -       - - - - - -      -     --               -- --
-         -          -  - -  --- -   -  -  -         --          --   - -    -  -    -       -  - --
-         --    - - -  -   -         ---- -     - -         -  --     -- -  --                 -   -
---     -    --   --  --      - -   -        -     -- -   -    -  -          - -    --     -       -
- - -   --  -  -     -   -  -       -  ---   ---    - -   -- --      - - -       - -   - -- - - -  -
-  -  -       -   -     - --   -   --    --       -  --  -            - -  --- - - -- --      -   --
- - -  --- -          - - - - - -     --       - -  --    -    -  - -   --     -  - - -   ---- -  --
-        -   -       -     - --  --  -    - -     --  -      ---    -   - -  -  -  -    -          -
-    -     -      -   - -      - -   - -  --  ----     -    -   -   - --                 -     - ---
-- --     - --    -        -    -   -       -      -    - -  -    --    -     -  - --   -  --      -
-- -  ---      -       ---- -   -    - - -     -  - -    -  - -- -    -      ---     -    -   -  ---
--  -    - --    - -  -     - -  -    -   - -  - -    -  -  - -   - -  - - --  --- - -  --- -  --- -
-  -----     - -      - -- -    -  -   - -    -   -      -     --     -    -     -     -          --
-      - - -        - --  - -   -  --  - - -  -  -- - --     - --    ----   -----  ---  -- -      --
--    -   -- --    - -  - - --          - -  -- -  -  - --       -     -        --    - -          -
-      --    -  -   -  -   -   -    --  - --   - -            -     ---  -  --  -   -    -     -   -
-   -    ----   -        -  --    - -  -  -            --   - - --       ---- -  -  -  -  -        -
-   -  - -   -   -  -  -      - -- --     -       - -      - -  -   -- -     - ---      -  - -  -  -
-    -   -    --  - -      --        - --  -       - --            - - -  -  --   --- -     - -  - -
-   -    - ---     -     -- --- ---  -- - - ---       -        - -     - -- -     - --   -     -   -
--     --  - -         -    -  - -  -   - -       -     -      -- - -           --    -- --   -   --
-    -  --  -- --- --          -       - - --   -     -   -        --    -  -      -         -     -
--     -  ---    - -       - -       - -    - - -    -     --- -   --  --   -- ---   --- -  - -    -
-   -    -   -   - -  --  - -  - - --  - -   -  -    -  -        -  -      -       -  - -    --  - -
-             - -    - -  -  - - -   - -     -    - -      -     -       - -- -  - --     - -     --
-   -  --   -  --   -         -  - -         -  -   --  -  -    -  -   -      --- -   --   -   -   -
- - - -- - - -   -  -- -- -  -    - -   --- -   - -       -  -  -- - -    -     - - --  - -   - -  -
-    -  --    -- -     -      -  -   ----          --      --  -  --      --              -   -    -
- -         -      --   -  -  -- --  -     ---  ---- -     -    -   -  -    -    -  -  -  - --  -- -
- -  -  --    -  - --  ---   -        -- --    - ----   --      -    -  - --  - -    - -  - - -   --
-  -- - - -   --- - -- -     - - --- -     -    -    --  ---    -         - - --      -       --   -
-      - -   -   - ---  - -- - -  - - -   -- - -  -     -                    --  -     - -  - -    -
--   - -   -- - - - -     -    - -   -   -            -     -- -  --   -   - -  - -  --   -      - -
-    - -  - -  -   -  -- -       --   --  -   - -  -  -     -          - - -  -    --    ----      -
-- -  - --    -      -   -    -    -  -  -  -   - - -   -    --   - ---   -      --     -     -   --
- -- - -  -   -            --      - -- --      --   -   -     -  -  - -    - --      - -  -   -   -
- - -     --- - -  -- -  -   - - -   - -  -  -  -        -     -   - -   -         --  -    --  -  -
--       - -    -   -- --   - -    -- -    - -       --- - - -- -      --    - - - -      - ---- ---
-  --  - --  - -       -   -    ---           -     -  - - -              --      -   ----    - - --
- -  -    -      ---   -      - - - -   -  -  -    - -        -   -      --  --  -     -  -   -  - -
- -   ---    - --  -   - - --   -    -    -    -         - -  - -  -   - --   -  -    - - --  -    -
-  - -  -    -    --     -     -    --   - - - -  --  - -        -  --   -  --  - -       -   -    -
-   -    -  --  -  -  -  -  -     - -  -  -      - -    -      -    -    -   --- -    - -- -- - -- -
- -   -   -     - --        --   -   -        - -  ---   ---- -   -   --  -- -    - - -         -- -
- --  - -  ---  -     - ----  -    -- - - -   -  -           -  -       -    -- -  - --       -    -
-     - -   -  -             -   ---  -    -      --     --  - -- - - - --   --    - -  - -  -  -  -
- - - -    - - - -     -  -   --- - ---  - - -          -- --      -   -   -   - -   -  - - -   - --
- -  - --    -   - - -   -  -    - - - - --   - -    -       --- -    - -     -    -  -   - --  -- -
-        - -     -  -   -     - ---         -   ---     ---- -  - - ---    -     -   -    --     - -
- - - --- -  -- --        --  - -   --  -  -   - -- ----  --  -  - -   - -  -      -  -     - --   -
- - - --     - -              - -- -- - -        -       -  -   -              -    -  -  -- -     -
-     -       -  - -    ---- - --- -  --  ---  -    -  --   --    --   --  - - - --  - - -    -    -
- - -  - -  -    -     -     --     - - -   - - -  - --       - --   - -     -     -    -  -- -- - -
-       - --  -    -     -  -  - - -    -  -    - - --     - -- - --         -     ---  - -  -    --
-  - -  --  --  -    --     --- - - -  --  - ---    -   -- -  -  - -        -  -      -    -- - -  -
-- -  -    -  -          - -      - --    -   - --  -   --   --- -  --    --- -  --    ---  - - -  -
-   -  -  --- --  -   -     -  -   --  - -        -     - - -     -  -  -  -- --      - - - - -  - -
-  - - - -  -  -   - - --- --   ---  -- -      - -  - -- -- - -    -     -   - ---  -      -- --   -
- -          -  - - -   - -   -     --- -----  -   -    -       --- --- --  -  - -  -    --  -  -- -
-          - -- -  - --  -- ----  -    --  -     -  - -  - -- -    - ---     -  -    -- -- --      -
-   - - -  - -    -   ---      -       -  -- -        -- - -  --   --     -    -  -     -   - -    -
-- - -  -   -   -   - -   ---   -  --     -  -  -         - - - -  - - - -          -- -         - -
- - -  -    -            - -- -  --   -- -      -- -     --  - -  --  --  --        - -       -    -
-       --   -     -  -   -  --   - -   - -    -   - - -  --         - - - - -   -   - -   -       -
-           -  -   -   -   -          --    --     --    -    - -   -  -  -  -  -    -- ---        -
- - --  -  - --    - -   --       -  --  -     --    --    - -    - -  --       -        -  -  --- -
-     - - - -- ---  -   -  - -  -     -  ----      -       -- - -     --- -  - -     -    -      - -
-- --    -    - -   -     -    ---    -     -  -- -- ---  -       -    -   -    --  - -  -  -  - - -
-  --         - - - --  - - --    -         -  ---- - -    ---- -    -      -    - -   - -   -- -  -
---         - -       -   ---  --  -    -- -   - -   -  --  - - -       - -  -- --    -  - -       -
-          -- ---        --               -  -     --    -   - -   -  -     - - -     - -  - -     -
-    ---  -             -- -     -- - -    -  ----  ---     -  - -      -   -  - -  -- -  ---   -  -
-     -    -   -  --  -- -   -   - - - -            -- - -     -      -  -    --  -     -   ---  - -
--   -       - -       -  -   --   - - -  -   -    - -    - --         --   - -   -   - -   -- --  -
- - - -  -       -             -   -   --  -     -  -  - - -  --- - -  -  -- -      -  - -   -    --
- -   - -  ----   --          - -  ---             -  --       - -   -    -       -  -         - - -
- - -   - -    -    -   -  -         -  --  -    ------   - ---   -   -  -  -- - --  ----          -
- - - -- -- --     -    --      - -   ---       - - -      - -      - -   -  -         - -     -   -
-    -  -   - ---   - ---  -     - - -   -   -  -     -    -   -    -   -    -   --    - -   - -   -
- -  -  - -         -   - -  -  -    ----  - -  - -   --  --    -  -  -   -   -     -    -   -- -- -
-    -  -        -      - -   -- - --   -  -   - - --         -   -     - -     - -  -       --   --
-        - - --- --   -- - - -   -  -     -     - -    --   --    --   - --        -     ---   -  --
-  -   -- ---    -         -        -- - -        -    - - --         --   -       --  -- - --- - --
-    -   -    --- -      - -  -  - -      --  - ---  - - -- -   -   --  -   -- -- -              - -
----------------------------------------------------------------------------------------------------
