100
100
----------------------------------------------------------------------------------------------------
- -  - --  - ---       -    -           -    -      -      - -  -  - -      - - -   -     --       -
- -      -      -   -  -     -  --- -      -   -  -  -- -     -- - - - -  - -     -     --- - - -  -
- -   ---   --        -    --       --  --    -    --- -- -  -   - - - -      --   -   -   - - --  -
-   -  - - -    -- ----  -   -     -     -   -  -   -        -        - - -  -- --        -  -  -  -
-       -    --   -    -  --   -- -  - ---    -        --   - - -      -    -         --- - - --   -
-  - - - --  - -     --  - -       -     -     -  ----     -    --- - -   -      - - - -      --   -
-    -    --   -- - -  - --   --- ---   -      -- --       -- -  - --   -   - - -      - - -- - -  -
-   -  --- -     - - - -    - -  -       -  ---     - ----    -   -      --  --  - -  -   -  -     -
-   - --         -  -     ---    -  --  -           -    -    -  -   -  -  --     -- --  -  - -    -
--- - -  - - -   - --  ---      --    -        - -     -      -      -   --           -   - - --  --
-  --             -         --       -   -- - -     -     --    - -       - ---  - -        -- -   -
--         -     -     -    --  - --   - - -  - --    -     --         -  -     - --    - -    -  --
-        -     --  - ---       -  -- -   ----  -   - -   -   - - -- -   -  -    -    -   --     -  -
-        ---  -    --    -     -      --  - - - --  -     -    ---    --     -          -          -
- - -    -       -    -       - -   --  ---   -           -       - ---  - --        -  - -    -   -
--     - - - -   ---    -   -         --    -     -  -   -    --   -   -  -       -  -  --  -    - -
--         -    - - ---- -  ---  --  -  - -- -       ---  - ---    -   -  -  -      - --   -     - -
- --      - - -    - -    -            - -       ----   -- --   -   - - - - -   -   -   --   -- -  -
- - - -   -  - - -  - - -   -- - -     -- -  - --    -      -- ---  -  -  - -      - - -  --     - -
--  -     -    -  -       -  --  - -  -- -     -  -    -- -- -          --    -      - -  - -- -   -
-- - - -- -    -    -      --  - -   -     ----  -- --      - -  - - --   -- -     - - - -  -  - - -
- -   -- - - -- -  -              -- ----              -  -  --  -       -     --  -      -  - -  --
-    -     -        - - --     -        - -    -  - -    - -      - -    - -     - - -- - -     -  -
-   -   -  - - -   -           --   -        - - -      - - -  -     -        -- -         - --    -
- -  - --   -- --    -----    -  - -      -     -           -  ---      -   -  - -     -    --   ---
-  -- ---  -   - -    --   -- --   --       - -    - -- -   - - -  -- -- -   -  - - - - --      -  -
-       -       -  -   -  -   -  -     ---- --  -        - -    -     -     - - - -     --  -   - --
---- - --       - -- -- -       -    -   -    - --  ---   - -- --  -            - -   -        --  -
-  - -             -      - - -   - - --  - --  -       -     -   --  -  -  -   - --     -    --   -
-  -- ---  - - - -- -- -      -     -- -- -    - ---          - -    - -  -  - - --      -  -    - -
-          -- -                  -     -- --- -     -       -    - -   ---  --     -- -      -  -  -
- -    -  - ---  - - - -            --- - -   -   -   - -    -   -  -- -       -  - -   -      -   -
-   -   --    -- -  ---   -   -----    -  --  ---  - -    - - --    -          - --  --  -- --   ---
-  --  --  --     ---     -  -     --    - -  -         -  - -  --    --      -   -   -  -         -
--    - - --  -   -   -    - - --    -  -   -         --          - -   - -   -    -  -     -   ----
- -   -- - --  ---     -   - --    -   -   ---- - -    --   - -    -          -     --  -  -   -   -
--   -          - --  -    - -- -         -- -      - - - --   --- - -   -  -      -  --       -- --
-      -  -    -   - -   -      -   -     -   -      - -- -   -    --  - - -  -  - - - - --- --  - -
-        -- - --            -  - -    -     -- - - - -  -   -  -   -          --     --      -   - -
--  - --    -- --    -    -  -   -  -  --   -  -    - -     --  -   -      --  --    - -      -- - -
-  -    -       -  -  --  ---   - - - - -  - -      -  -    -   -  -  - -- -      --   --      -  --
-  - -  -  -  - - -    --- -  -  --       -  -   -         -    - -      -  -   -- - - -  -       --
- - -             -- -    -    - ----- -- ---      -- - -- - - - -  --     -       -   --  -     - -
--      -     -- -      - -  -    - -  -    - -  -  --   -    - - -  -    -  - --    -    -    - - -
-        - -- -     -      --  --   -        -  -  -      -   --  -     - -  - - ----- -- - -      -
-   -    - -  --    -   -  -  --   - -- - - - -  --- - -  - --- -  -- -    -  - -  - -    -- --  - -
--   -     -    --  -   -    -   --    --     - -   -   - -    -     - -    --  -- -     -- -      -
--  - - - -   -   - -      -     --  -       -    -   -     -- --- -         - -    -   - - --   - -
- --      - - - -   ---         -  -  --     -   -  -            --      --   - --         - -  - --
-  - --   --  - - -        - - -- -      --       - --  -    - -      - -   ----  --  -     - - -  -
- - - - -  -      --         -        -    -  --       - -    -   -- - -     -  -   - -  --   - - --
-       -  -- ---   - - -  ---     -   - - - - -  -  -  -     --  -     --    -   -   --  -  - -   -
-    - --    -    --   - --   -  --    - -   -  - - - -     --     -   - --    - -    --  - -     --
-   -  -  - --  -   -- -- -- -           - -  -  -- - -   -- -- -    -      --- -    - -     -  -- -
-   -    - -    -- - -   -   -  --   -  --      -- -     -  - -   --   --- -     -  -   -        ---
-  - - -  - - --             --     -  -     -    - -  -   --  - --   -   -     -  -   -     --    -
-    -    -- -     --    -  ---   --  -      - -   -   -  -    -    --  --    --               -   -
- -     -   -   -- --  - -   -         --    -    --    -   -  - --       -     -      - - -  - -- -
- -    -  - - --- - -   -- -  -- -- -     - - -- -   -  - -- -      --  - --  - -  - -  -     -    -
--- -          - -      -  -- --  -    - -  -- -     - -   -         ---    -      -- -  -  -  - - -
-  -- - -        -        -         -    -           -  -  --  --- -- -    -  -   -   -  - --      -
-     -   --- -     -       --   --  ---        --       - -   -        -    - -  -          -   - -
-    ---    - -   --- -   --  - - - -           -  - -- -- -      --  -      - -  ----- -  --      -
-      - - -  - -   -  - -   -  - -   --   -- - - --             -   -- - -  -- -  -  -  -   -    --
-   --       - - - -   -   -   - -  -    - - -   -    ---   --               -    -       - -  --  -
-       - -    --  -  -       -       -  --   - -  -   -      -  - -   --      - -  --  - - -     --
-  ---   -  -         -  -   -  -  -        -    --  -       -  -  - --  ---    - -- -             -
--- -   -   - -    --  --     -      -     -    --    -  -   -  -  ---  -  --    - --- - --- -  -- -
-- -   --- --        -    -   --  - -   - --      - -   -     -          -  -  -  - -  -   -- -- - -
-   --  --  - - -    -     --  - -  -      -   -   -        -  -  -   -- -  -  -- - -   -  -  ---  -
-     --        -      -        ----  --      - -      -  - - --  ---     - -    - - -  -         --
--  -  -      -      - -   -- --  -  -       - --        -   -            - -    --   --  --- --- --
-     --      -   --    - -     -  - -   -   -  --  -             - - -  -      - - -  - - -     ---
-  -  -   --   -       -   --   - --   -  -       -  --   --  -  -   -       -  -    -  - - -  --  -
--  -  -        --    -         - -    - -  --      -  --   --  -  - -  -  -  -  - ---          - --
-    -- - --            -   - -          --      - -  -       -    --  -    - ---- - --  - - - -- --
--  - - -- - - -      - - - - -     --    - - - -     --     -- -    -   - --               -    - -
--   -    -     - -      - -    -   -- ---  ---- --- -    --  -  - -   -   -  --     --    -   - - -
-    -   --    -- -    -           -  -  - -          - -   - -- --   - ---        --  -- -   -    -
- --  --  -  -  - -      -  - --   - -- --    -      ---    - - - -      -   -  -    -  --    ---  -
- - -  -  -    -  -   - - - -- -    -- - - - -    --  -   --   -  -  -   - - - ---    --   ----- - -
-   -   - -     - - -             -- -      -     -  -       -   -  -- --        -   -    --    -  -
- --- -   - -    -    --  - -      -      -   -     -   -  --   - --  - - - --  -    -  - -  ---  --
--  - -- -   -  -  -  --     -  -     -        -  - -       - - -     --  -   -    -  -    -    -  -
- -- - - -       -    -  - -   - -   - - -   -          --            --   - -  - -  - -           -
-     --     --       -  -  -    --   - - -          -       --        --   -      --- --    -     -
- - -   -       - --   -   -  -    - - -  - -  -  - --  -  -   -  - -                -         --  -
-  -  - -- -  -     --- -  -     -   - ----   ---       -  --    - - -- -- --     -       ---   -  -
-   -  -   --    -          --  -   - - -   - -  -  -- - -   - -  -   ---         --- -            -
- -- --         --  -      -  - - -     -- -  - -  ----   --   - -- --     -  - -   -  -- - - -- - -
- -   -  -    - --    -   - - ---- -    -  -  -  --   -     --  --  - - -  --      ----      - -  --
--   - - -         -  ---           - -   -  -- -  -----  -    -  - - -  --   --           - --    -
--  -   -        --- -  --    - - - -  - - -- -   -- - - -- -    -   -    -     -  -- - -- ---  ----
- - - -      -      - -   - -  - --      -- -  -    -    -        -     -  -  -  -            -   --
- -     - -    -    -   --    - --    --      -          - --     - --   -      -  - --   - -  -   -
--- -    --                 -           -  - -  -      -  -  -  -   -   -    -----            -  ---
-- -          - -- -    -  - ---         --- - -      --      -   -  ---          -- - - --  - --  -
-  - -   -   - -    - -- -        -  -        -  -  -    - -       --   - -  -- -       -     -    -
----------------------------------------------------------------------------------------------------
