100
100
----------------------------------------------------------------------------------------------------
-  - -  -       -  -   -  ---         --                 -  -      - -         - -          -      -
--       -   ---   -   -  --    -  - --  - --      --  -- ---- -   -   --   -   -  -      -   -- - -
-  - -   -  -    -   -   -   - -    -  - -    -  - -- -    - -      ---  --- - -   -             - -
- -  - -     --    - - - -     -- - -   --  -- -           - -      -- -      - -    -   ----- - - -
-   -      -   -  - --     -   --    -   -  -  --  - ---  --    - -     -- -    -   -   --         -
-  - --  -- - - -    -- --  ---  - ---- -  -    --  - -    -      - -           -       - -    - - -
--   --    --      - -  ---          -  --   ---   -   -- - --   -    --- ---    -   - - -         -
-   -       --  -  -        ----- -    -    -    -   -     --        -      -  - -     -    ----   -
---   -        -     -     -   - --  - --      - -  - --  - -                  - -    - - --      --
-   -  - - -     - -  --     -   -- -                -    -   - - - -- -         --  - -     --  - -
- --  --     --- -  -   - -    - - - - - --  -  - -   --  -  --  -    - - --- -           -  -- -  -
-   -    ---         ---  ---      -       -- -   -   -   - --   -            - -         -   - -  -
--    -   - --  - -  -  -   - - -       - -- -  -  -    - --  -  - -   -        -     -      -    --
-  -  -  -    -  -   --    -     -  - -    - --  -    - --  --  --  - -- -  - -   -    - -    -  ---
--  - --   - -    - -  -      -   - -   ----- -      -       -  -          - -  -     -       -    -
-    -  -      -    ---       - - -   -      - - --     - ---  - --  -   -    - - ---  ---       ---
-    - --          - -    ---      -    -  -  --     -- -     --   -  --- -  - -       - - --   - --
-- -- -       -  --    -      - -    -   - - -  - -      -   -   -   -            -     -  -       -
-   - - - --- -     --   -  -  --    -- -      --        -     ---       -----  -  --- -- -    -   -
--  -    -- -    -    --- -- -  -   -   ----   --  -       - -  -  --    - -    - -   - - -        -
- -  -  -    -   -   - -   ---    -    -      - -    -     --  -  -  -        -  -    ---   --  -- -
-   -      -  - -   --       - -----     --   --  -   -    -   -  -   -   -   - --- -         --   -
-- -  - --  --       -  --         ---      - -     - -     - -  -  ----   --  -  - - --       -   -
-  --    -   -  - -     -   -     - - - - - -   - -  --      --  -   -  -    - -     -    - -  -  --
- -  -     --  -   ----  -  -  -    -   -             --  -    -     -     -            -     - - --
- ---   - -  - -    -- -   -    - --       --   -    -- --  ---   ---   - -  -  ---            -   -
- -   --- - -  -- --   -   -- ---- -   -   -    - -- -   -   - ----  -    --- -       - - --   - ---
-       --   -    -            -- -     -  -  - - -   -  -  - -      - --   - --  --- -  - -   -   -
-   -  - - --- - --- -    -    -  -  - ----- --    ---     -     ---  -             -   --- - - -  -
- -  -  - -      -  -  -   - - -- - -    -         -          --      --  - - --   -  -   - -    - -
-       -  -   -   --- - -  --   -    -   -- -  -- --  -   -        ------- - -  --         - -- - -
--  - -   -    - - -  -          - - -    - --   --     -  - - - -  - -        - -   --   - -  - - -
-   -- - - -  ---   -      - -   --- - - -        -  ---  ---  -    -  -  -  -  -        - - -    --
-  - -      --  --    -    -   -   --   - - - - --           -  --  -   -         -- --- - -       -
-   -        -      --   -- -  -  -   - --    - -  -      -    - -        -  -  -  - -  -    -    --
-              -  -    - - -       --    --  --- - -   - -  -    --  - - -- -  -  --  - -- - -  -- -
--    - - - -  - -         -- - - - -- -      -        ---   -- -- -- -    --  --  -  -  - -  -   --
---- - -   -    -  ----   --  --  - -- - -- -- -  -- -    -     -     -   -      --  --  -  --     -
-   -      --  -             -  - -      -    -  - -  - --    -  -  --     ---        --        -  -
- -             ---    -      -  -- -- --- -  -   -   - - -   --      - ----      - -  --- --  - - -
- - --      -             - -- - -               -          -  -     -  -    -     -  ---     ---  -
-      --          -     -     - -     -  - -   - -       --  -  --        --  -   -- -     -    - -
- -   -   - --      --         -  --   --  --    -  -          ---  -     -  -   -     --     - -- -
- -          -- -  -   -  - -       - -       - - -  -   -- ---   - -        -       - - -   -    --
- ---- - -   - -    -  --     - --   - - ---            -      -- -   -- - -   -        -     -  ---
-              -     ---       -  --   -  -   -        -         - -        -     -    - - -       -
-  -            - -   -  ---       -       -  -       -  -    -   -- ---    -           - -     -  -
-     -   --     - -  - -   - -  -- -  -- -    - - --     -  --- -    -- -          -   -- ---  -- -
-- ----       -   - -   - -     -     - - - - -   -- ---    -      -   -     - -     - -- -   --   -
-- -   -         - - -   -   -- -- ---     -  - - --   -  ---  -      -   --        - -  ---    -  -
- --      -        - -  -       -- -  -    -  - - ---    ---       -  -      -      - -     - -  ---
-     --   -   -  -  -  -   - - -     -      -   -   -        --- -  - -       -  - -           -  -
-     -- - -- -  - --  --      -     - -       -   -     ---       - --    -     - -- -  -----   - -
-  -- - -   -- ---   -       --     --       -  -   -  --    --- -  -        - --    -    - - -    -
-- --   -     -  - -  - ----  -  -   --- -- - --  - ---   - -     -  -   -- -     -  -          -  -
---         --  - - -     -  - - -  -      -       ---       -  - --   -    - - --     --  - -  - --
-   - -      --    - - -   - -  ---     -  -   -  -   --   - -       -    - - -      --  -         -
--  -     -  ----   --    -    -     - -     -   -  -- -        --   - -   - -                -  - -
-  -  - -  -- -     -        -  - -   -  - - -  --  -      - - -          -- -- - ----- - -  -- -- -
-   - -     -   -   --    - --- - -  - - -- -   - -   -  - -       -- --     -  -        -   -     -
--     -- -   - --  -- -       -  - -  - - -- --   - -   -  -      -        -  -- -        -   -   -
--- -     - --  - -  - - --  --- -    - -   --   -    - -   -        - -      -           -  -  - --
-      --  -     - --   -       - - --  -      - --   --  - -   - -   --  --- -         -    --  - -
- ------         - --   - -    -    - -    -   - -  -- -    --  -- -    -  -    -  -   - - -   -   -
-        -  --- -    -  -  -  -   --    -  - - ---   - -     -         -  -   -     ----     - -  --
--    -     -     --  -    - --  -      -     -   - -   -  - --- -             --       - -     - --
-       -     --     - -  - -- - -    -  -    - -        ---   -  -             -     - -- - -     -
-     -   - -   - ---   -  -   - --   -      - -  -   -- -  -    --      -  - - - --    -      -   -
-- -    -   ---  -     - -- -- -- -     - - - -         - -- -          -  ----  -- -   -    -- -  -
--  - - - -  - -    -      -      --      -   - --   - --         - - - -  --      -    - -       --
-   -      -    -    -      --  -   -  --  -    --- -  - -- -   -- -  -   -  --   -   -- -     -   -
- -   -- -- -  -   ---        - -    - -     -  -  - -   -   -  -         -   - ----  - --  -      -
---    -  - -      -      - -     --- -    -     --  -      -            -  - -   -  -    - --    --
-  -   --  -  -- -      -- - -   -   -      -- - -   ---- -     --     --       -   -   -    - -  --
-       --     - ----       --   -  -    --       --   -  --           -  --   -    - --   -   - - -
-   - -       - --  -  - --  --     -    - -   --  -  -  - - -  - -    - -     -        -          -
-   --   -  --   - -   - -  -   - ---  - - -- -  -      -   -  -    -     ---  -  -- -       -     -
- -  - -     -   -- -- -      -  - -  -  -  -     -  --  -  - -- -     -  - -    - -     -  -  - - -
-  - --   - -       ---    -    - -     -  -   -- -- -  - --           --- ---  - - - -  -         -
-            -  -      - -     -   --   ------    - ---      -   - -         -  --    -    --      -
-    ---   -- -   -         - - -      - -     -   -               ---     -  -     --          -  -
-        ---  -    -  - --  -  -  - -   -   -      -   -      ---      --    --   -     --  ---    -
-   ----   -     -- - -    -- - -  -   - -   -    --   -            --             -  -    - -     -
--    -   -  -  - -  -      --  -   -  -   - -  -       -- -   --   -  -       - - - --            -
- -    --  - - -- -  -   -   -   -    --       - -        --   -  -- -    -     -   -   -   - -  ---
-   -  - - -    - - - -- -    -    -  -   -    -    -- --     -  - ---    -   -- -    -- ----      -
-      --     -    -     - --    - - --- --     -        -     - - - -  - - -  -    -     --     ---
- -- - -     -- -    -  - -  --     -     - -    -     - - -- -     -      -   - -  -    -         -
-       - ---      - -  -  - ---  -- --  -     - -       -     -  - --- --  -  --   -- - ----- - - -
--   -     - --  - - -    -    -          --      -      -- -    -- ---  --   -   --   --     - - --
-   -  -  -     - -    - -    -   --    --  -        -- - -   --   -      - -- -- --   -   -     - -
-  - --    --     -  -           -   --     -  -  --  --      --   -    - - -  ---- ---     -     --
- -      - -  - -  -    - -      ----- ---  - - --  - -  ---          -    -     -   - - --        -
- ---        -   -           --    - -   -           -   -   -    -   - - -    --   -- --- - --    -
-     --       --  -    ---           -      -       --  -   -       -   -   -   -  -        -     -
- -    -     --      --  - -- --     -  - -       -     - - -- -- - -   -  - ---  - -       - -    -
--    -    -  - -  --  -       -  -  -   --  - ---  - - -        --    --  - - ---    -----  --    -
-            -      --   -   -- --     -   -         -   - - -      -         -      ------  -     -
----------------------------------------------------------------------------------------------------
