100
100
----------------------------------------------------------------------------------------------------
-     - -      -  - -    -- -      -            -     -  -       -       -               -      -- -
-  -   --      - -   - -      --     - -- -  - - -- --       -  -   - --- - -      -   -- --       -
- -  --   -  -  -  -     -   -      -    - -   -    - --        -       - -     -  -   -           -
-  --  -  -   -  -  - -  -      -     - - -   --   -   -      -     -        --  --   -   -  -  - --
- - -   - -  -  -     - -- - --    ---    --      - - -- --      -     - - -  ---  -     - -       -
- -   -   -  - -  - -   -   -   ---    -     --  - - -       - - -- -- - -  - -     -- - -         -
-    -    -       -     -      -  -  -  ---     ---  -      -    - -      -    -   -  -  - -    -  -
- -    --          -  -    ---- - -  -       --  -  -   -    -   -    -        -- - -   - -  -     -
- --                ---  -    -     - -      - -  ----- -  ----            -     -   - -   -   - - -
-   - -    -    -      - -  -  - -    -  -   - -  - - -     -   - -       -     -  --      ---- -  -
-       --  --- - -- ---- --   --  -           - -            -     -    --  - --        --      - -
--         - --                   --  -  - -    -          -      -  -- -         -     --  --  -- -
-    ----      -    - ---  -  -  -   --  -      - -   -  - -   --     - --    - -   -  -  -        -
-  -    -   --    - -    -    -  -  -- -  ---- -  -  -          -                 - - - --  -    - -
---   - -      -  --   - -- --  -   -  -------  -     -- --   - --- -----  -    -  -          --   -
-  -             --  -   -   -    -   ----    --- -  - -   -  --     -  - - ---       -     -  -   -
- - - - -     - -  --     -  -    - -     - --  -   -  - - - -   --   --   -- - -  -   - -     --  -
- -     -  -  - - -  -  - -- -   - - -   -    -  --    -    --   -- - -   -   -  -   -   -   -- -  -
-    -   - -  -     -   - --  -       -  -   -- -    --    - -    -          - -   -   --  -    -- -
--   -     -        -  --  --   -- - -     - -- -       ---- -    -         - -  --         -   -  -
-  -  -  -  -   - -       -- -- -    --- -  -     - -- -  - -     -   - --    -              --   --
- - - - -  -    -  -- - -    --  - -    - -    - -      -   ----   -      --     - -        -      -
- ----       - -   - --           -    -  -   - -   - - -        -  -          -     --            -
-- -   -  -     - -    -   -- --   -    -       - -- -   --  - --  - -     -- -     -- --   --   - -
-  --    -   - -    -- -- --     - - -   --   -  - -   - -  -    - -   ---  -   --                 -
--  - - - --    - - - -  -   - - -     -            -- - - ---  -  -             --   -      - -  --
-  -       --   --     - -  -      ---     - -   --- - -   -  -- -  -- -    -  -   --  -    -- -   -
- -- --   - - --           - - -  -  - -     -     --       -  -     -     -       - -        -  - -
---         - -      -   - - -   -  ---  -        -   -     -  -- -  -    -   - -   - - - -  - -  --
---  --  --  -    - --           -  - -   -  -   -  -- - -       -    -      -    -       -   - -- -
--      -- --   --- --  -  -      - -     --    --   - -   -   - -        - - --        - --  -    -
--  - -   -   -  - -  -      -   -  -  -     ---- --- -  --       -   - - -  -    -- -   --        -
-  -     -  - - -    -      - - --  - -   -      -      -  - --       -  --  -                  -- -
---  ---  --- -   -    -      -   -  - --- -        ---   - -  -- --    -    - --  - -    ----   - -
- -     -  -  -         - -     - -  -  -- -     -             - -   -   -     -- - --    --      --
--  - --     --      -    -- -  -   -  -  -       --    --  -  -  -     - - --  -       ---    -   -
- - -    - -       -  -  -  ---    -- -       -- -     -    -     -  -   --        --      ---   - -
- -  -  -- - ---           -    -- - -  -- --  -  ---         ----  -  --              -   - ---  --
-   - ---   - - -   -     ---   --  - -        -     -    ---  -   - -  ---  - -  -  -   -    - -  -
- -- -    --           -    -   ---  - -   -     -     -        -         --  --       --  -       -
- -   ---    -   - -- -- -    - --  -  - -   - --- -- -   ---  -  -   - - ---   - -   -   --     - -
--      --    --  - --       - - - --  -  -    -         -         -         - - -  -  -     -   - -
- -- -- -         - - -  -  - -     -   -    -  ---- -  - ---- -   - - --   --    - --        - -  -
- -   -    --    -   ---- -- - - ---     - -    --- --  -   --   - - -      -     -- --    --      -
-- -- -    - --    -  -  --   -    ----  -   -  -     --  - -  --          -     -  - - -  - - -- --
-   -    -     -    -   -  --   - -    -  -   -   -   -    - -  --       -   - -- - -       -  -   -
-    - - --      ----  ---- -  - --- -     --    -- --  -  --     - -    --      -             - - -
-        - -        -    -   -       --- -        -  --  -     --   - ---    -  - --  -      - - - -
-      - -- -  ----               --        - -- - - -   -   -- - -    - --    - -- -  -- --     - -
- --   --     -   -     --    - --     - -      -   - -   -   - -   ---         - --  - -- -       -
-      -- --     --    - - -      --  --   - -      --   -  -      -    -      -      -  - -   --  -
--      --    -   - ---  -   --- -  -  --   -        -        ---      -  -- -  -    -  -        - -
-     ----- --  -- -- --          --     ------ -  -      - --     --         -  -   - - -- -- -- --
--  --   - -- --  - -      -   --- - --        -  -  ---          -     -    -  -- -   -   - -   - -
-     --- - -  - -    -       -  - --  --   - - --    -     ----  - -   - -- - -  -  -        -- ---
-  - -   --    --   -  -         -        -   -         - -     -  --      ---   - - -- --- - -    -
-            --  --     -    - - -    -- -   --   -  -     -    - -  --  -  --- --         -      --
-  -   -     - -- --    -  --        - -  --- -         -   -   ---      --- ---  -   -  ---     - -
-   - -       --       -   - - -   - -   -   - - --  --   ----   --   -      -  -  -- -- -    - -- -
- -  -       -     -- -  --     - -   -      -     -  -  -   --   -- -   - -     -- - - --       - -
- -  -    -   ----    --   --      - --     --   -----    --    -      --     - -   -       -      -
-     -        -              - -   --  --      - --     --  -  -   -   -  -   -- -  - -- -  - -   -
--          -   - -   - --    - - -   -   -    -  --  -  -   --    -           -        - -      - -
---- -   --  -     -- --- -       -     -        ----  --  ---  --  -- -  -  -    -- - -   --     --
-    -    -   - - -  -     --         --  --  -    - - --   - -                - -        --     - -
--        - -- -  -  - --  --     --    - - --  -  -   -     -   -- - -   - ---       - -  -  - -  -
- - -      - ---      - -     - -     - -     -  - - -     - -      - -          -  -- -  -        -
- --     - -- -   - --   -   - -   - -  - --    -- - ---    -      -   -- -    --     - - -      - -
-  -  -   -                      -     ---       - --  - -       -   -    -   - -  -      - -  -   -
- -  -    -  -  -  -   -- -  - -  -  -  -  - -    --   -    -     - - --- -  -  -         -       --
- -      -   -    -  -              -  ----- --    -- - - - -       -  - - ----    -  -  -   -  -  -
-- --   -   ---   ---  - -- -- - -   -   -    - - - -   - -  - - - -    --     - -   -   -  --  -- -
-     --           -  -   --  - -  ---   -     ---     -    --       - -    -- -  ---    -         -
--  ----     - - - -- --  - --   - -          -    -- -   -      - -      -     -  --    -  -  -   -
-  - -  -      - -           -- - -  - - - --  -- - -    --     - - -- -  -  -   --  -   -         -
-  -   -     - - --   -- -   -  -- -- -  -      -    - -          -   -     --   -  - --  --       -
-   -   -- -  - - -  - -   -   -- -  - -- --  -  -   -  - --  -        -   -   - ---     -   - -  --
--- -   - -  -- --       --  -- - -   -     ----  -- -       -   --   -            -   -    -   -  -
-       - - --- --  -   -     --- -    --- -   -  - - -  - ---              -- -  - --    - -   -  -
- - --  - - ---  - - -  -  -   -- -    -       -      -- -        - -     -- -   -   -     - -  -- -
-  - - - -- -    -    --     -     -     -    ---- -   -       -    - -  --     -  -   -     -   - -
-   --              --- --     -   --  -  --  -    -   - -  - - -  - - -   - -            -  -  -- -
- -       - ----    - -  - ---  - - -- --     -- -        ---  -   -   -   - - -  - --      - -  - -
--  -  -    - -   - -    --        -    -               - -    -   -  -        - -   -       -  -  -
-   -   -   -     - --  -- - ----   - -      -       -         -    -        -   --   -        -  --
-  - -          -  -   - - - - -      ----      -       -             -- --         -    - -      --
---     - -      --    - -- --         -   - -      -     - -  ---     -  - -    -     -     - --  -
-- -- -  -     --    -       -       --     -    --  -             - -         - -  -    - --   - --
-       ---      -   - -    -  --- -   --   - -       - ---- -- - -  -    - -   -   -- - -   - -   -
--  - -  - - - - -----  - -         -- -  - --  - -      - -       --- --     --     - -  --       -
--  -  -      -     - -   - - - - -  -   ---   -  -   ---    - ---    -   - --   -    - - -  --    -
-     -   -  --   -    -       -  -   - -     -   --   - -          - -   -    -      -   -   - - --
- - - -    - - --    - --       -        --- -- -   -     -    -- - -          - --     --         -
--   - - -      --   --       ----   --- -  -- -     --    --   -   - - -  -       ---  --  -  - - -
- -      - ---- -  - -  -              - -    ---  -        -   - - --       -      - -    -- -- - -
-- -  -- -  - --   --  --  --    -  - --  - --   -    - -      - -      -    -    -- -   -   -- - --
- -  - - -  -    -     -  --        -   --  -  -- - - -  -  - - -  --     -    -  -   -   -     -  -
-   - -   -  -    ----       --       --- -           -  -  - -       -   -    -   -         - - - -
----------------------------------------------------------------------------------------------------
