100
100
----------------------------------------------------------------------------------------------------
-   -  -   -    - -   -  --- -   -- -- -        --   -- --- - --     -  --       -       -  --  -  -
--   -- - -  -  -  - - --     - -     -    -   -   --  -    -     - - - -      --   - -       -  - -
-   -   - ----    - -  --       -    ---  -        -   ---              -      - - -  - -- - ---   -
-  -    --     - -  - -   -      --  --  - - - -   -- -     --   -   -    -   ---     -   -        -
--   - - -   - -     ---       -             ---  --    -  -    -          - -   -      -     --- --
- - - -     --          - --   -  --- -     --   - -      -  -  -  - --   -   --  - - ----- -    - -
-- -    - -   -  --  - - - -- - -      -  - - - - - -  -  -  - -   -   -    -     --    --  ----   -
- - --  -  - - -   -       - - -  -  - - --     -       -  -      -- -  - -- -  --    -   -  - -  --
--      -- --    ---        -         -        -   -  - - -  ----   -     - --    ---      -    -- -
-  -   --      --   --    -   -    --   -        --    - -      -   -    - -    --  -     ---- -  --
-  - -   ---    - --      -- --- -  - -    - -- -   - -- - ----  -    - --- -      --  --          -
-     ---    - --        -      --     -   -  -       -- --    ---      - --    -   -  - -  -    ---
- --    - --  -     --   -  --  - --- -  - - -  -  - -      - -    -   -     --   - ---          - -
- --   -           -  -  -        - -    -  -  --          - --    -   -  -     ---   - - --       -
-     --  -   -  - -   -       - -     -     - - - -   -    -  -   - -     -      -    - -    ---- -
--  -          - - -- - -   -  -   - -  -   --    --  -    -   - - --   -    -  --  --           - -
-    -- -     -  --  --  - - -   --   -  --  - ---  -  -   -   - - - -  -          --  - --    --- -
-     -  -     -        - -- -----  -   -           - - -   -   -     -  --       - -           - --
--   --     --     - -        -   -  - - -  -  --      -   -     -    -     -        -        -- - -
-   -   -- -  --   --      ---- -- - - --   -  -   -   -   ---  --       --  -   -   --         -- -
- -   - --   -- -         --- - -  ---  -       - -  --   -  - -  -         --  -  - - --- -    - --
- -  -- -     -   -   -  -   - - --   -   --  -            -  - -  - --  --  -  -- -    ----  - -  -
-   -  - - - - -    - -   -           --  - --         --    --    - -    - - --   - --  ---  -    -
-- -- -  -  -      -   -    --    -       - -   -      - -          -    -- -    - --  --------   --
-  -  -   ---     -    - -    - -     -    -      -   - -- -- -  -       -    -   -  -  -  -       -
--   -   ---  -        -   - -- -    - - - --  -  -     -      -        ----- - --   - -  - - -    -
- -    --     -  - -  -- -  -  -     -  -    - -   - -    --  -  -   --            -    - - -   - --
-- -  -  -  -- --  -    -      -     -  -   -  - -   -    -   -   -     -  - - -     -             -
-  - -    -- - --   - -    -      -      -   - - -     -   --    -  -   --     --              -   -
-     - -    -    -      -      --- -   -  - -   - -- - -  - -   -      -- -- - -  --      -       -
- -    - -          --- - -       ---   - -- --  -    -  -   - - ----     -  - --       -      - - -
-    -  - - -- - -    -   ---  -   -      - - - -    - -- - - -      --     - -   -   - -   ----   -
--- -    --  - -  - - --     --- ----    --         -   -   -   -- --         -    -  - -- - ---  --
-    - -    - --   - ------  -       ---     -    -                  -- - -   - -          - ----  -
--  --    -     - -      -      -- - --       -    --    -  --           - --        -- - -   -  - -
-    -  -  -  -    - -  -    -      -     --    --           --       -       -  - -    -      -   -
- -     -    -  -- - -  --    -    ----   -      -  --    --     -   - - -----  - -    -  -----  - -
-      -   - --  - - --   - -   --    - - - -  -- - -- -  -  --    -  -       - -  --   --   -     -
-   -   - -     -       - -    -   -        -   -       ---      -        --  -  -   ----     --- --
-      -   -   -     -- -     - -- -      - -    -  --     -- --  -    -    - ---- -       -    -  -
-  --  -     -  - -- -    -   -    -     -  -           - -  ---        -     -  --   -       -   --
- - -   - ---              - -   - ---  -     -    ---  -  -       - - -  -  --         --   ---   -
-   --      - - -       --   -    - - -- - -           -  --  -  ---  -       -  --   -   -   - -- -
- -- -  ---- --   --       -   --   -   - -  -   - - -  -      -    -   --   -  -      - -   - -   -
-- -    --  -  -  --  -      -  -    -      -  -- -      -   -  -  - --  -- - - - - -       -  - - -
-  - ---  -       - -  - --      --         --           - -    -    -    -  - --  -- - -  -  -    -
-       -   - - -   ---    -  -   --         -     -     - - - -        - -- -    -    - --       --
- -    --    --  ---    -        - -  -  - -  --- -         -  -       - -  - -     -- -  ---     --
-  -  -  - --    - -      - -           -  -  --     ----               - - -  -     - -  - -   -  -
-  -    - -- - - - -- -  ----  -    -   -- -         -     -   --    -- -   -  - -- - --      -    -
----   --    - -  --  - -         -   -    -- ---   -  -  - -   - - -       -- -  - --   -      -- -
- -   -- -      - -   -     - - -   -- -  -- -   - -- --   - -  - - - ----    ---     ----  -   -  -
- - -   - - ---  -       -   -- -  -  --  -       -     -  -     -  --  -       -    -       -     -
- -           - -  - - --          -- -      -  --    -- --    - --   -  --  - - --           -    -
-       ----  - - - -       - --       -             --   - -  -          --    -      -  -  -     -
-    -     -  -    -    - -       --  --- -   -          - -  - - -   -      - --  -   -       -   -
-    -  -- --      -   -    - -- ---- -  -   -       ---      - - - -     -    -------             -
-- -    -  --     -   -  --    -  --          -       ---  --     -   -  -   --            -   --  -
-   -  -  - - -     --  - - -       -  -  --   -- --     - --  - -   --       --         - -  -    -
-   -     - - ----     --- -  -   --  -   - --        - - - - --   -       -   -    -  -   -       -
-     -   -         - --  --  ----     --       ---    -  -      - - -      ----    -  - -    --   -
- - ----   - -   - -      - - -    ---     - - --    -  --     --   ---  -  -  -     -     -    -  -
- -           --  -- ---               -          -   -   --  -    - --   -  -  -           -  --- -
-    --   - -   -  -   --   - -- -- --  -   - --  -     - -    -     -    - -      ---    - -   -  -
----    -    --  --  -   -- -   -    - -  -        --- -       -          - -         -  --  -- - --
-    --     - - -    --     -  - --      -  --- - - -  --  --  -  -- -      -  -- --  -            -
-    -      -     ---  - - -  -   -- --  -         -          -  -    - -- ----  - --   -     --   -
-     --            - --        -  - -  -    - --    -   -     -  --   -       -    --    -    - - -
----     -  --            - -    -   -  -         -   ---    -  -  -             - - -   --- --    -
-       -  -  --   -  --   -  - -  - --       ------   -- - -  -  --           - -     -      -   --
-      -  - -   --         - -          -   - ---   -  - -  - - -- --- -    -    -    --   ---   - -
- -  -  -  --  - --- - - ---  - -- - -  -   --   -  - -  -   - -- -        - -     -  -- -  -  -   -
-   - -   -    -- -   -     -        -   - --   -      - -   -  -  -  -        -  - -     - -   ----
-    - --  -  -- -       --  -        -    --  -       - - -  -      -    -- -         - - ---     -
- -- -   -          -  -  -    - --   -       - -   - --      - -- - -   -         --   - -  -   ---
-      -  -         ---           --  - ---    -- --   - -  -  ---     -- -- -       -  --     -  --
- - -    - - -     -  -- --  -   -  --        -  -       --  - -   -  --            ---  --     -  -
-  - - -     -          -- - -  - ---  --  -       - - -           -    - -  -  -          -     - -
- -   - -  --     -      -      -   --    - -           -  - - -    -- - -    -   -- --  ---   - ---
-   -          - -- --   - -          --          -  -- --  - - -      --  -    -   -              -
--    -     -     -     - -    -  ----- -  -  - - --- - -      --     -   - - -   -    -  ----    --
--   -- -     - - --      - - - -     -  - -- -     - -   - -    - - - --  - -      -  - -       - -
-   -     -    -   -- -      --  --   -     -     - -       --  -  - -   -   -       -- -    --    -
---         -   --   -- -         -         -  -  --  -   - --   --                 --  -     --  --
--   -- - - - -   -    -    --  - - - -   -    - - - -     -  -      - - -   -   --      -        --
-         -- - -- -----  - -   -- -   -    -     - ---  -      -       - -    --   -   - -    --   -
-  -  -    - -       --   - -       -          - --- - -- -   - --   -  -----   -  -   -  -        -
-   -      -         - -   - - - ----- -       -  -   -            --     -        -  -  -    -- ---
- -  - --  --  -               -- -  -   ---  --  -- -   - -  -  -                    - --  - - - --
-   -   - -   --  - --- - - - -    -- -     --   - --- - ---  --   - - ----     -  --      -      --
-  -  -   ---- ---   -        -- --     --    -  --  -      - -   -      - - -      -  -- -  ---   -
-   - ---    - -   --   -           -       -    - - -   -- -   -  -   -- --    - --   -     -   - -
--   -- - -   - --    -   --  --- -          - --       - - -  -  -  - - -     -  ---          -   -
-     -- --        -    -- -    -      - -   -   ---  -   --   --- - -    --    --   - - --   -    -
-  -            ---      -   - -             - -  -    -     -      -   -  -- -   -     - --     ---
-   ---- --    - - -  -  --    - - ---    -   -      ---  --  ---    - -  -    - -   -  - --- - -- -
--  -      -     ---                     - -  -   --   -    - - -  --      -   -  --  -       -    -
-  -   -- -  -- -           - ----    - -        -  - --     - --   -   - -- -   -  -   -          -
----------------------------------------------------------------------------------------------------
