100
100
----------------------------------------------------------------------------------------------------
-       -         -     - --  --    -             -   -          -- -   -      - - -  -     -      -
--       -  -- --    - -  --      - -   --    -         -   -     - - --  --  -          -- -  --  -
- -   ---   --            ---- - -      -    -- - --          - --     - -     ----- - -    - -  - -
- -  -      -  - -- -  -        -  --  -   --      -- - -       --  --  -  - --    - -    -  -    --
-  -          - -      -  -- -    -       -   - -   -          -   -   --      -     -  -  -- --   -
- -       - - -    --            --        - -    --     --    --   -      -      -  -   -   - - - -
- -    -   --   - - -    - -  - -  - ---   -     - --    - - -     -   -  -  -  -- -   -      -    -
- -    - -   - -       -    - - -       - - -- - - -   -    -   -     - - --  ---  -  -- --  ----  -
--  - --    - - ---    - --    -  -- - - --      -  -- -  - -             --     - -- -    - -     -
-  -    - ---  -    --   -     --    --         -  -    - -  -     --   -     - --  -     -- -    --
-    - -     --   -- -- -   -   ----   --   - - --    --  --- -      --    - -  - -     --   - -   -
-  -- -               ---   -        -   -    -    -- - --   -      -   -  -  -- -   --- -     - - -
-   - ---     -   ---          -      - -   -  -  --             --  -- - -     - --  -      -  - --
- -  -    --       -    --  -   -     -  --      -   - -             -    -    - ---    -    -    --
-    - --          -   - - --- -   - -    -       - -  --- -   - -- - ---      -        -          -
----       - - --  --        - - -- - - -   -  - ---      -       - - -     -   ---     -  -- --   -
- --     -      ---   -  -  --   -   -   -   --    -  - -   -  -    - --  - -- -        - -  -     -
-     - --    --   --   ---       -  - - -    -   - -  -  -  -  -- -  ---   - -- ----       -  - - -
-- - -           --   -- -    -    -     - -       -   -   -  - -      -  -   -- -  - - --  -      -
-   - - -         -   - -      -    - - --    - -      - -   -- --  -        --- --  -  -   - ---  -
-     -    - -   -- -          --  --     -  -      -   -   -  - -    -  ----  - - --- -    -      -
-  -        - -        -- -  -  ---- - --  ---   -      -- - -- -       -       - -    - - -   -   -
-- -- -  - -   --  -     -   - -    -   -          ----  --  -    - - -   ---   -    - -   -  -  - -
-      --    -          -        -    -- - - -- --  -        -- -   -   -  -- -   -    - -   -     -
-    -    -    -  - -  - -  - -  -- -   -     -- --  - -   - - -     - --  --  -  -    --   -    - -
- -      -   - -  -   -   -  -  -- - -     -- -    -- -      - --- - -  --       - -   - --- --- - -
- -    -     - - --  --   - -     -  -        -  - -              -        -      -             -  -
-        -   -- --    ---   - - - -         -    - -    -                -   -- --     -   -- ---  -
- --    - --       -     -  -   -   -  -- -  -            -  - -- -  -- --  - -  - ----     -   -- -
-   - -      --       -   -   - - -    - - - -   -- -- -   -     -   -  -  -     --    -      -    -
-   -  -     - - --   - - - -   -  - -       -    -  -      - - - --    --   -- - --  - - - --   ---
----    -   - ---  - -       - ---  -  -   - -- -      -    -  - --   - -  --  -    - -  -    -  - -
-   -    --    -  -         -    -    - -        - - -        -        -    -  -             - -  --
- --    -   -   -  -  - ------ -     -- -    -   -  -- -     - -- --- - - -- -    --  -- -      -  -
-   -     --  -       --      -        -      -   -   - - -  -   -       -  -----   -  --     -   --
-   - --    - - -    --          -   -   - - - - - -    - -   -     -- -  -   - -  ---   ---  - -- -
-  - -  --  - --      -   -                -   - -              -  -  - --   -     -  - - --      --
- -    -         -  -     - -     --       ---   - - - -  -  -        -- ----- -    - -    -    -  -
--  -   -        -  -   --   -  -   - - -      -        -  -- - -    -   -     - - -    - -- ---   -
-  -        -  - - -  --   --    - -- - - - - --  --   - -   - -     -     -           --       -- -
- - - - -   -      -  -- -- -   -     -  -  - - --       -      --- -  -   - -  -   -    -- - -  - -
--          -   -     - -     - -   -         - -  -     ---   -          -- --- -     -  -      - -
- - --    - --             -  - -   --   - --     -    -       -     -         -  -  - --          -
-     - - -  -    - --   -         - -   - -  -     -  --   -     -  -- -   - -  -     - -    -- - -
- - -     - -- -- -- - ---        - -  -  --  -   -    -   -  - -  -    - -    - - -   --   -  --  -
-  - -  --     -   -   -     -         --    - -     - ---  --  -   --  - - -                -  -  -
--  -     - - -    --           -       --  -   -        -            - - - -       - --           -
-     - - -- - --      -      -         - - ---  -   -    - -  -     ---   - - --    --  -  -      -
- -    -   - --      --    - --        --       -     --     -  -  ---       - - -       -      -  -
--     - -   --  - - - -   --   --   - - --- -  -    -  - --            - -     -   -   -    --    -
-  --           --     -       -- -     ---   - - -    -  - --  -- -   -- --  -   --   -           -
---   - -  -   - -    -    - --  - - --    -   -    - -  -    -- --          ---- -    - -   --- - -
-   -   -    -   -   - -  -- ---   ---     - -   -  -   ---     - -   -  -    --      - -          -
---   - - ----       - - --    - -     - -  -- - - -  -    -      --    -   --      -  -- - -  - - -
- - -         - --   --- -  --    - ----- -  -- -    -     - - -     - -      -   -   - -  -       -
- -   -  ----       - -    -   --- --  - -  -     -   - --- -   - --  -  ---    -    -- -   -  -   -
-  - -   -   - -- --    - -    - -      --     - - - -    - - -  ---    - - - -  -    -  --   - -  -
-    -  -    --  - -   -   - --    ---  ---    - - -  - -  - -  - -----    -  -   ------     -     -
-       --   -   - ---    -   -  - -     -      - - -    -    -              - --- -  --    - ---  -
-----    -- -   -  --    - --   -    - --      -  -   -  - --- --   - - -    - -         -  - --   -
- - - -   --          - - -    -- -  -- - --   -    -    - -   - -    -   -          -      - -  ---
- - - -  -- -  -        - -  -    -   - -   - -   -  --     --   -         - --  - -               -
-  -   -  - -  -  -   - -     -  --     -  -    -             - -   - -          - --       -- -  --
- -        -    --   -    -  -- -  - -   -      - - ---- -      -     -- - -   -     - ---         -
--   -   - --    - - ----   --- -  -  -- -   --      -    -     -- -------  -  - - --  ---   - -   -
- -  --    -  --   -    -- -       -         -- -- -   -  -     -             -  --  -- -       -  -
-     --   -     ---  - ---   -        -   -   --   -- ---      - --  -----     -   -  - -   -  - --
-    -  - -  ---       -   -    -   -- -     - - --   - -      -    -    -   ---      - -- --   -- -
-     ----  - - - ---     -        - -          -   -  -  -      -  -  -- -  -   - -     --     -  -
-  --     -  -  - -  -    -  -  -  -    -            --  -- - -         --   - -   -   -   - -  - --
-  -  -- --    -    - -   ---       -      -  --- -  -   -  -        --- - -     -    -- --        -
-        -    ---     - --    -   -     --- -  -   --    - -  -  -    -  -      -       -- -    -  -
- --       -       -- -     - -     -           -   - -        -       - -      --  -       -      -
--    -      -  --  -      -  -  --   -- -  - -- -   -  -  - -  - - - -   --      -      -    --   -
- --- -  -  -  -         -        - -    -  -  ---   --  -   --               -- - -     - - -     -
-  ---     -  -  - - -          -       -    --     - ---    - --  -   -   - - -     - -         - -
-     -  - - -       - -- -  --      -  -  -   ---  -  -- -     --                - -   --  - -- - -
--        - -  -- -  -   - -- -  ----       -   -    --      - --        - - -                   - -
--     --  --         -   -    -     -          - -    -    -  - -  -    - - --     -   -   -      -
-   -        -     -    -       --   - -   --- -     ---       - - -    -  --            -     -   -
- - -  --- -     - --     - - -   - -  --    - --     - - - -- - -     - --    -  -  -       -     -
-   -       - -   --  -        --    - -     -       - -  -  - - --     --   ---      - -         --
-     -   ---     -     - -   -   -- -  -  --- - - - --      -    --- -   - -  - -  --    -   -  - -
- ---   --  -   -   - --  ---   --       --    -       - - -    --       -   -   -  - - -          -
-    - -  -- -  - -  -- ---      --    - -  -       -  -      -  - -- - --   - -    - -    ---  -  -
-   -         -   -- - -   ---  -    -       - -     - ---  -  -    - --   - --        --         --
- -  -    -   - - - --     --- --- - -  -- - - --                - -  -      -    - - - -- - --  - -
-  -  -   -- - - --   -  --  -  -  -   - - - -   - --   - - -- - --    -- -  - - - -  -  -     --  -
-   -      -- -  - - -     -    -  -  - -  -- -    - ---   -  - -        -  --     --    - -    -- -
- -  - -               -   -  -- - -   -  - - - --      -  --- --    -           -- -   - - -  -   -
-----      - --     -- - - - ---   -- -  -   ---  --  - - -   - -  - - -- -  -   - --      -  -- - -
- -  - -  -     - -    -   -    --  --    - - - -  ---  -     - -   --        - --   - -  -  -  -- -
-      - -     -   -- -  -  - -  ---    -   -    - --  -- - -            ---- - - - -  --- -  -    -
-     -- -  -    -   --    -  - -    -  -- - -   ---  - -     -   -  --  - -       -     - ---  -  -
-        --      ----  -  -  -- - - -- - - --             --   -  -     -   - - - --  - ---  -  -  -
--- -- - -           -  -          -    - -       -  - - - - --        - -         ---         -- --
- -    -  -  - -- -    - -   - - -- -    --  -     ---  -  -       -   -  -    -- -   -       --   -
-   -    -      -    -  -  --       -  -  -    -- -    -      -  -       --    -        --         -
----------------------------------------------------------------------------------------------------
