100
100
----------------------------------------------------------------------------------------------------
-      ---        -        - -      -  ---   - -- -         ---    -   -    -   -     -    - - -   -
- - -   - -  - --    ---  -    - -   --  -    -  - -    -- -   - --    -  -  -          -  - - - - -
-  -  --        ---     ---  -  -  -      -    - --   -    ----   - - -     -    -  -  -   -  --  --
-   --   --         --    --      -  - --    -  - -    - -  -    ----   --- -     -    -     - -   -
- -           -  -   -  -     -  --  -     -  -        --           -         -   -    -      - ----
-   -  - -     -  -      -     --- -    -  -  --       -  -  - ----  -  --   -  -   - -     -  --  -
-   --  - -  -  - - - -  -  -     -    -  - -  - -   -     --  - -  -      --   - - -    -   --    -
-     -  - -  ----      - ---    - -    - -  - -        -        -  - -  --- - ----- -   -  -  -- --
- --  -  - -           - -          - -    - -   --        - --  --   -- - -    -   -  -  -  - - - -
-   -   -  -   - -   -- --    -- - --- - -     -       -- - -  - -  -   - -  - - -      -    --  ---
----  --       -   -       --           - -            -  - - --  - -  -       -       -  -    -   -
-  -   --        -  --    -  -    - --  - - - -    ---  -  -   --  -  - -- -  - -       --- ---    -
---       - - - - -   -      -  - -  -  - -  -          -    -  - -     -- -  -    - -           - -
-  -   --    -    -   - - -        -           --    -     - -  - -   -  - --   - -  --- -  -    - -
-    ---     -    --      -   - --     -   --      -      -   -- - -    ----  -    -- -  -    - -  -
- - - -- --     --    --   - -   - -  - - - - -  -- -     -- -        --     -- -  - - ---  -    - -
--   - -   - -    -- - - -  -  -     -  -  - -          - - -   - - ---   --  -   --       -   -- --
-         -   ----    - --  -  -     - -  - -    -     - -  -   - -   --    --  -   -  -- - ---  - -
--  -  -- --- -  - ---       -  -  -   - - -   -  -  --    --   --   --   - -- -  - -- --          -
-   -  - -   -          --    -    -   --  - --     -  -  - --        - -  --   -  -   -- --    -- -
-   - --   -  -  -  - -       --      -  - -              -   - -  - ---      ----    -    - -    --
-  --  - -  - - -   - -    -  - -    -        - -    --     -  -    --  -       -  --  -- - ---    -
- --  - - - ---- - -          -    --- - -  --  ----    -      ---    --   --      - -  - -  -   ---
-   -   -  -           --         -- - - -   -  -   --      - - - ---- - -  -- --        -    --  --
- -    -    --- ---- -    -     - -  - -         ---        -    -- -   -      -  --   -      -  - -
- - ----   -   -   -    -  -   -  --   -  - -   - -   -   -  ---  --     --        - -  -     - -  -
--     -   -  -   - --      -  -  -  --  -        --- --      --  -   -    -   -  - -  -  ---  - - -
--- --- -   -  -          -     - -    -   -  --     -   -   --               --  - -    --     -- -
-    - - --    - - -     - -     -    -    ---    - -- -    --      -  - - --    -   - -    -      -
--     -   --  -- -   -       -     -  ----   ---   -    ----        -  ---          - -     - - - -
-     -        -        - -          - - -  -    - -     -  -     -  --            -   -    - - -  -
-   -    --   ---   - -    -      -       -   -- --  -- -  -   --  --  - -  - -     -   -    -   - -
-         -   - --       --  -    - -  --   -   - - -  -   - - -- -    - - -   -     --  -         -
-      --    -   - -        -        -       ---                   -   -      -     -- --  - -   - -
- -  - -     --- - -    --  -  -   -       -    - ---     -  --  --       - -  -----  -- - -- --   -
-  -   - - - -- - -    -  -    - --  -  -- -    -    -   -      --     -    ---     -  - --  -  - --
--  --- --       - -     ---  -   -    - -  -          - -       - - - -    -     -- -  ---- - -  --
--   -     -       -     - - - --  --              - - -    -   -   -  ---    --   - -       -   - -
-            --  ---   -   - -  -  -    --  --        -  -- -  -           - -  -    - ---     --  -
- -  -- --    ---   -  -   -  - -    --    --   - -  -     -  - - - -        --      -    -     -  -
- - -- -   --   -  - -      -   --     -    --  - - ---- -  -     -   --  --   -      --  -    -  --
- -          - -   -  -- -- -   - - -  - -       -       - ---             --  -  ---  -- ---   -  -
- --        --   -  -  -   -  -     - - -  ---    --  -   -         -   -    -       -- -     -  - -
-  -      -    -  - -   -        --     -  - -   -     - - - - -     - --   -- -  -  -- --- ---    -
-  -  -    -       -    -  -  - - -     -    -    -   -  -  -  -- -  -- - - -     -                -
- -     ---   -   -     --- -     -    -      -     - -         -    -   -  - -    -  -- ----  - - -
-  -  - -   --             -    - ----   - - -     -   - --     - --     -   --- -   -             -
-   -      -      -  -  -  -   -   --        - -  -     -    -  - - -- -- -      -    - -- -       -
- -  - -        - -    -       - - - -  -   --   - - - - --    -  -     -  --  -   ---          -  -
- -  -  - -  --     -    ---    -  - - -  --- - -            - -      - - -   -   ------    --  -  -
- - -     --  --- - -- -   - -   -     -         --   -  -      - -     --  -  -       - ---    - --
-    -   --   -     -   -   -  -   - --  --  -- -       -   -     -  ---          -  -  -- --  --  -
-       -   -   - -      -    -  -- -      -      -   --    --   -    - --   ---      -  --      - -
- -        - - --  -                 -  --  --- ---- - -       ---- -   -   -  -   --  - - --  -  --
-   -- --  -  - -     -     -     -       -    -     -  - - -    -   -   --- - -     -  - --  -    -
-  -  -   -   -    - -            -  -     - ----- --  - -  -  -  -      -- -    -   -  - -     -- -
- --   - -    -  -      -  --   -   -   - - -  --   - - -      - - -  --- -     - - -     -  -    --
- -    -- -- -   --  - - -    -  - -      - - -   -   -    -- -  -     - --   - - - -- - -     -   -
---  -   -- -- -       -    --   -  - - - -  -  -   -- - -   ---  --    -    -  -   --          -  -
-       - -      -   - -      -   - -    - - --         -----  --  - --    -    -        -    ---- -
-- -   - -    -- -  -      - --  - --  -       --   -         - -      - - ---   -  - -    - - - - -
-     - -    -- -     --     -  -          - --   -       - -              -  --  ---  -   -- --   -
-       - --  - -  -           - -- --          -      - -     - --     ---       -     -  - -   - -
-   --     -  - -- -   -  -- --        -- ----   -- --    -         - -- -   -  --- ---   -     - --
- --         - -  --       - -        -    -- - -- -      -  -      -    - - -  - -   --   -  --   -
-   -     --   --  -  --   -             -    -     -- -  -      -  - --   - -   -- --       - -  --
-     ---    -        -   -              -  -     - -    - --   -   -     -  -  -      -   ----   --
-   - --    - -   ---    -    -    --    -   -   --   -          - -  - --      ---   - - -    --  -
-   - -      -  - -- -    -          - -    -  -  --    ---       -   --  -      -      - - --  -  -
-      ----  -         -       -     -    -- -  - -  --  -  -  -  -    ---    ---   --- ---  - -   -
- --   -   --- -     - -  -  -  -      -       -  --     - -  -   -    - -- --  -  -     -     -- --
- -  - -- -   -           -        -   - - -- -       -  -  -        -  - -   -    - -- -   --  -- -
-    -   -  -- -   - ----      -- - -   -    -   -   -  - ---      -        - - --     -    -  -   -
-   -   -    -- -  -          -     -   - -     -    -    -    --       ---       - - -  -  -  --  -
-   - --   -   -    - - -  --- -  -   -- --    -    ----    -  -   --  -      -       --- -    -- --
-   -  -  -  -  - -   --  -  - -     - --   -    --       -           - - - - -    -      -   --   -
-  -  - -     -      -          -     -     -  --  - -  -   - -  -       - - -   -   -          -  -
-   - - -    - ---  - - - --   -       -   - -     -      -         -  - -  -  -        -  - -------
- -   - -  -  -   --         -  - - - - -  -   - - - -- -- -     - -  -  -  -    -   - - -  -   -  -
-  -  -   --  ---     - ---  ---  -   -    -   -      - -- - -- -- -     -  -  -   --  -   ----    -
-  --  - -- - -    -          -   -  -  -             --- - -      - -     -  -  -   --   -- -     -
-    -    -  --  -    -- - - -    -       ----  -   -         -  - --     - -  --   - ----   -     -
-  --   - -         -  -      -  -   -        - -   -  - - -      -  -  - -  - -  -  -   --- -  -  -
-       --      - -- -         -      - ---   -   - -   -  -- - -  -         -   - ----        - - -
-   -  -     -     -        -   -   -       -   - -        -    - - -  ---  - --      - - -- -  -  -
-   -  -    --  - -   - - -       - - -  - -     - --  - -  -      - -     --     --   - -         -
- -     --   -   -  - - -  --         -   -      -- -  - -          -  - - - -- - --  -       - -  -
-     - -      -  -   - ---- --  - - -    ----  -     -  -   -- -     - -    -  --     -- -     -  -
-    -- -  -  - - ---- -       - -      -      - -      ---       - --    ---  -  ---     --   -   -
-  -- - --  -   --                      --    - - --  -       - - -          -  -  -    -- -      --
- -   - -   -    -  ---    -  - - --         -          --    --  -- -  - -  -    -  -  - - - --   -
- -   --  -    -             - -- -     -       - - -  --   -      -  - -      -      -    - -     -
- -  - --- - -   --     --- -  -     - -  - -      - -  - -   --  ---    -- - -     --      --  -  -
--  - -   -  - - -    -       -  -   -     -   -      --  -  - - - -  -     -    -    -  --   -    -
-  - -  --- - -  -- --    - -       -     - - -  -  -- -  - - -  -  --  -   -   ---  -    ---  -   -
----    -  -      - -                   - -  -  -- -    -  -  -- - -   - -      -    -  -  -  -    -
--  --    ---  -  -   -- -  -   - - - - -- ---      -  -   -   - -   - - -   -      -   -   -  --  -
-            -  - -   - -      -  -     -     --   -    -        -  -     -   -  -  - -  - - -  -  -
----------------------------------------------------------------------------------------------------
