100
100
----------------------------------------------------------------------------------------------------
- -            -        -          -        - --   --      - -               -      - -         -  -
-    -    --  - -  -         -      -----  - -   -  ---  ---  - -   ----  - -   ---  -      ---  - -
-- --         --        - -  -   -      - -  --  -      -      - --    -      --  -   -  - -   -   -
- -        -   --    -   -      - --         -  --   - -  - -  - -   -      -   --- - -- -  -  -   -
-  -  - -  -        --- -     -      --  -  -        - -  --  - ---     ---- --      --    -  - - --
-  - ---    - -         --    -      - -- -   --  -   -  -  --         -     -  -----              -
- -     -   -        -  -  -- -       - -- -- - -    -   - -  -  --   -    -      -   -- -    -  - -
-    -  -             - -   -  --  -- -  - - -  - - ---  -  --         -- -   - -      - - -      --
- - -      - --  -        - -     -  --     -- -  -  - -    --  -  - -    - -  -  -  -      - -    -
-  --- ---  -        -   - --   --  -  - -  ------   -       -  ---  -     - -   - -    --- -    - -
-   --   - -  -  - --        -     - --    -   -  -  --   -- -    ----   - -     -  -   -  --    ---
-      -       -      -   -  -          --   -    - -        - --     -    -  -      -   - -       -
- - - - -  -  -    -   --   ------  -     --  --           -  -   - --   -   - -  - -         --   -
- --  - - -  -    -   -     -     --     -       --  -         --    -  --- -        -- --    --   -
-            -- - ---     -- ---        -   - -       - -- -  -   --       -   -  --   --  - -     -
-   -   -       -   - -    -    - -  ---         -  -    --  -  -         ---  - - -- -   -   -- ---
- - -  -        - -- - - -     -     -   -        -  - - -       - - -   --  --- --     - - -      -
-     -            ---- - --       --  - - -    - -         - -- -         --    - -    - -   - -- -
- -      ---   --    -    - -        -  -- - - - - - -  - -  - - -       -- -  -    - --   -- -    -
- --   -         --       -  -  -  -   -           -    --     -      -           -     - - -      -
-     ---    -   -  --- -    - --    --      --         --  -   -    - --  -   -  --  - -   -- -   -
- -    -        -        -   - -  - -   - -   - -          - -     --        --- -  -    -    - -  -
-- --- -    -  --    -  -  -        -    -- -    -     -  -  -   --    -----       -  - -  --   -  -
-- -- - -  -     -  ---    --  -   -- -- -- -    - -    - -  --     - -      --   -  - --   -   -  -
-- -  - -- -  -- --              -      -         -  - -- --- -- -    - -   - -  - - - - -  ---  - -
-       -   -   -   --  - -  - - ------- --    -  -    -        - --  -       --- -  -  -       -  -
-  -- -      -  -  -   -    -            - -             - - -   - -  - -    -- -      -   -  -    -
--    - --   -  - -     - -      - -  -   - -- ---     -  - - -  -     -      -   ---        -     -
- --   -        -  -   -    --- -  -     -    -  -  -- --    - -    -                    ---    -- -
-     ----  --  -     -     - -- -    -   - --   -    -  -     - - -  -     -    -  -      -    -- -
- - - --      -- -  -   -   - - -- -    -        --    -   ---- - --  --       -    -- -    -  -   -
-      -   -       ---   --- -     -   -   --   -  -   -  - -   -     - -  - - -           --  --  -
- -- --  - --     -   -    - - --        - -   - --- -    - -     - -  --      - -    - --  ---  - -
-  -  --  - --    -   - - - - -    -   -  --- -   -  - --          - -- -     - -  -  --  - -   - --
-  -- -  -    -    --  -  - -- --- - -  -    - --  -   - -   -  -      -  -    - -   -- -  -   -   -
-  -  -    - -  -     -   -        --    ---  -      ----   -    -   -    -- -- -   -    --- -   - -
-   --      -  -   -      - -         -  - -    - -    -- -  - - -  - -     - -   -   - -   --  - --
--       - ---- - -- --   - - --    --  --  - --- --          --  - -  --     -- -    - - --   -- --
-     ---  -  -       -    -    -     -           -    - -   -- -   --  --- - -  - --  -     -  -- -
- - - -  -        -      --   --  --  -  - -   -     ---    -  -       --  --    -   --    -      --
-        -    -- --   -     -       -     --     --    -  - ---    ---   -          -  --   -   - --
-  - - -  --    - ---   - --  -     - ---  - - - --         -    -    -     -  - --- --- -  -- -  --
-  -  -- -    - - -  -  - -  -  - --   -   -      -      - - -              -  -- - -   -- - - --- -
-   - -   - -    - -- -   --  -    -- -----  - --      - ---  -  --  - - -            -  - -       -
--      --  -    --   -        - --   --   --   -       -- -   -    -   -   -- -      ---    - -   -
-- -   -  - -- -     - --    -    -   -  - -    ---     -        -    -             - - --  --    --
-  - - - --- -- -     -  -     --   -      -        -     -- -   - --  --      -   -        -  -   -
-      -     - -       -      - -     -    -   ---    - - -   ---  -   -       --    -         -   -
--   -      -- -  -     -    --   -   - -     - -      -   ---   - -  -  --  -      -   -      --  -
-     -   --  -  -        -  - - - --    -        -               -   -   ----        -          - -
- --           ---       -  -  --   -   -   ---           ---- - -    -   -  - ---    -   - -      -
-      - -        - --  -  --     --          - --  -- -  -       - --      - -     - - -  -  --   -
-          -   - -        -     -- - -  ---  -  -----  -- -  -   -     ---- -   --   -   -   -    --
- -        - - --    -      - -   -     ----- ---             -     --    -  -  -   - ----   -  - --
-    -  -  -     --  -   -  -- -    - -     -     - - -    --  --  --   -  - - ---       - -- - - --
- --    -    - --  --  - - -        - --        -  - - -             -  - - -    -  ----    - --   -
- -- - -- - -     - --- -    -  - -      -      - - -  - -    -  - -          --     -  -  -    -- -
-        --- - - ---   -      --    ----  -  ---  -    -   --  - --  -  -    -   -  -   -    ---   -
-   -        -        - -  - --  -      -  - -  - --      -      - -       -   - -  -       --- - --
--     ----- - ---   -- --       --      -           -   -        ----  ----   -- -- - -        -  -
-  -  -- -   --   - - - -     -  -  - --          -   -   --   -             -      -    --  --    -
---    --      - -  -     -       -      -   -    --       -     - -   -   - -       -  -   -      -
-- --   -        - - - -    -   -- - -       -- --       -   - --  - -  -    -     -- -       -    -
-       - - -  ---     - - -   - -    - -  -   -  -              -       ---- -  -  -         -    -
- - -- -   -      - - --     -    - -            ----  --  --    -- --  -- - -  --   --  - -  -  - -
--   --  -   --   - ---- -     - -- - - --   ---       -   -     -         -      -   --   ---    --
-  -  -   -  - -  -  -    - - -   - ---   -- -   -- -- -     -  -  - -       --  -   - --      --  -
--  --  - -  -        ---     -      - --       - -  - - --    -  -   -  - -      -- -    -  - - - -
-     -  -    - -          -  -  - --   - - - -   --  - -  --  - - --        - -    --   -  -    ---
- - ---    -          -  - -     --   -  -  -   -        - -       -   -   -   - -            -  - -
-              -    -- --      --  -      - - - -   - --    --  - - - - -- -- - --      - --     - -
- --   - -   -  -   - --   -  -   --   -- -     --         -              -    -  -    -     -  - --
--  -    -- --   - -     -      -    -  -   -      ---   - -   - --  -- -    -         --       -  -
- -    -       -  -- -  --- -   ---   ---    -   -  -     --  -          -  --  - - -- - -    -- - -
-     - --- - - -        -- -             -  - - -      -- -   -    -      - -- -   --  - -        -
-- - --  -   -    -        -  --   -------    -  -  - -  -     -    -  - - -- - -          - - - - -
-  -- --  -           - - -  -    - -           -   - - -    -      -      -     --   ---      - ---
-       -    - --     - --   ---     --       - - - -- --  --  -- ---         - -   -    -      -  -
- -         -   -   --    -        -  -              -- - -   -    -      -- -    --   -    --  - --
-  ----     - - -- -  -     - --    -  - -   - -  - -- - - - -  - --      --    - - -      -   - - -
-        -             -  -     - -       -    -       -  - - -- - -    -     -    --- --- -    -  -
-  -  --    -  -    -       - -     - - -  -    -   --    -  - -  -   -       -- -    - -     -    -
---       -  --       -  ---- - - - -      - --    -       - -          -             -- -    - -  -
-- -   ----- -  - ---   -       - - -  - -  -  - -    -  -- - - -  -  -  -     -  -     -  - -   - -
-  - -      -  -           --   - -    --   - -- - - - --     - -   -  --     -- - -  -  -   - --  -
--   - ---      -     -    -- - -           - -        -    --   - - -  ---  -- -    -     -     - -
--  -  -           -   - - - - -  ---- - -      ---   -     --      - -         --- -  - - -     - -
- -  -   -  -     - -   -  - -  - --    - -  - -    -     -     -  -- --   --  -          - -    - -
- - --  -  -- -   --  ---      -      ---    -         - -- -  -  -  -   -  -   - -  -- -      --- -
-       ---   ---          --- -  -       --- -- -   -     -   ---  -  -   - - -       - --  - - - -
- - --      - --  -   --             -       - -          --- - -     -  -   - -   --  ----  - -   -
-- -    -- -         -      ---      --   - --   -       - -      - --  -  - -    -- - -  -    -   -
- -   ----  - ---- - ---   - -   - --  - -  -   - -  --      --    -  -   --- -  -  -     -        -
-          -       -   -- -      -    --     -       -   -   -- ---     ---   -   --   -    --   - -
- -  -  -   -   -        - -- - -    -  -----  -- --      -          -  - -   -  -- -    - -       -
- - - -  -   -- -   -     -       -  -   --     - -  -   --  --       -  -     - -    - - -    -  --
-          -    --  -  -  -   -  - -  -   -- ---           - -    --    -- - - -- - - --- - -  -   -
-   -           -    -  - - -   -- -- - - -        -   -   -   ---       -    -  -  -  --     -    -
----------------------------------------------------------------------------------------------------
