100
100
----------------------------------------------------------------------------------------------------
-   -   -      -  -  -- -       ---  - ---  -      -    -         -      -       -     -           -
----    -   - -      -- -          --  ----   - --- - -   --   -   --        -- - ---      --   -  -
-  - - -  -          -     -     - -    ---  -     -  -- -  - -      -   --    -- -            -  --
--   -  -- - -       --      -  - - --   - -  ----- --   -              -- ----- - --   -    --  ---
-  -  -              ---       -     --     --  -- -  -     - - -         --     -- -           -  -
-    -      - - - -     -    -- - ---  - - --         - --  -  --         --   - --  -- -- -    -  -
----    -          -  - --  - -  - -   - -        ---  -  - -    -- --     -     -   -  -  --      -
-      - -     -   -   -   -   - -       -   -  ---  - - -      - --   - ---  - -    -   -  -   -  -
---    --    -  ---  -  - --   -- - -      ---- -  -  -   -     -    - -    -      -- -   -- - - - -
-         -- - -   - - --  -    - -      ---   -      - -- -     - --   - -      --  --        - - -
- -   --   --   ---        - -   --      - --        -    -   -  - - -    - - - - ---   -  - -     -
-   -   ---   ---   - ---       -- -  -     -  - -- -- -    -- - --           -  -    ---          -
-      -  -    - -  -      - -      --- --- -- -            - - ---     -  -   -- - -- -     -  -- -
- -- -     -     ---  --     --   -             -  -  -     -       -   -     -  -  -    - -  --   -
-  -   ---  - -      -   -    -  -   -        -  - --  ---   -  - -   -  -     -      -    -    -- -
-  - --   --   - - -- -   ---  - - - --- --- - - - -  -  -  --  --       -    -        --    --    -
- -  - - ---      -      -  -     --      --  -      -  - -- -           ---  - - -      - - -     -
--   -   -     - --   --  -     -  --   -     -  - - -     -  -     - - -   -      - - - -- -   - --
-      -   - -  -     - -  -    -   -    -- -      -      -   -- -     -       -- -     -  -    -  -
-    -  -  -----  - --- - -          - --   - -          -  --    -- - -    -   - - --   - --  - - -
-  ---    -     -          -  -  - - ---     ---- - --- -  -- - - --  -- -  -     -    -     --    -
--  -- -      --   - -    ---       -       --   -   - -  -    - --      -    - -     - - --   -  --
-      -         - -  -           -    ---     --    -   -  -    - --          -   -----       - - -
- -  -  -  - -      ---   ---- - -    -     -      - -     -   -       - - --------     -          -
- - -    -    - -   -  -      --    --- -- - -    ---    -    -- -- --   -          - -----   --   -
- -  ---   - - ---         -   -  --  -  -        -   -     -    -  -    -   - - -        - -    ---
-        -  - -       -      -   - -- - - -- -   -  - ---- -  -   -        -- - -   ---- -    -    -
-   --  -       -    -  -       --     - -- - - -       --  -      -  -----  - -       -    -     --
- -       -   - -  - -    -- -     --     - -       -- -    - - --- -      -- - -   - - -  --    - -
-    -       -    -         -  -   --  - -   -   --  ----        -    -   --   -  - -        --    -
-      - -- -  --    -     - -     - -   -      -       -  -          -     - -         - - -- --- -
-                - -  ---    -   --   ---     -   -   -  -  -    - - -    ---  ---- ---   -        -
-- - - -    ---  --  -  - -                 -   ---    -  --       -  -       -  - -         - -  --
-     -  --     -   - -- -    -    -     -  - -     - -     --      - -  -- -    -   -   -- - -- - -
-      -     -    -  - - --      -- - - --   -- -        --   --   -  -   --           - -        --
- - -    -   -    --    -          -   --         - -   -- - -  -      -- -       -   -        --  -
-     -  -   -     --  -  - ---   -   -      - - - -      --   -   -  -  ------  --   -  --      - -
-            -   --     --    --    - --  - -  -    - -      -     --   -         --  --    --  - --
-      --      - - --  --- - - --  --  -- -  - -  -        -    -       -   -    - --      -     - -
-- -  --  -  -     -       -  - -   -   -  -----    -  -   -  -   - ---       --  -  - - --        -
-       --    -  --- --- -  -   - -   --  -     -    -         - --- -   ---      ---  --- --  -   -
-      --   -       -----  --    -         -      -      ---    -  --              -            -  -
-    --      - --- - -  - -  -  -    -    - -  -     -      -     -        -  -  --     -- -      --
- - - -   -  -  - -      --  - -   -    -       -     -  - -   -   --- -       -     --       --   -
-   - - -   -    -- - -    -      -      -- -   -  - - - -- - -   -   -- --         -   ---        -
-     -   --- -    -     --- -      --          --  - -       --    -    - -  -  --     -    -- -  -
-    --   - -   -   -            -  - -           - - ---- -    - -    -     - -   -- - - - -   ----
- - - -       -   -  -  -   - -    -  -  -- --  - --        -     --    --   - --       -- -   -   -
- -  - - ----   - -  -------  -     -           - - - -  --    - -   --  ---    --   --        -- --
-     -     -    --   -    - ---- --       -  - - -              -- -  --   - --    --- -  -   -  --
--  - - -    --    -   --         -  --  -- --  -    -   - - -  - -   - - -- - -        --    -    -
-  -  --    --- -   - - -- - - - --   - - -  - -       --   -      -   -    --  -    ---   -       -
- --      -   -  -       -     -- - -  -  -     -- -- -   --   - -   - -  --  - - -  --    -   --  -
-  -     - -   -    -     - -  -    --  -      -   -- -   -  -- -    -  -         -     -       -  -
--            - - -- - --     - -  -- --     - - - - - -     -        -   - --  -  -    -- -   -- --
- -   - -- --- --  -  - -        -- -  ----  -  - - -    --    -          -     - -  -    -        -
-    - -  --      -       --- ---   -     -      -    -    ---      -    -  - -  --- ---       - ---
- -- -  -  -       -  -      -    -- -  -       - -    - -    -  -      --   --    -- -  -   --    -
-  --  -  -    -    -    -            -      - -- - -    -- -      -  --    -      -  --    -      -
-      -    -  -  -   - -  --    --     - - -- -- --    -      -    -- --   - -  -       - -   --  -
-  -     - -          -      - -- -- -  -   - - - -   -    -      -- - --   -  --  -       - - -   -
-- - --   --   --         - -     -- ----  - -- -- -    --  - -----    -  - -    -- -          -   -
-  - - -  - -  ----  -  -       -   -    -  - - -  -   -   -- -      -- -     -     -       --   - -
- -    -         -   --   -      -  - -- -     -- -   -     -   - --    -- --    -     -  - --     -
-  -  -   -   -      - -  -    --   -  --              -   --    --     -   - -     --          - --
-     --      -  --  -   - - -       - -  -  - -      - -          -     -  -  -    -  -        -  -
-           -   - -    -   - -   ---- -       -  - -   - -      - - -  -        -  -   ---  - ------
---- -    -   --  -  -        --  ----       -  -- -      -   ---   - -      - -  --- - -          -
-- ----        --  ---   --  -  -    - -    - -   -  -  -   --      - - ---        -    --  -    - -
-                  - - -  - - -          --  - -     -  ---   --- - - -     - -- - -        - - - --
- -    -    - -  - - -     -- -- -  -    - ---   -  - -               - - -      ---  --  -   -   --
-   - -     --   - -     -  -   -   --   - -   -   - ---- -- - - -     - --  -     - --- -       - -
- - -   -         - -   --     - - -      - - - -  - --- -         - - -         -   -    -    -   -
-    --- - -   --  -   -   -      - -  -   -   - -- -     ---- - - -    -   --      --    -  -  -- -
---  -  -- -  - -  -- -              - - - -          -- -       -   - - -       -- -        -     -
- -   - --- -     -  - --    - -  --    -     -   -   --   -      -      --- -     -- -   -   - -  -
-  - -  -          --    -  - -    -  -   --  -         -   -    --     - - - --      ---   -   -  -
----  -  -- - - - -    -   -  --  -            --    -    --   -   -- -   - ---       -    -       -
-   - -      -         - -  -  -  -   - -   -     -  - - -- -   --  - ---      -- --- - - -      - -
---  - -   - - -  --- -     ---   - - --  -- - - -    -   -    -  -    - - -  -  - --       -  --  -
-  ---  - --  -  -        - ---   -     -   -     -   -  -   -  ---  -- -- - --- --   -- - - - -   -
--    -   - -- -       --   --- --  -   -    - - --  -    -  - --     -         --  -  -   -   --  -
-      - -   --  -        -      - - -       -  -  -       -     -- - -       --   -       -    -- -
-   --- -   -      - ----    --   --    -       -    - -    -              --    -   -- - -        -
- -        -  -    -          -- - - -    -   -- -   -       --    -- - -  -       -   --- -     - -
-  -  - -  - -    -  -     -- -         - -   -    -    -  --- -    -     -       --    -       -- -
- -  -     -  -- -- -     -  -   --  --   -    -  -  -    -   - -     --- -      -            -    -
---   -  -      - -   -  - -   -  - --   -       -- ---   -  - - -    -   - --  -  - -     - -     -
-      - - --     -        --    --  - -   -- - -      - -      ---    -    --- - - - -  --        -
-  --  - -  -       -     --- --  - - - -  -     -          --  -  -  --- - --  -      -     -   - -
-   -   --  -       - -  - - - --           ---   --    -- --    --       -   --  ----       - -   -
- -   -     -  -       ---     --  -      --      -             -    --   - -- - -     - - - -     -
- -    -  ---  - - -        ---  -      -   - ------- --      ---  --   - -    - -   -      -    - -
- -  -  -    ---    -- --         -   - - -- --   -- -     - - - --  -  -    --   -  -   --   - -- -
- -    -      - - - -    -      --          - - -   -    - --        - - - -   --- -  -         ----
-         -  -      --     -   -----    -    -  --      -  -   -       - - -  -  -     -  -  - -   -
- --  - - -     -   -   -    --  -- --     - -    - - --- -  -    -     ---    -         -  -  --- -
- -   -           -       - -  --  -   - - -       - -   -    -  -  -   -  -       -     -         -
----------------------------------------------------------------------------------------------------
