100
100
----------------------------------------------------------------------------------------------------
-  --   -  -- - -    -- ----    -          - -    - -  -     -  ---   --   - -   -     - - -     - -
-   -     --  --   -- -          - -  --- - -   -   - - - --  -          -    --    --       -- -  -
-        -   -- -  -  - - -  -  - -        - -  -  -  -  - - ----      --      -      -   - -  - - -
-- - -       -          -   ---- -   - - -- ---- -   - --           - --   -   - -      -  -  - - --
-     -- - -  - --  ---    -              - -   -      -    -   -       -- -    --  --  ---      - -
-  -          -  - - -  -   -  - --   -   -  -  -  -- -    -    --- --  -           - -        -   -
-    -   -        -- ---  ---        -  - -   - -  -         --    -     - -    - -   -   --    -  -
--  -- - -  -  -     -        - -  -     -- -       -    --- -  -  - -              - -  --    -   -
-        -   - - -- - - -    - -  --   -- -  -  -    -  ----        --      -  -- -  -      --     -
- -   ---  -   - -       -    -   -      - -    --           -     -      -- - - -  --- - -  --    -
-  - --  -  -        - --     - - - ----  -  ---   -   -  -     -        -- - -        - - -   --  -
- -          --  -  - - - - -     -    --- -      -   -   - -          -   -  -- - --       ---   --
- - -     --     - -- --  - -- --      --     -     -    - --   - - - -     - - -       - -  -  -  -
-- -  ---  - -  --  --  - - -  - - --  -  -   -  -   - - --   -  -      - - -   -    --     -      -
-  ---   --       -- --  -      --           --     -      - -  -- -- -- -    --  -          -     -
--    - -  -     --    -  - - -   --   - -  --  -  -- -- -  - --  --        -   -  - - -    - --   -
-- -   - - - -    - -- -  - - -    -     -                -      -      -  - ----    --   -- -     -
--   - - -            -- -       -  --   -    -      - - -   - -      -   -                ----    -
-  -  -  -   - -    --     --  - -   -   -     -- -  - -- - -- -     -   -- -      - - -  -  -    --
- -   -   -     --- - - - -     -  --      - --         --          -      - -  - -- --     - -   --
-       - -    -         - -  - -        --   - -  --      - --  -        --- -   -     -  -  -    -
- - -   - -      - -    -    -- - -     - - - - -- -    -          --  -  -   --         --      - -
-     --   -       -   -    -- -     --   -  -  -  -  -   -  -           - --    - - -  -    - -   -
--   -   - - - - -   -   - -  -  - - -     -  - --- -- -  -  -- - -         - - --  --   -      -  -
-- -- -      -      -   -  -      -  -   --    -     --  - -      -  -      -          -   -  - -  -
-  -    -      -  -  -         -    --  --  -    -  -   --- - -  -       --    - --  - -     -- -  -
-- --     -  -   - --- - -  - -      --   -            - -  - -         - - --    - --- -  - - -   -
--       -     ---   -- - -  -     -   -  - --  - - -    -  -    -    -           -   --           -
--  - - -    - -- -   --      ---   -   - --      -  -    -  - -  - -  -  -   - --    -  - --      -
- - -   - -- - - -  -   -    - - -    -- -  - - -   -- --  -     --    - - -   - --     --  -      -
-       --  - -  - -  -- ---  -     -     -  -  -         -   -     --   -    -      - -   -     - -
--   -- - -  -     -        --   -    -- -   -    --    ---   -      -      -   --- -   -  --- --  -
-  - - - - -  -    -  - ----        -  -  -    --  -          - - - - --  - --       -   -         -
--  -- - --  --             - -   ---   -  -- - - --- --   -  - -      - -   - --  -- --     - - - -
-   --  --  -      ----       - --   - --    - --  - -  - -      -       -  - - - -  - - ---   - - -
-- -  -    -    ---  -    -       -       -  -  --   -    -  -      - -   - -        - -    - -    -
-   - --       - --    - -   --   - -  -      -   -     - --      -     -     - - -  -       --    -
-          -    - -   ---- -    -  ---     -  -  - - - -     -  -  --- -  --- - - - -  -- -- - -   -
-      -       - - -        -  -    -- - - -     - - -  -- - -- -      - -   --    - --   - ---  - -
-    -        - -  --   - -- -               -                -     - ----------   -     -  -  -  --
-  --  -  -     - -  --  - -  -         -  - -    -        --   - -  --  -  -- --   - -         -  -
-   -     - -  -       ----   --  -- - -  -          -   -  --  -   -     ---    - -  -     - -    -
-  --   -   -        --         - -  - --    -  -    - - --  -  ---  -       - - -- -    -   -    --
-  -     --     -       --   -  --    -  -- -    --   -  - - - -   -       -          -  - ---     -
-    -- -  - - -    -   - --     -     --        --    --   -- -- - - - -        -  -   -        ---
-- -  -     --   -        --  --  -  -             --    -- -  - -   - -  -      -   --    ---  -  -
-   -- -- - -   -- ---- -       -        -  -        - -         - -  -   -  --  - -  --      - - --
- -   -  -  -     - -  - -  -    -           -   -    - -  -  -  -  -  -        -- -- -    --      -
- - - - ---   -           -   -   -  - -  -     -- --- --     -    -   -  ----  - - --        -    -
---       - --     -    -  --      --  -    -             - --  ---- -   --     -  -  - --  -  --- -
-         - - -  - - --      -   --   -   --   --  -     -                   -  -       - -       --
-      - -   -    - -        --    -- - --       -  - ---- - ---  - -    -    - - --   -   - - - - -
-  - -  -- -- -      -  -- - -   --  - - --   - --  -   -     -   - -- --  -  -        - --      - -
-   --      -      -- -  -    -   - -  -      -       -- -  ---  -- -  - -     -   -   -   --- -  --
--    -       -   -  ---        -    -- --     ---- -    --     -  -         - - -  --      --     -
--  ---     -   -- -  -     -- -       -  --  -  -   -     -    -- --- -   -        -    --       --
-     -  -   - -    - -   --  -    -  -  -    -  -    -   -   -  --  -        -    --- -- -  -     -
-    -  - --  -   --      --- - -      - -- -     -         -     -   -  - - -  --              - --
-                    -  - -   -   - --  -   -        - -  -        - --- -- -     - -   - -        -
-  --  - -  ----   -        --   --- -  -  --- -   -- -- -       - -- - -- - --  -      - -  - -   -
- - --  -- -  -  -     -  -      --         -     -     -   -  - - - --         -           -  -   -
-     - -    -   -   -  -   -   - ---   -   - --    --      - -   -      -      - -   --    - - - --
-   -  --  -          - --- -         - -    ---     -    --  - --    -      - - - --    --   ---  -
-   ---     -    ---     --   -  -    -- -   - -   -  - -   --   -   -- - -  - -- - - -   -  -  ----
- --     --  --- -  - - -  --       -       -   --   --      - -  --       ---  -  -        - -    -
- -  -     --       -  -  - - -          --   -  -  - - -    - - - -         -  - -  -   - -- -  ---
-  -   --  -    -       -  - -          -   - -- -    -- --   - -    -    ---       - -- -    -  - -
-  -    -  -      --       -   - - -        -- -  -   -     ---- - ---    --  -- ---      --    -  -
-  -  -          -      - - -      -      -  -    -    -     --  -- - - -- - - --   -  -- - -   -  -
-       - - --  -   ---- -    -    --     -    - -- --  ----        -    - - - --   -  ---- -  -- --
-- -  -      - -    -              -    -- -- -   -   - -      -      -   -     -       -       -  -
-   --    - -  ---      --    -- -  -  -    - -    -   -     - -       -    -          - --   -  - -
- --   -    - -   --         -   -    - - ----   - - --     -     --  - ---   -           -- - -   -
---  --  -  -  -           - ---   -    - -   - - -         --   -  -   -  - -- -    -  -    - -   -
-  -  - --- -  -  --- -  -  - -       ----  --  -   -      - ---           ---   -   -    -    --  -
-   - -    ---      - -  -    -   -  - - -   - - -    -  -   --    --   - -      - -    -  - -  -- -
- -       -   --  -     -      --   --  --     -        -   - - - --- -      -   -  - --  -    -   -
- -  - - -      -  -    - -      ---  --  -  -- -  - - --      - -   -- -  -  -  - -  --           -
-  -      -       -   -   -     -- --  ---     -- -  - -   - ---   --     -    - - --    --  --    -
-     - -   --       - -         -           -  - - -   -   --- -    --- -   -   -- -  - -         -
-   -      - -    -    - -    ----  ---    - --- --   ---    -   -  --     -- -    --    - ---    --
-       --- - - --   - -  - - - - -   - -  - --      --   - -            --- --  --        -       -
- --  --  -    -  -  --   -- -   - ---     -    -   - -  -   -   -  -     -- - - - -   --   -      -
--  - -  - -   -    -  -    - - -       -    -     -  -- -- ----  -            -   - -     - - - - -
--       -  --   - -  -- - -    -- -- --   -  - -       -    -    ------   -    -- --         -- - -
-  --      - -     -  -        - - - -    -  -    ---     -- - ---  -      -   --   -    -  -      -
--    - -  - - - -       -   --          - -   -     -    -            - --         -       -   -  -
- -   -  -   -     -- - -      --  - -   - - - ---  -  --  -    --  - ---  -- - --  -   --- - -    -
-        - -- --   -     -- - -    -          -    -  -  -    -  -  -   --   -    -     - -- --  - -
--     -  -      -   -    -     -  - -  --   - - --    -  -  -   -      -  ----  ---         -  -- -
- --    -   - -- - --   -        --- - -   -     -   -   - -      ---- -  --   -      - -   - - -  -
- - -- - -- -- -     - -           --   -   --     -- - - --  -       -- -   -      --       -   - -
-  -   -           -- - -   -     -     -     - -  --     -  ---   -         --- --     -  -   - - -
-   --  -        - -    --  -   - --  ----       ---  --    --   -- --         -   -        -  -   -
--    -     --      ---   - - --    --    - --  -    - -     -  - -       -      --  -  ----       -
--              -   ---   - -  -    - -- - -  - -    - - -    -  -- -      --  --    - -   -  --   -
-  -    -   ---   - -        -   -   -    -     -- ----     --  -        -    -       - - -  - --  -
-  -    --             -        -  -  ---    - - -        - -      -  -- -  --      -     --   --  -
----------------------------------------------------------------------------------------------------
