100
100
----------------------------------------------------------------------------------------------------
-       -     -      --- -  --      - --         ---  -  -      -      -    -  -     -  -          -
-   - -  --         -    -    -   - -  -  --   -      --           - -   --  -- --  ---   -- --  - -
-       -  -- --    -        -         -      -                 -  - -          -  --   - ---      -
-   -  - -   --    -  - ---    - --  --   -- --     -  -            - -   -  - -             -   - -
--  - -  - --  - -- -  -    - ---- -    -    --  -  - -      -    -     -    -   -   -      -  --  -
-- -    - -  ---       --           --  - --  -    -   ----- - - -- - -      -      -----          -
-    -        -    -   -   - - - -  - - -   --    -  -     -  - -      -       -    -        - -  --
-       -   - - -       --  -   -   - - - - - -  - --  -    -     --- -  - - - --  -   -  -        -
-       - -     --   - -  -   -  --   -   -        -- - ---    - - - -   -  -   -     -       --   -
- --       -- -       -    -    ---       -- --      - ----     --   - - --     -       - ---- -   -
-  -   --      ---   -          -   -    -  -  - -    -                -    -  - -        -  --    -
- -- ---       -    -    --        ----  -  ---   -- - - - -        --   --      -   --    -     - -
-       - - - - - -   --- -  --- -      - -  -  -    -    -     --  - -     - -- - - - --      -   -
- -  - --  -     - -    --  -    -  - - - - - --    - - -- --   -  -- -- -      -  - -        -    -
-  -  -      ---  -   -   - -  --     -    --  -       -         - - -   -   --   ---  -    --  -  -
--     -   -   - ---  - - - -- -  -   --     -  -   - -   -    -     ---  - -  -  - --   - -- ---  -
-  - -  - -  - - -   --- -          -           -       - -   -  -        -   -- - --        -     -
--- -- - -   --- - -        -     - - -       --  -- ----   -   - -     - -      -  -    - - -  -- -
-  -   -     -   -   -  --  - --   -   -    -      -    - -    -  -       - -  - - - ---    -      -
- - - -      -        - - --- -- ----   - -   - --     -     - -       - -        --    - -      - -
-        --     ---  - -   --    -   - -    -  -  --- -  -       --    -     -   - -      -    -   -
-  - -   -     ---    -  -   ----  --  -  -   --      ---     -   -      -  -- - -  --  - - -      -
- -    -  -   - -          -  --     --     -   - -- - -   -- -  --    - - -   - --   -  -        --
--    --      -  ---        -     ---  -- --   - -   -  --  - - -      -    --      -      - -- - --
-      - -  -    -- --   -      -  - -  -- ---  -  -    - -   --  -      --    -  -  -     --  - - -
-     -    -- -           -- -  - - -   -  -  -    --          -   - --- -  -- --  --    -   - - - -
----   -       -     -- -       -  --     -     -      - -   -   --   -  - -     -  -- - ---  - -- -
-    -   --- -   -     -- -  ---       - -    -- - --- -  - -        - --- - - -  --   --   - --   -
-- -                - -          --- -    - -- -        -   -   --    -   -  - --  - --- - -- -- - -
-   --    - -  -  -    -  -     -    -    -  - - - -  - -  -  -    - -   -    -  -     -   -       -
-  -- --      -  --- -   -  -  -  -   -      --   -   -     -    -     -    -  ---- -   -     ---  -
-    -         -  -     --    - ---- -   - -  - -     -   -  --    -    -  -  -    -   - -    - -  -
-  - - -  -    -   -- - -   -   -    --  -       -           -        - -  -  - -  -- -    -       -
-     -          -      --   - - - -    --     - --   -   --     -- - - - -   -     -    -  -  - - -
-      -      --- -    -   -   --      -   -   ---     - --- - - - -  - -    -  - - --  --  - -- - -
-   -- --    --    -   -     -  - -   -   -   -   -     -       -  --  -    -  - -  --  -  -- - - --
---   --      --- - -    - - -- - ----- -        --  -  -     -   -  -  - - -     - -   -    -- -- -
-   -          -    -  - -  --             -  -           -  --     -   -  -  - -- -  - - ---  --- -
-- - -  -    -- -      -  -    --  -         - -     ---  - --    -- -- - -   ----  - --    -- --  -
-       --    --   -      -     --- - --   - -  -  -   - -     - -          -    --   --           -
--- --   - - -   -   - -  --      -       - -  -- --  -   -   -  -  - --     -      -  - -   -     -
-- -    - --        -  -- -    ----   ---   -- - -  - -     -  -  -    -- -           --   --  -   -
--- --- - --  -     -  --- ---    -      -    - --    - ---  - --  -          ----   -        -- - -
-    - -- -- -   -  -     --     -  --   -  -  -  -         --  --  --   -- -  --     -    - -    --
-  -  -- - -  -       -     - -  - - -  -   - -  -     -   -   - -       - - -    -            --  -
- -     -  -    --    -   -  - --     --  -    -    -     - -  --     -       -  -- -     -- -  -- -
-   -- -   - -  -- -  - --   -    --  - -    -    --    -  - -    - -- -       -      --   -       -
-  --- --   -    -- - -    -        -     -    -      -  -     -- - ---     -- - - -     -   - -  --
-         - --  - -      -     - --     --- -      -     -      -  -     -  --       -     --      -
- -   -       -     -        --     -   -   -  -  -  -  - -- --   -    -     --       -- -  --------
-  --  ---     -     - -    - --      --   -      - - -        - -    -   -     - -   - -  -  -    -
-  -  -   --  -    - -  -      ---            -- -  -    --- -            - ---  - -  --       -- --
- -   ----               -  -- -- -    -- --  -      - - -   -        --    -   -  ----  --  -     -
-   --    -     -    - -  --      --                -  -    -       -  -  - -    -- -     -   -  ---
- --     - - --  -       -  --- --     -- -  -       - - -      - --  - --      -   -     -   -    -
- -    -  - -  - -  - --   -  -- -    -   --     -     -- -     - -  -  -     -  ---   -   -   -   -
--   ---   -     - -   --- - -  -      -  -   -- --  - -     --  -  -- -   -  -     -    -- -   -- -
- --            -  ---    - --- -    - -            --     -- ---     - - ---- ---  --    -   -   --
-   -     --   - -        - -    --       --   ---   --   -  -   - -  --  -- -    -      - - - --  -
-- - -  -     --  - -     -          --   -   -  --- - --   --     -    -   -     -- - - - - ---   -
- ---  --  -  - --   -  -   - -   -  -   -- -     - --     -    --    -  -   - - -  -             --
-    -    - -   -             --      -----  -  --         --  - -  - --   -      - ---    --    - -
-      - - -                 --- -   -  -    -         - -    -  -  -    --          -       --    -
-  -    -- --  ---       -  -- -   - --     --    -  -      -- -    -- -   - -        --     - -  --
-      - --   -  ---     -    -  --- - -  - - -  - - -   -    -- -    --   -- - --     - -  -    - -
----     -  --  - -   - ---- -  - --  ------   -       - - -      - -    --      - -           -   -
-   - --         -    -   - -   -   -           - --   - ---  ----     -   - -         -    - -  - -
- -       --   -   --     --  --  -   - -  -    -    -          -- -     - - -          -        - -
-  -----   -   ----     -     -    - -    - -     --      -        --   -         -   -- --   -    -
-    -          -    --   - --   -  - -         - -  -  -    - --- --   - - -- ---     -    -   ----
- --   -- - -        - --  -  - --   - -      -       - -   -- - -     -  - --     -      - - -  - -
-    -  --  - -          --     - - ----  -  -   -  -  -     ---   -  -                  - - -   - -
-  -             -      -   -     - -      -         --- -- -      -- -- --  -  - -      --- - -   -
-       -  -- - -   - -   -    -  --   - -   - ----  - - - - --          -  - -    --        - -- --
-- -    -- -   -  -    --      - --  -  - -   -          --     - -- --   --  -        - - - --  - -
-       - -- - -    -     --   -   -     --  - -- -- -      - -- - --   -    -- - - --   - -   -   -
-    - ----     - -   - --    --     -  - -  -   -     - -  - --  - -   - -  - -    - -  -   --    -
- -   -  - -  - - - - -  --   -         --         --  ----     - -   -       -  - -  -   -    - - -
- -    -- --- -  -    - - -  -     -   --  -   -    - -    -  -          --- - --  -  - -      -   -
---  - -   - -  -   -  - - -  - - - - -    - -    -     --- -      -  - -   -    -     -       - ---
-- -   -  - --   - - - -      -   -   - - - --     - -     - -     -  -   -  -  --   - --  -       -
-  -    -      -  -         --    - - - - -       -        -        -   -      -     - -    -      -
-- -  -               --              - - - -   --          -  -- --- --   -         -    -  -     -
-    - -     -                  - -  - -  -- --- -  -- -   ---    -  -- --       - - --  --- -  - --
-          -  ----  - --      --  -  -- --  --- -  - -  --  - --   -        - --  --  -     -  -   -
- -  -   -    -      -           -     -       -       -            - ----          -     -  -    --
- ------- --- -     - -  ----  -              -     --  ------   --         -    - -       -   -   -
--           -  - --  --   - -   ---   -   - - ---  - --     --    -   --        - - --        -  --
-- -          -  --      - - -  --    - -   --  - -   - - --  - --  -    - --- -           - -     -
-    -          --       --       -- - -        -     -          -  -  -       --  --   - - --     -
- -  -  -   - - --  -  -  -  --        -     --    -  - - -     --  -  -    --             -- --   -
-    --- -  -     - -   -    -   --     - -     - -- -    -  -  --    -  --- - -   -- --         - -
-   -   - - -          - -    ---  -- - --    - ---- - -   - --               - - -  - -     -  -  -
-  - -     -    --   ---   - - -   -   -   -    -  - -- - -      -   -        -     -  -   ------- -
-      -- -     -   -    -     - - -   - - -  - -   -    ---  -  -   -   --   -  ---  - --  ------ -
-  --- -- -        -  -   - --     - - -- --   - --   - - -     ---  -  - --        -      ------- -
- -   -       - -       --  -    --         -- --  -       -  -  - -   --  ---  --         ------  -
-  -                            -    -  -    -    -   - -    -      -    -  -     -                -
----------------------------------------------------------------------------------------------------
