100
100
----------------------------------------------------------------------------------------------------
-      - - - --    - -     -  --          - -             -  -   -   - - ------  -         -       -
--- -  -   -      - -     ---  - ----     -  -    -  --    --  -  -       ------  -  -  - - --   - -
- -   - -            -   -- -        -    ---  -  -      - -  -     -     -   - -    ---  -- - - ---
-     -    - -   ---    --- -- -  - -    -       --  - --   --   - -- -    --    --- - - - - -     -
-       --   -   -  ----  -   -  -   -  - --   -  - -    - --     -     -    --    -     --        -
-     - -       -   -        -     -  -   -     ---     -      --             -     -  - -   --    -
-- - -      - - - - -- -       -         - -  -  -        -   - - --    - -     -   -  -  -- - - - -
-- --   -      - - -  --      - -   -- - - -       - ----   --   -- -  --   - --  -     - -   -- - -
-     -   -  --  ---    -  - -                -    -  -   -   -    - --  -     --     -  -  - -    -
-      - - -    -      --   - --  - ---- ---      -      -   -  --   - -  ---                    - -
-    --- -     - --  -  -  -  - --   -                 - -  -  -     -         --    --   -  -     -
- -- - -    -     --- -   -  -    --  - -   -  -  --- - - -     - -      -- -      -    -- -       -
-  -         -- --   - - - -    -   -  -        -   - - -   -        -        -     - -      -- ----
--- -    -  -   -   -   -     -  -   - --- -  -   -   --    - --  --       - - -     -    ---   -- -
-  -     - -  ------ - -  - - -    -     -  - -      -  - -  --- -      -        -    --       -   -
-----       -       -   -    ---   -    -        -      -   -      - -  -    - --  - -    -- -------
- -  -- -      -  -       - -        --  - - - -- -- - --  - --  - -- -     -- -  -   -  -  -   -  -
- ---   -   -      --  - -         -   -     -  - -  - -   --                --- -        -    -  --
-    -        -- -- --- -   - --  -    -   --       - -  -              -- -     -   -     -  -    -
-   --  -  -   -   -   -        - -   -       -- - -        - -  -- - --   ---  -  -  - -    ----  -
-   - -    - - -- - -    -   -      - --     -  -    - --       --   -     -  -  --    - --- -- -  -
-  --    -     - - -- -        - --  -  ----  --    -   -- -   --  --  -  -  --     - --   -  - -  -
- -     --  -   - -  -     -     --                    -     - -  - -   -- -   - -- -   - --   -   -
- - ---   -       - ---  -     ----   - -  --  -- -  - - --- --- -    -   -  --    -  - -    -     -
-  -          --  - -  -  -  --     - --    - - -     -     -    -  - --- --  --- -   - --  ----   -
-   - - - --      - ---        ----    - -         -   --  --  - -  - -  -  --       -  - -- -  -  -
-            -  -  - - -  -   - --  ---    - -            --  - -  --   ---  -  --  - - -      -- --
-     --- - -  -  - - - --    --         -  --      -    -         --       --  --      ---       --
-  -               -  - -- -   - -   -  -  - -  -  - - -- --     -  ---  ---      -    -    - --- --
--  -    - -      -  ---       - --      - -    -  -- -      -  -    -   -     --   -  ---- -    ---
-  --  ---  - -          -    - -   --  --  -     -- -     - ---   - - --    -          - --    -  -
-  - -           - -  --  -          -         -   -      ---     --     -     -   --   - --  --   -
-   -      -   --  ---       --  - -     -     - ---  - -   - --- --- ----         -- -  -- - --   -
- -  --   -   -   -    - - -  -   - - -  -  -           - --  --- -           - - -         -      -
- -     --  -- -    ---  -  -  -          -    -        -  - - --  ---         --      - -   - - - -
--   ---   -     - -   -  - -- -  -  -  --  --- -   - - --   -   --     -  -  -   -  --            -
- - -        --     -- - ---  -       -       --  -       - -  ---  - - -          --    -- -      -
--   -- - -      --  -          -  -     -       -  -- - -- - -    -   - -  - --   --   --        --
-       -     -- -   -  ---     --  -      - ---      --   -      --  -          -- - - -- - --    -
- -  -    -    - -  -  -   --          -      -  -  -   --          -      -  ----   -   --   -    -
--     -  -    -  -     ---   -  -   --- - --- -     --    - --    -  ---         --    -   -  -   -
- -   --- -  -  -  - -    - -    -- -     --   -   -  - --    -  -        --  - -  -  - -     -    -
--  - - -    -  - - --- --- -- -       --         -     -          - - -  -      -        -    - ---
-- -   -       - -  ---    -     -  --      -   --   -     -    - -  -   -   -  - -     -   -   -  -
--  --    -   - -  -      - --           -    --     -  --   - - -     -----         --  -     -   -
-    --    -      - - --  -       ----           - -   - ---   --    -   - - --       -        - - -
- -----  -  - -    --   -  - - -- -   - -   --   -  - - -   -    -  - - -        --    --  - -     -
-  -   -    -     -       - - --   - -- -       -       - -        --   -       -  -   -    --     -
-   --- -    -  -    -   -- -     -- -       --   -  -   - -          -    -  -  - -  -   -- --  - -
-- -   -  - --- -  -- -  -            - - -  -         - - ---- ---  -- -      - - --    --   - -  -
-     - -            -   --  -       -           -- -  -  -  -        - -   -   - - -  -  -     ----
---   - - -  -- ---  - -  ---     - -- -- -     -  -  ---  --  -   -      ------ -- --   -  - ---- -
-  -  -    -  -             ---   -  - - - - -    --   --   ---  -- -     -       -  --    -       -
-- -          -   - -- - -   - ---     ----      -     -      - -        -     -- - -  - -  --  -  -
-   -     -   -  --    - - -- --       - -  -----       --  -- -- - -    -      - -     - --     - -
- --  --          -- - ---   - -    --         --     -       -        -        -   -       -   -  -
-- -    ---   - -       -  - -     -  -  - ---   --   --- -   -   -   -   - -  - -            -  - -
-   -     ---- --    - -    --   - --     -  - -     -    -  -- - -    -  -  -    - - -    - -     -
- -  -  -     -   -  -            -  - -     --    -  -    --   -      - -    --   -     --   - -  -
-- -      -   --  -     -  - --   -- -   ----        - -        -  --  -  ---- -  --   -           -
-  -   - -             --    -   --  -      --    -  -- --  -  -  -   -   -                  - - - -
-           - --  -     -       - - -   -  -  -  - --- -     -- -   - -    -  -          -  -      -
- -     -  - -  -   - - ---      ---  --   -      -       -   -   --     -- - ----    --    -    - -
-       -     ---     --  --  -      -  -- --  -- -    -       - - - - -    -  --  -- - -          -
-- -  -  -      --   --  - -   -  -- - --    -   -  -   -    -    -- -- --  -        -  -    --   --
- -  - -- -   -     -       ------          - ---  --  -        -    -    ---  -    -  --   -      -
-- - -  --  - -   -  -  -- --     - - - -  -      -       --      --- -     -   ---  -        -  - -
-     --  --  -      -  --  -  - -  - -  -    -  -  --- --  -   -       - - -       -      - -  -  -
-     --   --   -- --  - -  -     -  - - -                  --      -        - --  - - ---  -- -- --
--   -         -            -            -         -   -  -   -     - - -  --        - --    - -- --
-  -   - -     - -  -     -  --  ---- -   - ----   -- --   -    -      -      -   --         -  -  -
-      - -  - ---     - - ---      --   ---      -  -        - -    -     - -  -      - -    --  - -
-- -  -  - -   -          -    - - - - -- -   - - -      ----  -       -    - -   ---   ---- - -   -
--  -  -        -   -   -  - --   - -- -   -          -       -       - - ----        -   --    -  -
-  - -  -- -   -- -   - -  -       -    -- ---               --  -- --   - -  --   -  -- -    -- ---
-  - - -  -  -  -   - --   -        - -   -    -   ----  -       - -    --  - -   - - -    --- - - -
-  - - -   --  -- -  --  -  -    -      --- -             - - -  ---- - -          --  -       -   -
- - - - --  -  - - - - -      ---    - -  -     -----   - --       -  -- -  ---  -         - -    --
-    -  -- - ---    -   -    --      -- -- --        -  -     - - -    -  ---  -    -   --      - --
-    -  - - -  -   --  -  ---  -  - --         --        - - -    -     - -     ----         -   ---
--  -    --    --    -  -     - -    --   --          --  -   - - --       --    -    -- -     -   -
-   -       - -  - - -        --       --   -- ---  -   -   -      - -   - - -  - -       -       --
-   -       -                    - -     -  -  -  -      -      -- - -  - --        - ---          -
-- --- --  -  --    -    --     -- --    - ---      -     -  -   -   -  - -  -      -    ---   - - -
-         -   - -     - -    -    --     - -    -- -   -- - ---  -- ---   -   -       - -         --
---  - -    -   --        ----     -     -    -   -     -     ----    --   - --    --  --  - -  - --
-  - --   -- - -  - --- -   -     -- -       -       -   -   -  -   -- -    - --     -   -  -      -
-          --  - -    - --   - - -  -      -     -   -   - -  --      -         - --  - -- -    -  -
- -   - --   --- -   - --  --     - -- -     -            - - -  --   -  -    --- -   -  -  -      -
-   -   -    -   -     -- -  -----   - -- ---  --    --     - -  - --- --  -        -  --     -- - -
-     -  ---   -                       -         --  -  --   -- - - -   --   --  -    -  --   -    -
-      -      - -  - -  -    -  - -- -- -  -   --   -           -   -     - --  -   -    -- --   - -
- -     ---    - -  -   - - -  -- -    -         -- -  -- -      -  -  -      -  -   --   - -     --
---       --        - -      -  -      --    - -                  -        ---    -- -- -   -- -   -
-  --  - ---- -  -   --        -     -     -- --- -- -  - ---- ---    --      --- -- -   - -       -
--   -   ---        - - -      -     - -     -    - ---      -           -      -  -    -       - --
-      -   -      --  -  -     - --    -    - - -      -   -      --     --    - - -    -     --   -
-    -        ---    -    -     -   -         -   --   - ---- -            - -- -     -- -   ---   -
----------------------------------------------------------------------------------------------------
