100
100
----------------------------------------------------------------------------------------------------
- -  -        -         -                     - -  --    - -- - -  - -   ---  -      --  ---  -    -
- - -     - -  -   - - -    -      - -  --   - -         -    -   -- -- -       - -  -- -- -  - - --
-   -  -    - -- -- -  -      -   -  -  -  -  -- - -- -   -    -          --     -  -  -         - -
--       --  - -     -      - - - - -   - -  - -  - -     - --  -   -  --     - -  -     - -     - -
-- --  -  - -   -           -  - --  --  -  -    -           -       --  - --- --- -          -    -
- -   - -      --  --          - - -  --         ---  -  --   -   -  -  -        -   --    -  -    -
--      -   --      -  - -  -- -  - -         -   -       -   --    -        - --  -           --- -
-    -         -         -- - -        -  -- - -- -    -   - -     -     - ---   -      -- -       -
-- -- - - -  - -      - - -  -       --   - --      --     - -       --- -     - -   --  --  - - - -
-   -- --    --- -  -   -      - -- --  -    -      - -  -  - -   ---   -   --     -    -  - -     -
- -     --                   --   --  -             -- --      - - ----   -   -  -- -    -   -   - -
--- --  -   - --  - -- --  -     - -  -    - -   -   -    -  --- - -     ----  ---   -   - --  --  -
-    - - -- --     -     --     -- --  --    --  -          --       -       -   -- -    ---     ---
- - -    ---   -   -     ---  -     -    - --    -     -   --  -    --    - ----     --  -   ---  --
--    -     -   -   -  -  -    - -      - -        - -   -        -   --              - --   --    -
-  -    --     --  --   -  -     - -  --   --   -        - -    --  -     -  -  - - -   - ----  ----
- --  -- -         -   - --  - - --  -  - -          -     -   - -- -     ----   -          -      -
-  -   - --  -  -    -  - -  -    -   -    -      - - --    -- -            -   -        -   -  -  -
- - -      -     - - - - - --- ---   -  -   -       -- ---   -      -  -  - -  -- -    -  -     -  -
-     --     --    --     - - - - - -     - -   - -      -   --  - -- - -  -  --       -    -- -   -
-           -  -  --    - - -   - - -   - -- -   ---- -  -      - -             - ---  -      -    -
-      -  -    -    --  - -    -  -   -     -- -     --  - -  --  -       - -           ---        -
-      -  -        -  -     -  - -    -   --       - -  - -- - - -  -    --- -              - -   --
--   -    --- -     -  --   -- ---   - - -  -  -        -     -           --    -   - -- -      -- -
- - --  --      - -  - --     -              -           - - ----  - -  -   - -     -- -     --    -
- -   -    -   -    -      - --   - - -- -     -    - --   -     -   -     -  - -     -  ----      -
- - --   - - ---  -      -    - -   --   -- - - --- ----  - -   - -     --    - --      -  -  -- - -
- -  -   - --      - - -           -  -  - - -  - - -       - -   - -  - - --- -    -     -        -
-     - -              -- -   -        --- -  -  - -  - -  - -  --       -- -   - -    -   - -  -  -
- -                 -  - -- -- --  -     - -- -- - - ---       - --      - -     - -  --    -- -  --
-   - -   -- - -        --- -    -       - -  -      ----   -- - -  -       -       -  --          -
-     --   --- --- -    -- -  - - --- -   -    - -   --- -    -      ---      - -  -   - - - - -   -
-   -  -                -  - -  -    - -    - -       -   -   -  - -     -      -  -     - - - -   -
-   -   - - -  - -   -      -  --    -  -     -- - --   - - -    -  - -         --   - - -     -   -
- - -        --- -  -  - -    -    -- -   -  - - -   -       -   -  --  -   -     ---  - - -    -  -
-     --      -  ---  -    -   -    -  -- - -  --    --      ---   - -    -   -        --          -
---       --  --    - -     --  - - -  - -    --  -     - - -  -     -      -    -  -    -- - ---  -
-    -  --  ----- - -  - -    --     -    --   - - ---  -     --- -  - -    -- --     -  -      -  -
--- -     -      - - --  -   -     -           ----    -  - -  -- - - -   -  - -  -  ---   - - -   -
-   - ---    - -   - - -- -   -  - -  -- ---- -      --    --             - -- - -  -       - - -- -
-   -   -   - -  -  --  - - --    - -   -       -- -- ---    - --  - - --  --  -      - -        - -
- --      - -   ----   -  - -   -     --           - - --        -      -- -  -  -  ---            -
-    --     -             -   -    --  ---  --    - ---     -- -    - - -          -    -      -  --
-    -      -  --  - -   ---  ----       -      -    - - -   -   --    --   --       --   --  - -  -
---- ---    - -  - ---  ---      - -   -  -   -  --   -- -  - ---   --   -        -  -   -    -    -
-    -  --           - -   -     -- -     -       ---  --  -   ---  -  -     --     -        --  - -
- -   -     -  -   -- - - - -          -- -   - - -         -          -- -  -  - - - -----   ---  -
--   -   -      --      -  -  --     -- - -    -  - -  -  -     ----      --       - -  -   - - -  -
-          -       --- -  ---   -- - -  - -  -  ----   - -    -  - -  -         -    - -    -    - -
--  --  -      - --      -     - -   --      -      -- -   --  -   -       -- ----   - -   - -     -
-      -  - -  - ---    - -      - -  -   -   ----    - -   -- - --   -              -   -   -   - -
--       -   --   --     -  ---  --       --- -     --   -      - -- -  ---- -   - -   -      --   -
-     - -      -   - - -  ---         - - -- -    --    -      -          - ----   -    --  -   -- -
-- --      - -      - -        -   -  -    ---       -    -- -   -- - -    -  --    -      - ---- --
- -- - -      -      -  -  -- -     - -  -  - --  - -   -    - -         -      -     -       --   -
-          -  ---   - - -    --- -    - --- -      --- ----          ----  -  - - -  - -     --- ---
-    -  --  --              - -  - -  -   -   -     --    - --- -  --    -   -  --    -  -    -   --
-- --      -   --- - -  - -          -   -    -        -          -  - -    -     - - -   - --  - --
-    - - -        ---   - - - --                 -   - --  - -- -      -        -    -- -    --    -
-     -- --    - -          --   -   --  -     - -- - ---     - --  -- -- ---     -   -  -    --  --
- -   -   - --  ---      -- -- -       -   - -- ---  -    -  - - - -      --    -       -   - --   -
- - -  - -- -   -    --   -- -   - -   -   - -   --  --  -    --- --  - -  - - - -  - -   --     ---
-   - -    -    -   -    - -    -  --- -    -   -- --- - ---    --        - --   ---     -     -  --
-   - --   -- -   - -          ---     -   -   -    - -  -     --         - -  -    --  -  -  -    -
- ---   -  -   - - - - -      --      - --   -     -  -    -     - - -  - ---   -  -       -  -   --
-     - - -    -  -  - --- - -     -- -    ---  -  ----  - -  -  -- -     - -        -   -  -- --  -
-  - -     --- -    --  -- --   --      -              -    -  -  -    - ---   -   - - -       -   -
- --     - -            - -  - -  - -  -  -    -   -  -           -         -- - --   -    - - --  -
---      -   - -     -      -   -        -           -- -     ---    -          - ---- -  --       -
-  -   -    -    -          - --  ---      -        - ----     -    -                -- ---   - - --
--- -  -  --    -- -  -     -         - -    -  - -  -     ---    - - - -  -       -- - -  -    -  -
-  -   -  -  -- -- - - - -  - ----      -   --   - -  --  --   - -   -  - -    -    -- - -       - -
-  -   - --  -   - - - -      -       -        - -   - -  - - -       --   - --  - - - - -----   ---
-      -   -     - -     -  --- - --    -    --  - -  -    -  -    -- -   -       --  -            -
- -   -      -- -   -   -  -                 -  -                -     -   -  -   - - -     -  -  --
-    --     -  ----  - -   --  -    -  --      - -   - - -     -      -- --     -      - -  --   ---
-- -- - -  -        --    ---   - -      - -     -- -      ---- --         -- - -- -  --  -   --  --
-  -   -- -   -  -  -  -      ----   -    --    -  -  -  -   -  - --  - -     - -   -   -- --      -
- - -    -         -- -     -                -       -- -     -  - - -  - ---  -- -   -      -  -  -
- - - --     --  -  -- - -   -- --   - - - -     -   -  -    -  - --  --     --                    -
- -   -         - -        -     -- -        - -   -  --  -    --       - - -      --   - -- ----- -
-- --- -- -  -       -     -  -      - -     - -       - -  - -      --  - -  --- -             -  -
-- -      ---   - --   -- -  -   - -     - - - -- -    - -        - -       - --        - -   -    -
-      -       -  - -       -      -      --   - -        -  - -  - - - -    --   - -    - -    -- -
- --  -     - -  - - -  -     -      - -   - - - -  --   -        - --- -      -     -   -      - --
- - -  -- --- -   --   -  -      -- -   --    - -  - --      - -- -- - ---  - -       --        -  -
-    --  -  --  - -      - -   -- - -  -   -  --- -         -   ---- -  -  -            -   -      -
-- -    --     - -     -      -      --    -     -    - -   ---       ---     -    - - -  --  -  - -
- - --         -    -   -  -   -  - -  --    - - -        -  -  --- -      --- -    - -      - - - -
--       - -   -   -- -  -  --- -    -  --- -    --  - -- -- --                     - -   -    - - -
-  -- - -   -     --  -  --     -  -- -    -- - -     -   - - ---   -      -        - - -    --  - -
- - -- -- -  --    - --- -   -- - - - - -     - --  -  -    -        - - -     -    -  -    -  -   -
- --  - -- -   - ---  - -   -   --        - - --     -  - -- -   -    -     -   -      - --   - ----
- --  -        -   -  --       - - - - -  -  -       --   -   - - -   --   -     -   -     --  -   -
-    -    -- -      - -- -   -   -   --           - -  -      -- - ------  -       -     -  - - -  -
-     - -    --        - -   - ----- -  --     --  -        --  -   - --  -- -     -  -   -   - -  -
-        --     -- -  -  -- - -    --       --          -      -- -           - -    -    - -      -
-  -- - -     -  - ---        -- -     --      ---           -     -- -   -      - -      -   -  - -
----------------------------------------------------------------------------------------------------
