100
100
----------------------------------------------------------------------------------------------------
-        -      -  -    -  -     -         -  -   --     -  --        - -    - -  --  -- -  - --   -
---     -   - - --- - ----- -       - ---           ---  -    --    -   -  -- -        -       -   -
-       -   --       -       -  --- - - - -- - - -  -     -  - -- ---- -  -  --    ---    -   -- - -
-     -- - -   -  -   --   -       -       -       --  --  --  -  -        -- -   --   -- - -   -  -
-     - - -   -   - -             -  -   -      -         -   - -- -- -   -     -     -  -   - --  -
----   -- --    - -  --   ---  -   --  -   --  - - -               -  --    ---  -   -- - - - -    -
-   --      -     -- -      --   --  - -    - -- -   -       -   -  -----  -     -  -  - -       - -
- -  -- ---   --   -  -- -      -   --    - - -  -- -    -  -     - --  -  - - -    - -- --      ---
---- - - -   -  --- - -  - -  -  ---  -  - -    -    - -     - -  -   - -   - -   --  -  -   ---   -
---- - -      -    - -  -      - - --- - -                 - -  -   - - -- -  -  --   -  -  -   ----
-     --   --   -            -    -- - -       -           --    -     - ----  --- -   -  -  --    -
-   -     -      - --  -- ---          --    - --    -  --   - - -   -  -     -   - --    -   -   --
- - --   -  -  --      - -      --  - -   -      -    ----  -         -    -       - -  -       - --
- -      --        -    -   -           -  - -   -  --  -  -   -- -    --        -    -     -      -
-             -  -   - - -   ----- ---     - -    -    -  -   - - --   - -- - -       -----   -   --
- - -     -   -- - -       -   - - -  - -  --  -- -- -       - -        - - -    -        -    - - -
- -    -  - -  --  -  -      -   -  - -  - -   -        - -        -    - ---- - -  -   - - --  - --
- -- -         - -     -  - -        -  -  -  - -    -       - -   -  --     --         -     -    -
-      - - - --    -     -   -         -     -- -       ----    -    -          -   --    - -    - -
- -          -  - - - --- -   --         -        -    - --  ----  -- -  --  ---        -  -  --   -
-  -   - -  --     --  - -   -     -   -    - --    --   --         - - -      -   -       -    - --
-        -        - --  - -    -     --   -  - -    -   -   -----  -   -  -     -  -  -  - -   - - -
-- --  -- ----      -- -- - --  - - --     -   -     --- -- -    -    - -   - -  -  -  -  -    -   -
-  -  - --    - - - - -        -      -     -- -  -    -  --  ----  -       -   -       -  - -   - -
-   -- --     -       - - -  - -- -     - -- - -  -  -  --    - -  -   -           - --     ---   --
-  - -    --     -- ---   -  --  --  - --   -- - -   --   --   -   -         -  -  -     -      - --
- - - -     -- - - -      - -  -- -   - - -     -  - -      -   -   -   - -   --- - -        --    -
-     -  -     - -     -  - -  ---    - --   -  -- -  - -  --   - -     -  -  --  -  --   - -    - -
-   - -    - --   --     -   -          - -         ---    -  - --  - -- -   -   - -  -     -- -  --
-   -    -  -  -         -       - - --   -   -     --  -   ---      -      -    - - -  -      - - -
--- -   ---  - -   -  -    - --  - - -  - - -- - --   -            -  --  - -    -      - --  -  - -
- -   ---   -  --  -  -  --     -      - - - - - -  --      --                --          -    --  -
-  -  -     -  - ----  --         -      --     -     - -  -   - -  -     -   --        --     -   -
-  --   -  - - -   - --  -      - -            -    -   --  --  - -- -  ---         - -     - --   -
-        -       --- - - ---     -   - -- --    -   -     - - -- --    --  ---    -- ---   --- -  --
-- ---- -    -    -   -  -     -  --   -  -  - -      -         ---   - -    - -        -     -    -
-       --    -  -  -   -   - -  --           -  - -- -     --    -    -  --   - - -  --    -     --
-  -- - -   -   -  - --      -  ---    -  -    -  -   -   -     -  -  - - -   - -     -  -    -    -
-- -  -- -- -   - --    -   -  --      - --    - -  - - --   --  --        -        - --           -
--   -    --  - -  -- - - -    --- -  -  -- - -     - -  - -       - -   -  - --   -   -- -  -   ---
- - - -    -     - -- - --     -- --       --  - -      -- -  -  --    -    -        -    ---  - - -
-  -  -   -   --       -    --  -  - -  -         - - -  - - -     --        - - -   -    -   -  - -
-       - -          --  ---  -  -  -   --       - --  -   - -   -     -  --  ---       -   --    --
- -- - -- --  -      --     -  - - -  -- - -  - -         -   -   --- -        - -- --- -- -       -
-----  -    -      --  -    --  -- -   --   --  -   -  - -          --       --      --   - -   - --
-   --        -     -       - --  -   -      -    --  -    - -   --    -   --  -   --    ---       -
-  -  -  -  -  --         --   --  - -  -   ---  -   -   - -  --  -  - - - -         ---- -    -  --
--   -  -  -   -   ---   -  - -      --  - -   - --    --  ---  --        -   - -  -      -- -  ----
-- -  - -    -   - -  -- -   - -   -   -  - -         ---          --      -- --     - -- -- -   - -
-  -- ---    - -     --     - -  - -- - -     ---  ---    --- - -      --       -  - -   -- - --  --
- -       -    -- -   -    -  - -  -  -  --   -- --        - - - -   -- -  ---    -- -    -   --   -
-   --  -  -   -    -      - -   -    -      -    -      -     -   - -- -        -     --  -- --   -
-  -      -      --       -  -    -- -     -  - -     -     -     --       --     ----    -  -   - -
- -   -  -  -  --   -  - -     --- -  - - -  -            - -  -   --- -   --- - -    -  -   -     -
- -   --- ---  -    -   --  -    - - - -- -- - - - -  --    -   -    -         - -  -  -      - -  -
-- -    - -    - -   -     --      --  - -    -   -    -  - ---    -       ---   -  - -- -     -  --
-      -  ---- - --    -    --   -   -    -     - - -- -- - -   -  -  - -   -   -   - -     - - -  -
- -      --   -      -  --- - --  - -   -      -    -     -           --   - -               -   - -
-      --   -   -    - -     - --  -  -  -  -  -       -  ---     -        -      ------  --  --   -
-     -- --      -   -           ---  -  -  -   -   -    - -  --  -  - ---   -  -     -  -  - -  - -
-  --  --     --    -  -    - --      - - --  -   -  - -- -- -   -   -    --  - -- -     - -   -   -
-     -     -         --  --  -   -    - -    -   - -- -     --           -- -       --     --  -- -
-     -  -  -  ---  -   -         ---   -  - -   - -  -            --          -       - -  -  --  -
-      - - -  - - - - ---   -       - -- --    -     ---        --   ---    - - -   -        --   --
- -   - -       -  -  -- -- -  -- - --     - - --   -     -        -   -      --       - --- - --  -
- -   --  ----     -       --  - -      --          - -- --  -     -     - --- - - -  -      - --  -
- -     --    --   -      --   -  -        - --     -    --    ---    --   - -   --- -   -  -- --  -
--  -    --  -   - -          -    -    -  -- -- ---  -    - - --- -       --        -    -    -   -
--- -  -     -  -  -    -   -- --  -       - -   -  -     - -    --   --- -    - -    - --- -    - -
-- -    -     --            -    - -    -  -      --- -  -   --            --    - - -    -    --  -
--   ---  -  -- -    -     - - -       -- -- - -     -          -    - -- -   -      - --  -      --
-  - -  -   - --       -  -  -  --       -  -  - -       -    -  ---             -- - -  -  --  - --
-  - --   -   - --    --       - --       --     - - -  -      -  -  - -       --  -   -- -   -  - -
--  -  - ---       -            - - -   - --  -  -  -    -     -   --  - -   -- --  ----    -   -  -
--  - --     --- -- -   - -  - - - -  - -  - - -           -  -  --   -        -   -      -     -  -
- - ---  - -   --  -  - -         -  -- -- -  -- --  --       -- - -   --        -   - -- -   -    -
-    --  -  -- - -     - -      -  -  -         -  -     -     - -   --  -- -      -   -           -
-  -- --         -   - -   -- --- -  -      - -   - --  - - -  --     -  - ---  --- --   -  --     -
--     -      - -   - - -  - -- -- ---  -   --             -      -     --   -      -  -- -  -  -  -
-   -    --   - -  -  - - - -       - --   --    -     ---  -    - --  -  - -  -    -  -  -        -
-        -  -   -         -     -       --          -    -  -    -    ---  - --  -      -  - ----  -
- - -     -   --  --   -       -  -   -  --    - - -- --         -             -- --     -  - -    -
- - -    - --   -  -      -     -  -            - -     --   --    -   -   - -    ------ ---   -   -
- -   --- - -  - -      -  - - -   -   -    --        - -       -    --    -    -        --   - -  -
- - -  -  -  -   --   -   -  - -   -     --   -  -  - -    --   -        -  --   -            ---  -
--      -   -    - - -   - - -- -    ---  -       - -    -  - -   - -   -  -            -- --    ---
-             -  -   -     -   -   --  --- -  -  - - -     -    -    -  - - -       - -     - ---  -
-  -    -- -    - -    --     -    - -      - -      --  -    -    -     - --   -  -  -- -    - -  -
-   ---- -      -  -- - -- - -   - -     --      ---      --   -- --    -    ---   - -   - -   - ---
--       -           - -   --- --   --  -           - --  -- -           --  - - --           - - --
- - --   --        - -  --     -  -       --      -  - -               -      -  - - --  - ---     -
- - -- - -     -    -    - --   - -  - -  - - -    -  -   --- - --    - - - -                 - - --
-       -   -    --  -  - -   - --        -   - -           -         - -     -              -     -
--   --  -  - - -   - -   ---  --   -- -       -   -    -  -    -      -     --   --          - -  -
-  -- - --- --    -     -     -  -  - - -       -      --        -  - - - -  -   - -  - -          -
-   - -  ---   - -    - - -   -    --    -     -  - -      --     -   - - -- -    --     - --- - - -
-      -    -  -     -- --     -    -      -      --    --    -         -    -       ----- - --   --
-     -    -                   - -         -   -     -   - --    -  -       -  - - -          - -  -
----------------------------------------------------------------------------------------------------
