100
100
----------------------------------------------------------------------------------------------------
-                      -  --      -      -            - -  -  - -    -- - --                  -    -
-  - -    - -    -  ---       -     --  -  -   -      -    -      - -       --     ----   - -   - --
-             - -  - -  - --     -    -- -   -       -  - -    - -   - ---   -   -    -   - -   -  -
-  ---      -  -- -- - -    -----  -    -  -                -  -   - -   -- -- -   -- -         -  -
-     -    - - -    --  -        -  - -  --- - -         -- - -   --  - -- - - - -   -   -  ---  - -
-        --  -   -     - ---   --   -           -     --   -   -      -   -        -      -    -   -
--     -      --      -- -  --  - - --   -- -    --   - --- - --        --- - -  -  --   --        -
- -         --  -        -        --   -   -  ---- - - -    - -- - -     -  -    -  --    -        -
- - -  - -- -      -           - -- --- --    -        -    - -   -   -    --       - -  -  -  --  -
-       -  -      - -       - -   --     -- -- -  -         --  --  --- - -  - ---- --     -  -  - -
-         -- -- -- ---  ---      - -   --- - - -    --- -            - -      -       -     -  -- --
- -  - - -     -    - ---      --   -            --     - ---  -- ---- -- - ----   --  -- -   -   --
-  - -   - -           - -       -   -  --  -- --        - - -    -      - -        -         -    -
- - - - -- -- -   -- -  --  -    - -     - -     --      --   - - - -   --  ------     --  -  ---  -
-   --    -    -       --  -- --   -  -  - --  -   -  --   -   -    - -     -       - --    -- -   -
-  -  -   --   -   -  -    -  -  -  -      --    -- -- --   -- - - - -   -   -  -   -  -- -  - -  --
-- --- -- - -   -  -    - ---     -  ---  -       - - -                  --- - --  - -  -    -  -- -
- -   - -     -- - -    -   -       - - -      -     -   - -- -       -- --       - -     --       -
---- -- -  -       -    -   - -    -  -         --  ---- --    - - - - - -    ----  - --  -  -   - -
--  -  -- - -   - -   -      - -  -    -       -    -- - -        - -  -      - ---    -     --    -
--     - - -  -    -    -     - - - -       -- ---   -   -      -     -    - -   --     -- - - -   -
- -   - -       -           - -  -      - - -  --- -      ---    -   -- ---    --  ---- -- --    - -
-   -   - -    - - -    - -    - -      -      --    - ---       - -   -  - - - -    - - -     -   -
- -   -   -  -    - - -      -   - --   --  - -     -- -     -     - - -- -     -    - -      -  - -
-      -       -   --- ----     --  -                   - -     --  --    --  -       - -- -       -
- -  - -  -     -  - -        --- -     -   - -  - - -        --      ----- --     -     -     -- --
-  -- -- - -     -   -    - - -- -  -   -  -         --         -- -       --   - -  - --   - -    -
--  --    - --        -  -  ---  - - -- -   --    - -  - - - --  - -  ----- - -  -  -  -  -  -     -
-           -     ---    -     - --   -   -          -    --      --         ----       -   -     --
-   --  ----  -            -     -           --    --  --    -  - --   - --- - -  - -    --    -   -
- -   - -    -      - -  -  - -     -    -   -- -  --      -  -      -  -               -  -      --
-   - -- - --   - - - - --  - --  --   - -    --   - --     - -   ---  --     -  - -- -     - --  --
--   -   ---- -   -   -      -    -     ---  - --       -     -  -   -   --    -     -    - -      -
-    -- -    -  --  --- -    -  - -   -  -    -   - --   - - -    - -   --   -       --- -  - -- - -
-  -    -  ----  - -    -    -    -    - -      - -   -     -  --   -        -    -    - --     -- -
--  --                   -  - --   ---   -  -  --  -     -- ---       - --    --   - -  -     -   --
-  -       - ---    - --  - --          -- -    - -  --   - -   - -        -   - --    -  - - - -  -
-    -- - -        --    -     - -      -- - -    -   -             -  --  -  - --- ---   -      - -
-  -          -  -   --------     --  --   --- -   -    -   - - ---  --- -     -    -  -  -  - --- -
-         --   -  -      --     ---  -    --  - -   --      --          --  -- --    - -- - -   - --
--    - -    -  -      -    -- -    -          -  - --      -                --   -         - ---  -
--         -   ---  - -           --  -- -   - -      ---   -    -   -  -   - --  --  --    --   - -
- -    - -          -    -  --  -   - - -          - -    -- - -     -   -    -  -      - -    -   -
--     --    -     --      -   - - - - -  ----   -   ---            -  -     - --  - --  --- -  - --
- --  --    -   - -     - -- -      --    - --  -   -     - - -     -      -    -- -   --       -  -
- -   - -    -- --             -         -  - -- --  - --   -   -    -       -      -  -  -      - -
-   -- -- -      -  ---       -  - -         -      ---         -  -       - ---      -    --   -  -
-    -     - --  -  -        -   -   -  -    --  --  -  -   - -  -  - --  - -  -   - -   -- -  --- -
-   --   -      -    -         --       - - - - -  -      -   --  -   -     --     ---  -    -  ----
--        -  ---  -    -   - ---        --    - --     -    -       -      - -- -     -   -  --    -
-  ---  -- ---  - - - - - -- -   ----- - --   - - - - --   --   -       --  -   -       -  --  -   -
- -          -  -- - - -- -   -        --    -  -       --        -       -   -- --  -    -        -
- -  -  ---   -        -  -- - -   -  -  -- -  -- -    ---  ---  -   -    --  - -  - - -    -    - -
-    --    --  --            -- -  -  -     --- -          -       -   --- - -  - -      - - -   ---
- ---      -      -   --    - -            -    -    -    - --- --  -    -    -    -        -  --- -
-  -- --    --  -   --        - -      --  -       -- --   -       -   - - --- -  -          - -- --
- -   -  --          -      -- ---           -- --   -- -  -  --    -    --   - - --   --        - -
-   -  --   --   ---   - ---  -   -- --    --    -      -   - - - - -            -  ---         -  -
-  --   - -         - - --   --      -  --     --  -- - --   -   -   - - -     -  -   -  - -- -- ---
-- -     --   --  --   -  -  -  --      -  -  -  -  - --   -    -   -   -  - -     ---- -  ---     -
- -  -    -  -      -- - -  - -   --- -   -   - -  -      -  --- - -  -  - - --    -   -  --   -----
-     ---      --  -  -        ---      --  - - -    --    -     - -  -- --         - -  -- ----   -
-    --  -  -   -   -    --    -- --- -   --  -   -   - -   -  -  -        ----    -   -     -  ----
- ---  --  --          -    ---  - -    -  - -- - -- -- -       -    --  - --  -                 ---
-    - --        -        -       -  - --      - -   -- -   -     - - -   -     -     -      -   - -
-          -- -  - -       -     - -     - -  -- -    - -    - -- - --   -  -- --      ---- --     -
- -   --   - - -  --      -       -  -  - -       -           - -- -    -  --               - -- - -
--   -  -  - -   - -          -  - -    - --         --  - - -     -   -     -----     - -   -   - -
-  -- -   -     -      -   -     - --  -      -  -     ---   -- -- --    - -    - -  -- - ----- - --
-           -  -  -       - -    - - -   -- -    -     -   -  -    --  - -    -    - --       - -  -
-         -   -       -                 -         -  -   -     -  --      - --- - - -- - -   --    -
- ---      ---- - -  -    - -   -  -     - - -  -     -   - -    --   --   -       --  -  --    -  -
-   -  -   - -     -  -        -   -   -    -   -    -  - - - -- - -  - -   -------    --      - - -
- -  -  -      -  -  -  -    - -    -   -  - -  - - --       --   - -          -      - --    --   -
-        -     -  - -  --      -    --  --  -   -   --          -- --     - -      -- -   --       -
-  -       - -        -  -  -- - -           ---       --  -- -         -     - -        -  --     -
--      -  --   -   -        - --     - -     -- - -          --  -       - - -  - -     --     - --
- -   -- -- - - -   ---   --- - --    - - -   -   -   -    ----  - - -        -        - -  -   -  -
-- - --       -- - -     ---- -  -    - - - -   - -       -   - ---   - -----    ---    - --  --   -
- --     -  -   -   -  - -        --     --  -      - - -           -  - -      -      - -  --  - --
-  -  -   -    ---  ---- -     --        - -        -  --  - -    - -       --       -        -    -
- -  --   -  -   --          -    -- -     --  ---  - - - --  -   -- -  -  -- - -    -       - -   -
-     -  --   --      -  --  - --  -  - - -  -    - ---   - ---   -  -           -       -   - -   -
- -  -- - - --         --  --    -       - --- -   -   - - - -- -  -   - -   --- ---- -  - -- -    -
-  -       --    -   -- -    --       --   - --   --  -  ----   --- -    -     -        - -   -   --
- -  - -  - -   ---     - - --   --- -  - -  -        -      --   -  -    - -  -    -            ---
- - -  -      - -   - --     -  -   - --  ---- ----     -  -  - - --    -         -  --  -   -     -
- -  -   -    --  --- -- ---   - -  -  --  - --  -   -    -       - --  -    - -       - -     -   -
- -  -   - -                  -          -  -----    -  -  -    -                     --  -        -
-  - - --  -  - ---   -    -    -  -   ---    -- -   -        -   -     -  --  -      - -   -     --
- -    -    -     - ---   --  - -   --      - --   -- - -- - -   -    -  -  --- -  --    - -       -
- - - - -   --  -    -- -   --  --    --  -   -  --   --     - - -  - -               --     - --- -
-  -   -    - -  --  -     --     --     --    -   --     -   -  - -  -- -- ---     - -    -- -   --
-     -  --    -     - - -         -  ---    -  --   -- -        -  - -       - - - - ---    -     -
-             -   --             - --    -         --  -   -    -   - -         -    -  -     - ----
-    ----  -- -           -   - -- --   -- - -- ---              ---  --   -   -           -     - -
--   -   ---- -       --       -  -   -       -  ---   --  -      -      --  - -  -- - -- --       -
- -           -     --     -   - -  -- -  - -- -     - -  -   -       -         -  -- -      -     -
----------------------------------------------------------------------------------------------------
