100
100
----------------------------------------------------------------------------------------------------
-                      -  - -    - -   -    - - - -                  -  -         -    - - --      -
-  --  - --      ----     - --  -   -    -- -   - -- - --  -   -- -     -              -  -      - -
-           - -   -   ---      -  - -  -     -  - -  - -      -           - - --      -            -
-  -  -   --  --   --- -------  - -  - - -  -  -    -        ---  -       -  -  ---- -   -    -  - -
-    -    - -     --          - - -    - -- - -  - -    --     -  - - --     - -     - -  - --     -
- - -- -- -- -       ---  -      -     -      - -   -    - -         --    -          - -   - ---  -
- -   - -      -  -- -- -    -- -   ---- --     ---- ---       --  --  -  -  - --   -    ---  -  - -
--    -  -- -    -  -    --    -   -    -  -        -    -     -  -  -- - -     -         - -    - -
-       --  ---      -   -  -  -     --   --     -  --  -   -       - -   -  -       --  -         -
-  -       -  -   ---     --     ---    -   -  -        -      - -                    -    - - --  -
-       --      -- -  -       -     ---  - -   - -   -  -        - - -- -   - -----     -          -
-             -  - - -          --     --       -  -  -    - -  -  --   -    -  -         -  -   ---
-   - -- -  --   -     -      -   -- --  -    -  -      -        -    -  --   -   - -  -     -   - -
-      - -- -    --  -      -   -   - -  - -   -   - -- -    ----    - - -  -  - -        -    - - -
- -  -  --   - -- - -  -  -  -  - -      ----- -     --   --     - -      --  -   -   -- -         -
-  -  -      -  -   - --- -     -- - - - - - - -- --   - -   -  --      -    -  - -   -- - - --- - -
- -  -   -     -  -     -  -- -  - -             - --    - -  - - - -        -     --     ---- -- --
-   -     -    -  -  - - -    --   -  - - -  ---  -    -      - - -- -            -  --        -  --
- -     -  - -  - - -  --- - -  -     -  -    -- -     ---   -  -- -  - -   -    -       ---- -    -
-     -  - -         -   - -- - -    -    - -  -  --  -   ---   -   - - - -      -  - - -      -   -
- - -        - - - -- -     ---  - --  -  --    -    -  -   -     --     -  -- -        -          -
-   -    -     -  -    -  -  --- -   -       -   -- - -   --    -   --   -      -    --  - --  -   -
- -  - - -- -       -     --- -   --  - -   -  -  --  -        --       - -           -  -   -     -
-   --      --- - -- -  -  -  - --  -       -   -    -- -  -  --    --   --     - - --- -   -   - --
-   ----  - -          - --      - -  -  --    -    - - -    - -  ---         - -      -- --       -
-  --   - --  ---     -- - -- --      --   - -        -    - -- -- -  -  --- - -  --      -- - - - -
---   -- - -        -   --   -     - -  - -  -  -    -    -    --  - -   -  --  --   ---     -   - -
-          -       --    -           - - - --      -   -   --      - -    -    -- -     -  ---     -
-  -- --         -  -- -    -  --      -    -     -    -  --          - --    -  -- -   -     -  - -
- - -    -    -  -- -     -      - - -           - -    --   - -   -    -    - -   -       -    -- -
-     -       -    -    - --          - -- -  -        -  -       -    -  -- --         -   - -    -
-- ---  - -     --  -      ---   -  -    -  - -- - -            ----   - - -  -       -- -    - - --
- -   -- -  - - -  - -  - -   ---- -      -  -   - -  ---    -       -   - ----    -- --    -  -   -
- - -         --   - - -    --      -  --   ---- -   -        - -   -- -     - --        -   - -   -
- -  -   - - -- -   -    -     -- - -  -  - -     --- - -     -      --- -    -      -  -  -       -
---   -    -  - - - -  -   - -   - - -   -- -  ---      --  -      --   - --    -    -   -- --    --
-    -  - -   -  -   -   -    -    - -            -                 ---   --      - - -    -   - - -
--- --- -           -    -       ---     - --   -   - -   - -   -- -  -    -    - -    -  -  -  -  -
-         -- --     --   -  --  -   - - -  - -  -  -  ----    -     -- ---   -        -      -  - --
-   -  - - -    - -   -    -   -    - --  -  - - - -    -- --- - -   - - - - ----    - --     -- - -
-        -  -     -     - - ----   --   - -- -  -     -         --- -      - - - -     -   -  -    -
--   - --  -     -  -   -   -  ---  --   - -   -   -----  -    -  -    - - --         -     -  -   -
-    -    -- -   -     -     - -  -    -- -       - -   -          -- - -  -       -    --      -  -
- - - -  -     - ---    ---  -  --  - -  -    -   -   -- --  --          -      --      -         --
-  -     --- --  -    -- -    -  - -   -    - -     -  - ---  -     - --    - ---   ---   -- -     -
- --    --- -     -  -    ---    - - -    --- -   -   -       -    - -      -      -  --- - -- --- -
-  -  - -   - --   -- - -  -        --- -       -   -- --   ---- -   - -- --       - - -  - -- -   -
-     - -       -  -         --       -  -- --- --  -  - -      - -- --- -      -                  -
-   --    -  -   - -  --- -  - -   -   -  - - - -  -   -  --- -          -   - -     - --  ---  -- -
--  - --    -  - --           - -  -  -  -     -    ---    -          - ---  - -   -   -    - -  - -
- -      - -       -  --   --       -    --      - -    -      -  --     -        --     --  -   - -
- -    -       -         -- -   -    -- -      ---  -  -   -  - -      - - - - -         -     - ---
--  - --  -   -    -- -       - -  -      - -  -  - -   -  -        -  - -        -        --      -
-  - - - - -  -- --     -       -   -     -    -    -    - - -- -    -  -   --- -  -       --   - --
-   -           --  - -   - ---     -   --   - ----  ---    -  -- - - -   -  --- - - - - --    - - -
-   -  -    ---   -     -        -       --  --          - -  -    -  -    --   --   - -   - -  -- -
- - - -        ---- - -- - -      - - -  - -   -  -  -   --  - -         -    --      -   -  - --  -
-  -  -  -- -    --- -   -  -    -     -- - - - --         ---   -- -  -  -- --      -  - - - - - --
-     - -      - - - --   --   --  - - -  -  -     -  - - --     -         -  -   -  - -     --  - -
-  --        --  -      --    - -  --- --   --       -  -   -- - -    ---    -        -  - -    -- -
-  --     - - - - -   -  ---    --- -   -       -   --          -- -       ---  -- -    - -   - -  -
-   -    --     - - -- --  - -     -  -- -  --- -- -           - - -     - --   -  - -       - - - -
-  -  --   - -    -     -          -     - -  -   - --     -  - -  -  - -- -  -       - -- - -    --
-    -   - - -  -   -   - -   -    - -   - - ---              - -    -   -   - -   -  -      --    -
-- -  -         - -   -        -   -    -             - -- -      -   -   ----       -    -       --
-     -  -    -  --   - -  -  - -    - - -   -    -   -     -   -       -   -    --     -      -----
-   --  -        -   -      -   -    -  -   -  -      -   -  - -  -           - -   -    -   -     -
- - --    - -- - -- - --  --  -         -   -   --      -    -     --- -    - -- --   - -  -  ---- -
-  - -         -       - -   - -    -     - -   -          -   -  - --     -- -   - - -  -    ---  -
-  -    -  -     -- -    -  - -  -     -  -   -           -   - -  -      - -     - - -   -  --    -
--  ----- - - ---   -  --     -- - --  -  --    - -- -   -   -   -    -- -   - - - --    - --  -  --
-              - - -  - -- -        - -  ----     -  -  - -    -   - - --     --   - -  - - -    - -
- -     - ---   --   -   -    ---  -         -      -   -    --       -   -   --         -   -     -
---      -      -    --- -  - -  -  --- - - - -  --  -    --      -  -   -  - - -   -  -    -   -- -
-   -  -   - --- - - - - - - --      -      -  -- - - -   -  -  -       -     --   -- -  --   - -  -
-    - -      -    - -  -      -- -  -  --    --      -   --  -   --   - ---    ----   -      -- - -
-   - -  -- -   -  - - -    --    -- - -   -       -       - - - -   - - -  -   - -  -- -  -   - - -
-  -- -      --         --    --    -   -    - - - -  -      -  ----   -       -              -    -
-- ---  --      -- - --   -    -             ---    - -      -       -   --  -  -  -     -      ----
- --   -  --- -            - -     ---  -  --       -   -  --  -  -  -     --- -  - -     --       -
---    -        -   ---  -       -      -    -     - - -  -    --    ----       -    -   -   ---  --
--  -  - ---- --    - -    -  --    -- - - -  -      -  -   -   - -          -    --    - --- -    -
-  - -  -     -       --         - - -     -     -  -    - -   --      ---   -- --                 -
-         - -    - --   -   - -     -  -  --  -    -     - - - -    -     - - --    - -   - - --  --
--      -       - -        -     -   --  - --  - -                            -   --  -    -   --  -
-   -     --- -  ---  -    -    ---   - --  - -  -   -   -  - -     - - -        -    ---- -    ----
-  -   - --     -    -  - --   -       -    -     ---    -   - -   --  -   - ---  --       -   -   -
- - -- -     -      ---            -- -    --- --   -- - --   - --- -      - - - --  -    -    - - -
- --  -   -- -   -    -  -   - -- -    -  -     ---            -   - --- -      - -     -- -      --
- -  -  -     -    ----       - -  -       -   - - -- -  -    -    --   - - ---   -    - -    -   --
-     -  --      -  -  -  - -  -  -    -   --  - -  - --- --- --      ---        -    -- -  - -   --
- - -         -       -   --               - --  -  -  -    -  - -  --   -  - ------- -   -  -     -
-   ---   - - --    -         -  - ---     -   - - -              -    --  -     --   - - -      - -
-       -       -    -  -     - -   --       -- - -     - -   - --  -- -  - --  -  ---  - - -      -
-   -- -  - -   --          - - -      -   - -   - -- -- -  -   -  -   --        -- -   - - - --  --
-   - -    -  -      -          -   - -   -  -  ---     -   -    --  - -  -  -    - --      -- -   -
- -    - -- --- -  --  -- -   - -  -  -- - -- -         -  -    -   -- - -     --  -- - - -  --  - -
-     - -  -   - -  - -   - - -     -          ---   --       - - --  -    -    - -   -   -        -
----------------------------------------------------------------------------------------------------
