100
100
----------------------------------------------------------------------------------------------------
-     ---                  -     - - -- - -    -   - -   -         -          -   -       --  -    -
-        -   --     -    -- --   - -          -    -     -  -  - -   -- -   -- -  - --       -- -  -
-     --  - -- -                 - - --   -     - -  -     -    -  ---          -  -        - -- ---
-  - -       ---- -  -       -           ---    -     -  --   -- - -    -    --     - - -          -
-  - -  -          -  --          -  -  - -      -          --   -        - - - -  --  - - -   --  -
-          - - ----  -   - --   -  --   -  -  -    -    -  -- -- -- --  -- -  -  - -  -      -     -
-- -  --    -      --     - -  --  -   -- -  -    - -    -  -  -  -     - - -   -    --       -- ---
-   -       - --  - - - -  -               -  - - -  - -- ----  --   -    - --   -  -  - -    -    -
--- --        -  - - - -    - -  --  -  -- -    --  - - - -  -   - -    --     --       -          -
-     -  - -    - - -      - --- -            --    -    - ---  --   -  - -  -         -  --  -   --
-    -- -           - -      -- -     -  -  - -   - ---  -    --   -- -        --   -   --    - - --
-    -    -     -    -- --  - - -  -    -- - -- -   - -      - -        -- -   -  -   - --  - -    -
-           -  - -    -   -      -   -   - -    - - - -              -     ---  --    -   - - -- - -
- -   -   - -  --- -      ----- -- ---    - - -  --- -   -  -  -   -  -   -------  - -   -- ---- - -
-   -     --   -   -         -    -      -     - -   - -     - - -- -  -    --   - - ---    -  -  --
-  --        --  - --   -- -        - - --    -      - --     -      -      - - -   -   --         -
-    --   -  - -  -   --   -- - - -    - - -  --               - -  -  --     - -    --    --    - -
--   -  ---- -- -      -    -- -      - -       -         - -   -  -  -   - --      -              -
- -    -  - -  -   -          -  ---      - -               -    -  -       - ---  -  -    -    -  -
- -    -    -   -       -  --          ---  - -   - -  -  -- -   -   --     - -     -- --  -  -    -
-    -       - -- - -   - --- - -    - -  -       -  -  -       - --   --       --- --       - --  -
-    - --  - --      -- -  - -- -   -- -   - -  -     --  -    -              - -     --  --    -- -
--  - -       --   -  -- -  -   -    -          --- -   --  --    --        - - -  -      -        -
--    -     -- -    -       - -    -     -- -        - --     - -      -   -  --   -      -- -  - --
---        -  - - -   ----     -  - -   -  -  -       -  --  - -   -  -      -   -    -         -  -
- -   -    - - -     -  - -   -    -- -     -       -  -     -           - --  - -   ------   - -  -
-   --  -  -  -           --   --            -  -- -- -  - -     --  -                      -      -
- --  - - - -    - - ---   ---   -       - -- ---   --     - - -    -  --- --     -  - -   -- -    -
-- - ---       -      ----- -- --  -- -     --   -    - -     - -    ---   - -  -   -        -     -
-  - -  -  - -    -        -  --  -       -      -    -         -   --  -  - - -    -       -   -  -
- -   - --  -   -   -   -  --        -    - --     -  --  -    -  -   --- ---    -- - -  --        -
-   - -   -  -      -    - - --     -  --  -  --    --   -- -   - ---  -    -  -        -  -   -- --
-     -     -    -   -- - -- -  --         - -  --      -  -              -- -      -  ---  -  -  --
-- ---    - -  -     -      --      ---  -     -    - --  -     --   --          - - -  - - -- -   -
- --  -      -     -    -     -- - -   - -       -  -    -  - -  --   --   --  -         ---- -   --
-     -  -   - -          -    -  -  --        -- -  ----    -       -        -- -     -     --    -
---     -  -- --   - -  ---  - -    --  --   --  -       ----    ---     -                         -
--   -   -  -         -- -    --  --   - -    -- -  - ---   -  -  - -    - --  - -        --       -
-  - ---    --     - - - --         -              -- - -  ----  ---    ----    - - -  - -    -   --
-   - -    -   -    -  -       -        -    - - -- -   - -    -          -    --   - -       -  ---
-- -        - -- -   -   -- - - -    - -        ----         - - -  -    -     - -  -        --    -
-- -    --          -  -  -  --  -  -- -   -- -        -      -     --      -        -    ---   - --
- -  -       ----     -    --  -        -    - - -- ---- --   -- -- --  --   --      - -  -  --    -
- - -- -  --      --- - - -  -- -     -   - -  --   --     -     -  - - -          -    -      -   -
-  -   - - -   - --     -- -    --  --  -- - - -    -  - - -  -  - -      -- - - - -  -     -  -   -
-- -   -  - -  --  -  --  -    - --         --  -      --       -   ----     -  -  - --  --- -     -
- - -  -   - - -     - - -    -  - ---  -     --- -   - - -   --         --   --- - --       - --  -
-     -- -   -     - - -  -     -         --       -    - -   -----     -----  -         ----   -  -
-- -  -   - - -  -     -   -  -    -  -  -   -  -           --  --   - -   ---    -  ---  -- -- - --
-  --   -----   -     - - -- - --   -    -     --     --       -  -   - -   - --     -         - - -
-- -   -   -  -  -  -- -   -  -  -  - --- -   - -- -    -   -- -    -          -  - -   -- --      -
-- -  ----   -   - --  -  -    -- -    --    --  -        -     -  --      ---          -   - --  --
-  -  ---  - -  - -   -    --     - - -- --    - -- -  - - ----         - - - -  -    - - --   --  -
--  -          - -   - -  -  - --   -   -           --  -     -  ------        -        -- -  -   --
-  --- -  - -     - --    ---   --  - --- -  --  -- - -    -- -                - --     - -        -
-     -     --  -     -   -      - - -   --    - -      - --   -   -- -       --  -  -  -     -   --
-   -   --          -- -     -  - -    -     ---  -  -     - -   --   - -- -- ---   - --   -    -- -
-  - - -        --         -- -   -- -    - - - - -    -   -  --     - -    - -      - -- -   -  - -
--   -  - - --   -   -   --   - - -   -  ---   -    --  -- -- -   -  - - --     --  -   -  - --    -
----  -      -     -- - -   -     - --   - - -  --- - -        --    - -       - -       -         -
-       - -  -    -   - --  - --       -   -   -      --     - -  - -    - ---   -  - ---  --- - - -
- - -  -   - - -    -- -  - - -        -  --     -  -    -   -    -   - - -     -  --   - - -      -
-    -       -   -    -   -    ----   - -  - - -- --   --   ---  -      -  -       -- -  --    -   -
- --    - --     -  --   - - - --  -  -  -    -  - - -   - -  -   -         - -- --        -      --
- -  --   -  -      --        -    --       -  -      -    - --  -      -   -       -- --   - -    -
-   -  --  --     -- --- - - - - ---    --             --  - -- -- -    --      --     --  --   ----
-    --  -   -            - -     - -  -   - - -- -   -  - -- -   -   --   -- -    --  --   --     -
-     -- -     -   -   -          - -      - --- -    - ----   --  - - ---     -       ---- -      -
-    -   - - - - -   -- -   ---  -  --- - - -     -        ---  -- -  -    --    - -         - -   -
-   -        - -  --          -  -     ----  -  -  -- -   - - ---  -     -  -        -       -  - --
-  --   -  -  -   -     - - --       -         - -  -  -- ---     -       -     -- --     --- --   -
-- -      - - --   -    -      --    -----        --     - - - ---         -    -       -     -    -
- - -    -    -           - - ---  -  -  - --  --    ----   -   -   -  -    -    -  -    --     - --
-        -  -   - -    ---  --    -            - ---    --  - -   -     -- - - - -                 -
--    - -       -  -     - -- ---    --  ----- -    --    - -       -  -  - -     --- -    - --   --
- -  - - --  -- -     -                           --   - - -  - -       -  -- - - -   -    -   - - -
- -   -  -  -    - -    -  -   -  - -    --   - -              -   - - -    -  -        -    -- - --
- -     -     -   -- - -   --     -     - -  - ----   ---    -  -- -  -     -- -- -        - -  -  -
-- -  -  --     --   -  --      -   ---- -  --       - --- --- - -           -         --          -
- --   - ---  --   - -    -   -- -  -     --  --     ---  -    - -     --  -  -- ---     -     - ---
-  --      -  -  -      -     -       -- - --    -     -     - -    --   -   - -   - --   -  -     -
-  -   --- -      -  -     -- - -  -  - -        --     -  -        --      --  -   ---   ----- -  -
-- -  --    - -   --- --  --  -   --  - -   -  - -    -    - - -  -    -     --       ----     -  --
-     - -   -  ---          - -  -          - -- -  - --        --  --- -      -- --      --  ---  -
- - -- -  - -- -   -    -    -    - -   -  - -     - - - - - --- -   -    - -  --   -- ---  -     --
--  -   -      - ---   - -- ---        - -       -          -  -       --- -- - - -    --   -  - - -
- -   -  -       -- ---   --  - - - -- ------ -    -       --  - --  -   -  -     -   --  -- -     -
- --    -     - -     - -   ---- -    -           - ---  -   - --              --      --   -      -
-     -- -  - -   -        --         --     ----- -  --        - ---  -- -- -   -     - -----     -
-  - -  --     - - -  -   --  -    - -     -     -          -       -       - ----- -       - -    -
-   - -  --- -    -    -   -         --   ----    -   -  -   ---  -- --     -   -    -- -     -    -
--  -  -  --  -  -    --    -  -           - -         -  - - -   - -    -   -    -          -  -- -
-      -       -       -- -  - -   - -  ---- --   - -      - -  --     --      -     - -  --   - - -
-      -   --   ---   - -             - -      - -          -    -  -    - -  -   - -     -  --  - -
-- -- -  - -          -- -         -   -  - -    - - -   - --  -- -   - --  -   -- - -  --   --   --
-  -     -   -     - -   - -    -  -- - - - --- --     -    - -             -   -     -   -    -   -
--  -   - -  -        -  - - -   -   -  -   - -   -  --       --  --   --       -          -  -    -
- -                 -  - - - - --     -   -     -        -       -  --  -   - -       -- -   --    -
----------------------------------------------------------------------------------------------------
