100
100
----------------------------------------------------------------------------------------------------
-   -  -  -    - - -    -- -- --          - -     -     -- -           - - -          - -   -  --  -
---  --             -   -       -   --  -- -   - - -  --      ---         -  -  - - --   --  - --- -
-           - -   -        -  -     - -  - -    - - -- - -  -   - - - --  -     -   -    -   - -  --
-    - ---  -     -  --- -  -    - - -  --     -    -  - - -         -   -     -  -   -   --  - -  -
- -   -    -    -  -           - - - -  -   -     -    -- -  --    - ---    -   - - -   - - -----  -
- - - -  -  - -   - -  -     - --   - --     - -- ---  -   -- -         -     --    -         -  - -
-    -- - -  --  ---  -   -- -   -    - -  - -    -    -       ---  -  -    -- -     -  --  -  -   -
--  -           - - -   -- -     -    -      --  - - -  --    -   - -    -  -  -  --  -- --   -  ---
-   - --  --  - --      -   --  - -  -  -    -  --     -   --     -       -    --- - - -    - -    -
-       -     -  - -- ----     - - -  -       -      ----  -     -  -     -        - -        -    -
- - - ----   -  -   --    -      -     -    -        -    -  -  - -   -     -        --- - - -  -  -
- -     -  -   -     - - - - --- -   --   -        -- -      ---- -  -   --    - -        - - -    -
-   -- -- -- -- -       -         ----  -   -   ---  - -   -     -  -   -        -    -      - -   -
- -  -    --     - ---       -- --    - --   --        -   -  -  -  - -  -      --  ---  - -    - --
-  - - - -     --- -    -  --   - - ---     -    -   -    ---   -     --    --   -      -    -    --
-  - -     -  -- -     -      - - -  - --       -     -            - -        -- - -    -  -  - - --
--    -   -   -  -- ---    - -    ---- - -        --     --     --   -----      -       --     -   -
-  -  -  --    - -    -    -            - -     -         ----  -      -   -   -  ----  -  -      --
-    -    -     -- -- -- -   - -    -  -- --   --  ---  --  -   -- -    - - -   -                - -
-   -     -          -   - -    -       --- --   --  -   -  --- -     - -   ---  --  - -     --    -
-- - --  - ---  ----- -    -  --   -  - -     -      - - -   -   -- - --   --      -      - -   -- -
-     - -      -    ----- -  -- --     -  -- -    --    --   - --            - -     -    - - --  --
-  - -  -      -- -  -   - - --      - -- - -- -    - - -        - -        -  -   -      -- - -   -
----   -         - -  -   - -    -             -  - -  - -   - -   - -             - ---      -   --
----  -   -              -- --  - -     -  -     --   -   --            -     -- ---         -  -  -
- ---  - -   - -    -- ---    -    -      --    - - -   --   --  --  --              -   -      -  -
-   -      - -     - --         - -    -       - -  -    --- ---    -     -   - -     -  -         -
-  - - -    -  -          --        -    --      --  - --   -   -  ---   - - -      --  - -  - --  -
- -- --     - -   - ---  -   -     - - -    -      -   -  ----  -        - -  - ---    -  ----  -  -
--   -     -   -  - -  --     - - - -- -    --  - -       -  - -     - -         -         ---   ---
- -        -   -- -  -  -        - - -- -     -     -  -   -       -        -- --  - - - -  --  -  -
-         --  -- - -       -   -     - -- -    - -- -    - -  -----  - - -  -   -- -    - -     ----
-  -   --        --      - --- - -   -    -   -     -       -     - -     -    - -    -           --
-    -            - -- --  -   - -  - - -  -   - - -  ---    -   --  -     - -      -    --  --    -
--  -   -  -   -  - - -    -  - ---    --   -    -   -     -  -  -- -   - - -   --  -    - - ---   -
-    -  -  -  -  - -   -            -   --         -   --        -   - -          -     -  - --   --
--   ----  -        - -      - -  - -           --    --      -  -   - - - - -           -    -    -
-  -  -   - --     - -    -  - - -    -  -  -     --       --  -  --   -        - -  -         -  --
- --   - -- -  -      -   -     --- --     -  -- -  ---   - - -  - - - -           --   --   -     -
-  -    -  -    -  --    -- -      - -     -      -- - - - -    - -      ---  -- --  - -    -  -- --
---  - -   -  --            --- -- - -  -  --   -  -      -  - -- -    -      -      -  - --       -
-  - - --        - -   -         -- -      -         --  - -   - -     -   -    --     - - -      --
- -  -      -         -       --     - - -     -      -   -   -  -- --    -   -     - -   -   ---  -
- - -  -      - - - - ---  -    -- -      - -    --    -- -      - -       -  -- -  -  -          --
-   -    -- - -    -- --      - - -- -- -  - -   - -  -     -  ---   ---        -   ---    -  --   -
--    - -    -  -     -    -- -  -     - - -    - --- -   --  --   -     - ---   - -           - - -
--  -  -  -  -- - -       - -      --  -   - -   -  -      -      - -  -  -     -        ---    -  -
-       - - --  --    -- - -  -  - -     -    ---     --     --      --     -  -  -    -       --  -
-          --  -   -  --     -  -- -  -- -   -  -  -    --        -  -      -- -  -   -   -  -   - -
- - ---  -  - - --    - - -   --- - -   -         - - -  -  -     -     - - - - -   --   - -  - -  -
- - -         - -   --    --    --     - --   -  -  -- -    - -   ---  -   -      --- - - -        -
-  -- --    - -    -      --  --- -----    -   --          -    -    -   -    --      -   -  --- ---
-   -      -    -     - --  --     -     -  -   -  -- -     -- -  -  -             -   - -  -      -
- --  -  - -  --   -  -       ----  - -     -  ---      -- -   -   - --  -  --  -     - --     - ---
-    -  -   - - -  -    -- - - -- - - ---    --        -- -- -     -  --  -   -    - -  -   - -- - -
-  -  --     - -  -  -    - - -   - --    -  - ---       -   --                -       - -  ---   --
-   -    -   -   -  - --      -- -  -     -   - - -    -  -    - - -    - -        - ---        - --
-     -    -     -     -    - -   -  - -   - -  - -  --    - -   -  - -    ----- --      --- -   - -
-             -   -  --         -  -   --   - - -- - -    --   --   - - --- -   - -            - - -
--   -  -     -  -    -      -       --  -   ---  -          -    - -     - - -       ----   --    -
-- -   -- - -        -      -   -      - - - -  - -     - -  - -- --  -  -  --   -    -    --      -
-  - -  -         -   -           -   -     - ---       -  - -   -- - -       -- -    - -      - - -
--    - -  -   - -  -      ----- --- -  -              -    -  -   -  --     ----      --- --  - - -
--    --     --    -   -         - -  --- --- -  - - - --  -  ---   -  --        - -     -      -- -
--  --          --     -   - - - - --- -  --   ---     -    - -      - -  -        -  -  - --- - - -
- --  -     -- -  -  -         - -- -        -  - -         --          - -  - -  -    --     - -  -
--- - ---  -  -   -  -   --    -      -       --    -   ---    -   -   -     --               -    -
- -    -  ---       -        ---- -  --  - - -   -   -  -    --   ---   -       - --     -  -  -- --
--         --              --  -     - -    -    -           - - -  -  - - - -  -    -    -        -
-    - --   -     -      - -  -           -  -       -  -  - -- -   - -   -- -      -  -    -    - -
--     -  ---    -    - -- --  - - -       -  - --    -       -  -      -  -   --- -       -   - - -
- ---  -      - -- -        -  -  - -- -      - -   -  - -  - -- - -   --  -   -        -- --- -   -
-    -  - -     -  -   --  -  -     - -     -   -     -     -   -  -- -  - --       -   --        --
- -   - -- -  -   -      -  -----   -  -    -- -  -     -- -  - --- -  -  -  -- --    -   -  - - - -
-        -   -      -     -    - - -     -             ---  ----  -     - --- -   - -      -  -    -
-  -   -  - -  - - -   -         -  - - -   -    ---  -  -       --    -   -- - - -- -  - -  -   - -
-   -- -     -  - - ---    - - - -   -          -   -  -   -  -        -       - - -        ----   -
-  --  -  - -       -  -         ----- -      -   -  -    -   ----       - -  --    - -  -   -   - -
-  --- - -    - -   -      ---     - -   -   -      -   -  - -   - -    -    -   -      -   - -    -
- -  -   -  -  - - -    -  -         - -   - -    -   -     --  --  --  - -       --  -            -
-- - ---   - - -      - - ---   --  - --   -   -   -     --   -  -   --  -     --     -   -      - -
-      --      - --  -  - -                -- ----      -     - - - -    - -     ----  - -  -    - -
-   - -   -- - - -  -     - -    -   - -   ---        -  --  -      -  -    -- - ------    -     - -
- - -  - -   - -  -    - -  -   --- -  - -   -- --  -  --       - -- -  -    - - -  -  -   -       -
-- -   - - -         ----  -  -  -  - -- -  -  -              -  -- -  -  ---  -- -  -     - -  -  -
-  - - -    - --        -  -             -  - --    -  ---   -      - -    - -  -    - - -     -   -
-  - -   - -    --    -    -  ---      --    - - -  -  -  --    - -     - -  - - - - --   -  -     -
-      -   - --   -- -  -        ---  --     -      -    -- -   --    -    -        -   - - --   - -
-     -     -       - -- - - -            -- -  -      -    -    --     - -- --   - -      -   - - -
-  --         -  -     ----  - -   ----  -   -      - - - -   -   -- - ---     - -  -   --     - - -
- -   -- -    - -   --   -   -             -     -   ----        -         -- -  -    -    ---   - -
--- - - -   -  ---   - --  -----  --    -    --   -  -     -   - --  - -     -    -   - - --   - - -
-  -  --- -  -  -      - -  -  - -    -   -- -- - ---   -      - -   --     -    - --          -   -
-   - -   - - ---- --  -  -- - -    -- --  --- -   -  -  --  -    ---- -      -- -  --     --     --
-- --  --  -      -   - -     - -- -- -- -   ---   -  -   -   -             -   --   - -  -   --   -
-- -   --    -      --   -- --   --     --  - -  --- -   - - ---- --   -- -    - -          - -   --
--      -   - -   - -      -          -   -    --   - -   -       -   -    --- ---  -    -   - -   -
-  -- -     -  -       -         -    - - - -            -       -            - - -   --  -  -   - -
----------------------------------------------------------------------------------------------------
