100
100
----------------------------------------------------------------------------------------------------
-   - - -- - -    - -        -    -     -  - --           -     -   -        -    - - -       --   -
-  -       -    - -- -   -   -     -  - -   - - - -    -   -    - ----  --  --    -   -           --
-    -   -       -  -  -  - -  -  --- -     --  -   -    -        -     --- -  --   -  --- -  --   -
-   - -   - -- -   -   -   -    -- - - - ---       -   - ---     -- ---  --     -   --        --  --
- - -  -   -  - -- ---   -    -------      -  -       -         -     --    - --  -  ---   --      -
-   --        --     --             - - -   --  -  -   -- -     -- -     -               --   -  - -
-     --     -     ---    -       --  - - -   - -      -       -  -  --- -   ---    -    - --      -
-   -      -    -  -   -- - - - -    -- -       -   --   --- - -  -    - - -     -   -  -  - --  - -
---   - -        -  -    - - -- - - -  -   - - -            ---  - - -  -      -   -         -     -
-- - --   -- --  -- -  -  -      -  -      - --              - -     - - -      -     -     - -    -
-   -  --  -       -    - --  -  --    -- - -  - -   --  - --- - - -      -          -   --      - -
- - -- -           -   - - -   -      -    -    -       -     --  --    -   -   - ---  --    --    -
--       -  --       -   --        - -   --       - - - -   --- --  - -    -- - --    --   - -   - -
- - - --   --   - - --- -      -        -    - -- -   -   -     -  --  -  - --  - -   - -- -     - -
- - --  -- -  - - -  ---  --    ---    --  - -              - -  --   -- - -   --   - - -  --   -- -
-   -    -     -   - -   - -  --   - -- - -   --        -  -  --  -- - -        -   - ---   -    - -
- -   -    - --       -    -    -  --   -  - -     -- - -         -- --   -    - -      - -- -  -  -
-  -  -    -  -- - --   -          --           ---  - -  - - --       -    -   -   - - -- -       -
-   -     - -      -- --- -    -    --  - --     -      --      -  - ---    -  -               - ---
- -  --  -- - -  -    -  -   -       - - - -    -   -        - ---      --  - --  -     -      - ---
--  ---  - -    ----   - -  -  --- -     -    - -    -    - -  --  -      - - -      -   - -       -
-- -     -     - --   -  -  -     - - --      -  -  -      - -     -    -       --  -        --    -
-  - -   -            -     - --- --        -  - -- -  -     -- -   -  ---  -      -            ----
-   -      -      --- -   -   -        -    ---    - --  -         --   -  -     --   -  -  -   -  -
-    -    -  -  -- -  -   -     - --   -          -- -- --- -  -   - - -  --    -  --  -  - -    - -
-- -    -  - -  -   - - - - -- -  -  ---- --   -- - --      --        -       --- -  -  -          -
-    ---    -     --- - -        -  -       -- - -  - -    -  -  ----  -   - -      -- --  -   - ---
- - -      -     --   --   -   --  -  -     - - - -     - -  --  - -     --- -   --       - -      -
- --   -    --  -  -   -      - -          ----  - -    -  -  -   -      - - - -   -     -         -
-   --     -     --  --    -    -  -- -          --      -- --  --  --    ---- -- --   -    --     -
- -      -   -  - - -         ---           -- - -   --     -     --- - - -  -   - - -- - -- - -- --
- -    -  --- --      -    --   -  -        -   -   -    --   -    -  --   ----       - ---- -   - -
--              --- -  --  -   -     --   -      -   -- -    --                     -  ----- --  - -
-    -     - - -      -  -     - -    --    -          --       --  -   -  -      -- --            -
- -   - --     ----- ------ -    --      - -   -    - - - -  ---    -     -  -- -   -        -   - -
- - --- -   -        -     - ---  - - -         -     -              -          -   -    -    -   --
- -           - ---  -    -     -      -     --  --           --         ----- --    --    -    -  -
--     ---    -     - - -  - - -    -- -   --- -   -  -  -  - --  - --     -            - -    -   -
-  -            ---       - -   -   -  -      - -  -     -   -        -  --  - ----     --  -   - --
-   - -     -   -      - --    -        -- -  -     - -  --  - - ---- - - --       -  -   -    --  -
-     -   -  -   --- -  - -  -   --   -----  -   --  - -       - -- - - - ---      - -   ---     - -
-   ---    --  -  --  -       -   -  -   -  -- -     -   -   -                --   -   -        -  -
-  -   --- -   -    -  -- - -- -  -   ---  -  - -- -      --          -  -       - -               -
-   -   -      -   - - - -     --- -    -   -       -   --   -    -  -  -     -    -          -    -
-   ----  - -- --  -- - -- --     -     - -    --     --     -   -  --    - - -  ---  --         - -
- -    --        -- --   - -   -      --   - - -  - - - -  - -  -          -    - -    -  -  -     -
-     -  - -- -   --  -  --- - -       -  -- - --   -- - -    --  -   - -- -     -- --    -       --
- -    --- - -   -  -    --   -  - --      -   -- -  -         -   --  - - -   --   - - - -  -     -
-   --     - - -       --- - - -     -   -  -    -   - --    ----   - --      --    -    -     - - -
- ---  -- -    -- -        --  -   -    -  -   --   -  -  -              --       --    -  -       -
- -  -    -  -  - - -   -      -             -    ---  --   -     -    -     -- --   - --- -   -   -
--  ----  - -     - -  --           --  --- - -    -   -     -   -  -      --   - -  -       - --  -
-   -    -   --  --   -   ---   --- --     -   - -  -  - -   - --       -         -  --    -     - -
- -   - -   - -      - --   -         -      -- - - -  --  -- - -     -   -- -   -   -   -- --    --
--    - --    - ----        - - -  - -     -- - -- -  - -  -   -  -     -      -    -      -   -   -
-   -       -----  -  -   -   -  -    -     - - - - -     - - -     -  --  --  --  - --  -- -  -  --
--    - -- - -   -       - -   -    -  - - --      -    -- --  - -         -- -  --  -- - -  -  - --
-          -    - -  -   -     --    --- -- -   -       -   -  -  -     - - -      -- --        -  -
-    -  -- -          -  -        -    -  - --- - --     --    --    -     --    -- --  -   - -  ---
-      -      - - --      - -  - -  -      --  -- -- -- -     - -    -  -    - --  -         -     -
-    - --- -    --- --    -   -     -  -- -        - -  --  -  -   - -     -    - --   - --  -  - --
-  -  -  -   - -           -  -  -      -- --     -    -       --- -  - -   -    -   -      - -    -
--    ---- -- - -    --- -      -    - -   -               - ----     -  -  --       - - -      ----
-- -  -           -- -- - --- - -      - -  --     -   - -   -- -  -  - -    - -   --   -- --      -
-    -  -  --  - -  -          - - -     -  -  -- -          --  -    -  - - -  - -   -    - -     -
-     -  --    -  -    - -  -   -     --- -  --          - --  --  - -  -- -   -       --   --  -- -
-   -   - -- - - -   - -  -   -    -     - - -  - -  -  -    ---  --       - - -- - --  - --  - -  -
- - --   -     - -       -  --      -      -   - - - -   -----   - - -    -      -    -- -  -    ---
-       - -      -- - -       -     -     -   -  -    -        -- - - --  ---- --  -    -  - -     -
---   - -    -   -    --- --   -  - -             - - - -----    - -               - -  - -   - -  -
--- --   --  -  -- --  - - ----  - - - ---     -        -   -- -      - -  - -- -     - -   - - -  -
--- -    -   --       - -  -     -       -      - - -   -  -  -  -    -   -----      -        - -  -
-  -- -   --       ----  - ---  -  - -    -    -    - -   --       -     -    - ----   -      -  - -
--  -     --  -        -- ---             -   - -  -   --     --  --  -- - --- ---  --   - --  -  --
- -   - - - -- -      -           -  --      - - - -    ---    -  - -           -    -  -       -  -
-  -    - -      -  -            -    - --  -      -  -   -   -       - -   - - -       -      - - -
-  -  -     -    -- -- ---  --  - -  --     - -    -   - -  -                 - - - -  -  --   --  -
-  -- --  - -             -- -     --     -    -  -  - -     --     -    -- - --   - -  -    -     -
--   - - -  --  -  --    - -         - - - -- -  ---     -       -   - --   - -- --   --- -- - -- --
- - - -  --        - -  ---      - --     -   -  -   - - --    --      -  -  -       -        -- - -
- - - --   - --  --- --     - -   -   --- --     - -   --        -   -  -     -  -      - - ---  - -
-       --     -      -         -   -       - - -    --   -   -       -   -    - -  --- - - -   - --
- - -     -  - -  - - -       -  -   -   - --    - -  --- -    -- -- -    -   -  -  -   -  -       -
- -    -     - -  -  - -     -    -   -     ---  - --- -    -   - --- -      -  -   -   ---- -     -
-  -      - -- -- - - - -      - -  -  - -  -        - -  -   - -     -   -            -  -- -  -- -
-      - -  -   -        -  -       --   -     ----  -   -  ---  - -- --         -  - - -     -   --
- -         --  -       ---    - -- -        -  -    -     -   -   - -        --    -              -
-   -  - -- -- -  -                -    - -   -  -- - -- -- ---- - - -- -   -   -   -  --   - - -  -
-  - -    -   -      -   -  --- -    -- -  - - -  -   - - -    - -   - -- -- --            -  -    -
-  - -- --     - -      -    -  -  --    - - -  --  - - -       -  - --   -   ---       --- -  -   -
-     -      -   -          --   -   -     - - -  --  -  ---   -- -    --   --- -         - - -    -
- ----- -     -  -    - - - -   ---   - --   -- - -   -      --     - -  --  --    - --    -     - -
-  - - --   - --        -     - -  --  -   -   -         --          -        -   - -  ----      - -
-     -  -  --          -         -  -  -    -  -     -     -          -  -    - - -     - -    -- -
--  - --- -     -          -  -      ---     - - -  -      -      - -   --   -   -   ----          -
-- -   -   --- -       -   ----  -    - --  -   -       -  - -  - -  ---  -         - -  -     -  --
-  - -   -      ---    --           -     ----- -  -- -        -     --    -   --            - -   -
-   -     ----    - -     -- -        -  -            -        - -         - -    -    - - -- - -- -
----------------------------------------------------------------------------------------------------
