100
100
----------------------------------------------------------------------------------------------------
-       -      --    - -       -      -              --  - -      -- --  -   -  --   -     - -     -
--    -   -   -  -    -       - - ---    - - - -- -  -  - - ----- -     -  --- -   --    -  - - -- -
--     --    -     ---    --    -        -- --   -    -   --       - --          --    ---   -     -
-      - -     - - -      -   - - --          -     - -    -    --  - -     -- - -     -   --  - - -
-  -   -   - -   -  -       -- - ---        --    - -       -       -  ----  -   -        - --     -
-   -  -   - -  -  - - --       -      - -  - --     - -    --  -  -  -   -  --  -      ----  --  --
-        -  -  -    -       - -  ---    -  --        ---  -     -     - --  - -    - ---  -  -  -  -
-  -    -   - --  --  - --             - -     - - -       - --  -      -      --       -   -  -----
-  - - - --        --             ----   - -- --     - ---- -   --   -      -   - -  -  -  -  -    -
--     -- - -   -- -     - - --       -           - -    - --- --  -     -   - - -  -    -     --- -
-    - ---- - - -- ---      --  -  ---  -  - -          -   -         --     -  --- -      -   -  --
- - -   -         -    -  -   --   -     --    -- -  ---   -     -             - - -   -------  -- -
- --            - -  -  -     - -        - -     -  -    - - -        -   --    -  - -   - -  --   -
--   -     --    --    -    -     - -   -        -     -   - ---    -    -      -    -   - --- --  -
-        ---  --    --           -   -  -   -    - - -    - - -  -    - -     -   -  - -  -   -    -
-  -    -      -  -- --     --- -       - -        -  -- -  - --   -- -   ---    --  - --   -- --  -
-  -      -      --       - -   -   - -  - --      -       --- - - --  -  --      -     -----  --  -
-     --       -          -   -- --  - - -   - ----     -        -     - -   -    -  -    ---  -   -
-    -   -   -  - -    --       -   ---   - -     -   -   --  --   - -  - --    - -   --   -     - -
- - ---  -    -- -- -  - -  - -  -    - - -    - - ---  -     -        -- -      - -    -     - -  -
- -  -     -      - --    -      -  - - -    -      - - -  -   - -  - -    -   -    -- -  -- -  -  -
-   ---  - -  - - -  -     -   -  - -   -- -    -- --   -  -  -        -  -       - -   -   -  - - -
-     -  ---         -   -    -  -        - -   -      --   -  -    -           --     -    -      -
-    -  -        -      -    ---   -    - -  -    -   -   -  -   - --- -  --      - -  -  -  - -   -
-    - -- --   - -    -         -- -        - - - - -  - -  - - - -    - -  --     -     -  --- -  -
-    --- --        -   -      --        - --     -    - --  -- -               -  - - --    --     -
--  - -     --   - -  - --  - - -   -    - -       --      -    -     --   -- -  ---- - - -    --  -
- --- --- -  -         --       --      -    -   -  - --   -     - -  -  --    -      -- --    -   -
--        - -   -- --    --  - -   -    - -  - -  - --  -        -  -             - -      - -    --
- --            ---     --  -  - -- -   -  -    - --   - --     -    - - -    -   - - -- -  -    - -
-       -- -    -     -            -  -          - - --    ---       - -        -     -- - -- -    -
- ---- -     - - -   -     - - - ---  --     -  -       - - - - -   -     -         - -   -    -   -
- --     --    - -    - --    --               -    - -  --- -      - -  -    -  -   -  --   -     -
-      -- - - --  -  -    -     -          --     - - -   --     -   --   --- -  --    -- -       --
-  -- -    -  -         --  ---      --  -     --- ---       -  -- - -  -   ----    --  -- -       -
--  -  -  - -    -     -     -  -   - -    - --   ---       -  -  - - --  -- -        -  - -    - --
- ---     -           --  -   -- --   -- --  -   -   - -   -  - - -   -   -    -  -   --  -  --    -
-   -   -  -    --- -- -      --              -  - -   -  - --   ---     -  -- - -   -  --- -  - - -
-    -         -   -  -    --    --    - -- --  - -     -      ---  - -    -           -- - -   -  -
--  - -  - -  -    -  --     - -- -        -    - -    -  -            -       -  -       - -      -
-   -   - -  ---  -    --  -   --  -   --    --  -    -   -- -    -             -    - --  -  - -  -
-     -        - - - -  --        -   --  --     -   - --  --    -- -   - ---- - -  --- -          -
-       --   --  -   -- - --   ------     -         - -- -    - --  -      -      - -    -  -    ---
---  --  --    --   - --     -     --  --    -    -  --  -    -   -    - -- -- - - - - -      ---  -
-    -- -   ---         - -   - -- -    ---  -  -   -    --    - -- --- -      -        - --  -    -
- - -       -   -  -   - - --       ----   -  -   --   - - --   - -- -- --  -    - -   -    -   ----
-- -  -  - - - -  -   -   -  -  - --    - -  -  -   - -      --    -  - -    --- -  -  --       -  -
-  -     -- -  -       -  - --         -   - - -- - --   - - -              - -  - -    -   -- --- -
- -  -- - - -   --   -     -   -  ---  -  -  -  -  - - ----- - - - -- -  ---  -  --  -   -     --- -
-      --    -      - - -   ---     -  -    --  - -- ---          -       - ---- --  -        -    -
- -  -- -- -          - - -  -  -  -   -  -      - -    --- -        - -   - ---      -      -   - -
-  --     -  -    - -    -   -       -  -   - -   - -     -- -              -  - ---      -        -
- --   -- -     -    ---   - -  --  - -   - -  ---  -    -     -  - - - --     -     ----   -    - -
-      --  -  ---   - - - -   - -       -  -  -        --         - -       -  -      -- --       --
-   -  -            - -  --     --  --    - -- ----      -- -     -- -   --   -      -    -  ---   -
- -      ---  ---- --  -        -    -       -      -     -   -- - -       -    -    ---        -  -
-  -  -   -      -    - -    --    -   -- - -  --        - -  -     -        -    -   -   --       -
-     -- -  --    -   --  - --- -    --- --        --      - - -- - --   -   -      --  -- -   - - -
-          - ----- --      -          -    -    - -    - -------- - -         --  -  - -  -   - -- -
-- - ---    -     -   -- ----  - - - ---   ---      -- -  -      -   -   -   -  - -- -- -   - - -  -
- - -    -   -   -- -- ----     --   - - - -       --  -     - --  -    -  -  -          --- -     -
-- -     - -    - -   -      -- -- -  -  - -     -      - -  - - -   --      -- -  - -   -   --    -
-   -  - -   - -                       -     -    - -      -  -    -    -          --   - --      --
-- - - -  -            - -    -- -     -    -   -  -            - - -  -     - - --      -   - -   -
-      -    -   - -      -      -  - --  -  -       - - -     -         ---     --     - -  -  - - -
-- -- - -          --    - - -        --  -        - -    -      - ---  -      -         -  -   -  -
-  --     -    -   -  --- -- -   -- --   -  -    -  -   - ---  -- -  - - ---   -     -       -     -
--    --- --  -    - --  -     -     --      -      -    - - -   ---   - -    - - -   - - -  -  -  -
-  --        -- - - -       -- -  -   --    -- -      - --   -  -    - - -- -  -  -- -     -   -   -
- -   - --  -   -  -        -   -  -     - --    --     -     -       --    -- --   -  --  - ---   -
-    -      --          -    - -        --  - -             -   -   - -    - -   ---     - - ---   -
-      -- -      -      - -     --       - -  -  --  ---   -  --   - -      -  -       - - -  -    -
-- --  -   -   - -  - -  -     -   -   --   - - -     --   -     -        -   - -   -        -  -- -
-   - -- - -    - -     - -  --   -    - -- --  ---     --   -  ---      - --- -   - -  -  ---     -
- --  -  -- -- -      - -  -   --   -   --- - - --  - -  --   -    --         - - -   -  -    - ----
-             - -- -     --  - -   --  -    - -   --       ----         -   -    -     --  -   -  --
-- ---   -  -  - --         -        -  - -- -  -   - - -    ---    -    -     -   - --     -      -
-       ---   - - - ---  -  -         - - -   -   - -          - --    --  - - -   -  - - --  - -  -
---  --       - -  - ----- ---     -    -- ----  - - - -   -       - -   -      --  --   - - -  -  -
-  - -  -- -    -         -  --  -          -       ---   -  -    -   --   - -       --   ---     --
-  --  ---   - -- - -   --    -  -   - --   --  ---        -   --    - - -   -      - ----    - -  -
-     -     - --    -- -   -    -   -   - -          --  - -  -   - -      -  -- - - -  -  -   --- -
--    --  -  -   --    ---       --         - --       -   - -- -   -  -    - -  -    -   -     -  -
- -  --    ---     --             -      -  - ---- -   -   -        -  - - -       --        --  - -
--  -         --   -  --   -    --   -   -       -   -    - -  - --   - --  -   - -- -             -
-    -- -   -- -       -     - -- -    -  --       -- - -   - ----   -  -     -  -       -   - - - -
- ----    -   -    - -  -  - -   --       -   -    -  -    - - --  --         - --- -  -  -   -   --
- -       --  - -   -      -   -     --  -  -    -  - -  -        -  - - ---           - -   - -   -
--    -   - - --  - - - - - --  -     ---   - - -  --  - --- --    -         ---  -- -  -  - -   - -
-     --- --      - - --         --  - --     -  - --       - -   - -   -        -         -   - - -
-- - -     -      -      -   -  -  - -   --  -- - -  - -   --  -   -- --     -  - --  -- ----- - - -
-    -          ---        -  -- - -- -     -  -  - --      -  -     -  -  --  -      --    - -  - -
- - - -    --  -               --    -   ----- --  -    -  -- -- - --- - -      -  -     - -  -    -
-    -  --        --    --  -- - - -   -         -- -    - - -        -  - -  --  -    -     - --- -
--   --- --    -      --  -    -     --     - -   -       -   -  -   --      - --  -     -- -      -
-  -         -- - -  ---  -    - -   --   -     - - - -   -  - - - --  --  -          - - -   - - --
---   -  --  --   ---       -      - -  --  - -  -     -   -  -  -    -  - -   - -  - -     -  - - -
-      -  -     -    - -  -    --   -  -- -    -           -  -      - ---   -  -   -  -         - -
----------------------------------------------------------------------------------------------------
