100
100
----------------------------------------------------------------------------------------------------
-  -    -      - -  -  -    -            -     - -   --            --- -         -      -  --  -   -
- -  --    -----  - -          - ---- --     - -    --   -             - -    --   - ---      - -- -
-  -  -               - -  -     -       -   -   -   --     - -- -    -  -- -    - --     -- -- ----
- -    -  -  --     -  -    -  -- --   - -         -      -       - --          -         -   --   -
-           -  -      -         - -- - -    - - - -  -       - - ---   -          -    - -      -  -
--  -    ---        --   ----     -- --        -    -     - -   -      -   -- -  -     -       -   -
--          -- --   -    -    -           -  -    -   -        - -- --- - -    - -     --   - -    -
-  --      - -   --   --   - -   - -   -   -  -- -    - - -  - -     - - -    --   - -   - -   -   -
-   - --     - -          -      -     -   -       -   -  - -  - -    -     -     -            -   -
-  - -- ----    - -  -   -- -- -   - -   -       - -  -- - --   -    - -    -   -  -  --  -  -  -- -
--      -  --     -    -  -   -      - -  -   -    - -- --     -         - - --          -     -  --
- -   -       -  --  -- -- -- -   --------   ---   -    - - --  - - -- --       -   -- -     -    --
- -  - -  - --  -   -   -        - --  -   -     -      --   -               -  - -- -   -    ---  -
-    -- - - -   --      -   -            -   -     --     -  --    --  --  -   --      -         ---
- -    --     - -            -           -      -       ---      -          --   -- -- -- - -  -  --
-               - -  --     --     -  -      -  -   - -       - - - --  - ----      -  -     - -- --
---       -           --   -   - -    --      --    ---         -  -  - --    -   -     - --  --   -
-  -    -- --    -     -  -   - -    -  - -- - - --      -  - --          -- -    -  - - -      -  -
-    -           - -    -  -    - - -      -  - -  --  -        - -     -   -    -     -           -
--  ----  -        -  -  -- - -   --         -  - -       - - -   -   -       --   -      -     ----
-  -  - --- -  - -       --   -- - --     - -    --- ---- -    --  --      -        --  -  -   -   -
-   --   -- -- - -- --  - -    -- -       -     - -        -  - - --   --    -    -   --   --- - ---
-            - -      --- -  --  - -- --  --   -     - -  --  -     -----   --     -     --   --  --
-  -  -           - -    -               -  --- -  --    -   -  -       -  -  -- -      -  -  - -  -
- -        -- -     ------   -  -  -  -          -   -        -  - -   -      --  - --         --  -
- --   -    - -- ---    -   -- -    - -  -  -- --  - - - --    --       - -     -  -  - - -    -  --
-    - -           ---    --   -  - --    --    - -    ---  --    -   - -  -  ----- -     --  -- - -
-     --    --- --       - --     -   - - - - -    -    --         --     -       -  -    ----     -
-- - - - -      -     -  - - -    - --- -    -   -             -    -              -  -        - - -
-  -   -  -   -   --   -   -    --  -     -     -  -    --    - -  -    --  -   -   - - ---  --    -
-- -   -   --   -   - -           - - -     -- -   -  -      -    - -- -       - -- - -     - --   -
- --   --               -  -   -     - - -  -  - -   ---  --   - - -   -       -   --   -- -       -
-    -  -  ---     - --  -       -  - -    - - -     --              --    -  -           -  --    -
--- -   - -     -- -- - --     ---  -  -     --  --     --   -   - -   -  -     - -  -  -    -     -
--    --  --- -       -      - --  - - --   --- -   -    --   --- -     -  -         -      - -  - -
-    --  -  -- - -    -    - -   -    -  -   -- --- --  -- -       -    --          - --           -
-   - - ---- ---    -  - -        -- - -            -   -   - - - - ---  --    -       -  ---  -   -
- -  -   -   - - -  -     --   - -   -         - -   -   -    - -  -    -    - -  - -  -  -   -    -
-- -  --      --  -         -          -   - --     -   --     -  --- ----      - - -----    --   --
- -  -   --      -       ---  --   -  -      - --  -  -  -   ---- - -         -    --     --- - -- -
-  - ---  -  ---   --        --  -     -    - -  -- -     -- -    -  -- -   - -   -   - - -   - -  -
- ---        -- -   -  -- --   --  - - - - - -  -         - - ---   --- -      - -     -    ---  - -
- - -   --    -- --  -       -   -       -   -   -      -  -- -   -       - - -  ---   -  -   -   --
-      -   --  - - -     - - -- --    -  -   --  - - -    -    - -- - -    -      -     --     --- -
---   -  -   - --      -  -     -- - -      -      -  ---  - --  --     - -  -   - -  -      --    -
- - ---   -    ---       -- --   -    - -   -       - -    -   -   - ---   -- - -  -  - -          -
- -   --     -        --  -      - --  - -      ----  ---  - -  --        -  -- - -  -- - -     -  -
-  -   -   -  - -    -   --    -       --- -  - - ----   -  -- -     -    --  -     -    - -  --  --
-        - -   - -   ---   -- -   - --   -       -      ---    ---    - -  - -- ---    - -       - -
--  -        --   -   -  --  -  - -   - -  -         - - -   --        - ---     -   -     -  ---- -
-   -   -    -- --   -   -       -    -- - -   -     -   - -    -  - -        ---  --- ---     -   -
- - -    --    ---- -   -  --    --   -    ---   - -   -  - -  -    -    -    -- -     --  - -    --
- -   -   -- - - - -  -  -  ---       -    -    -    - -  -  -   ---      ---  -    --    --- -  - -
----    -  - -   - - - -  -  -  --   - - -   -   -    --- -             -       - -   - -  -    -  -
-  --   -   ---- -  --       - --  -  - -   - -  -    -   -  - - -    -    ---- --   - - -  -    - -
-    --               -- - --   - --  - - - -      -   --  -    - -     -      -   --  -    -   - --
- -       -  - -  -  -- -    -- - --  -     -    -   -  - -- -  - - - -- ------  --   -    - - -   -
-    -- - - -    -  --  - ---   -  -- --  --       - --   -  -  - - -   - --   -   - -       --   --
-     - -      -    - -- -  -   - - -      -      -         - -  - -- - - - - -          --    --  -
----   -- --        -   - -- - --     -  -   - - -    -       - -- --      - - -- -  - -           -
-- -   -    -   -   -       -      --   --            -- -  -- -- -          -       - - -  -  --  -
--       -- --    -   - -   --  -   -  - --  -   --  - - --  - -   -     -  -  -        -    - --- -
--  ---  -   - --  -    --   -  - --   -  - - - - - --    -      - -        -             --  -  - -
-     -  ---  -     - - - --    ------ -    -     - -    -  -  - -   -- - -   - --   -       - --  -
--  -    --    - --     -     -- -  --    - -- -  --- --    -          --  ---    - -           -  -
-    ---      -    --    - -    - -    -   --     -    -        - -    - - --    -   -   - -     - -
-    - - -  --  --  - - -   -    - -    -    ---   --       -    -        - -    -         -  -    -
-    --    ---  -  -    -   -- -       -       -    -  -    - -  --      -   --  - - -     -  -    -
-  -  --       -    -- -- --  -  ---- -     --   - -   - ---   -- -   -   --          -  -- -  --- -
-          --   -- -    - -   --      -   -      -               -  -  --  -          -- -    - - --
-  -- -      -      - --         --  -- - -  ----    - -  -  ---      -       -    --      -- -    -
-    -- -   - - --      - - -- - -    -         -                 - - -     --    -  -     - -  -- -
- -    -  -     - -  --     --        --   -   -    -  -      -  -- - -   -  - --      --- - -   - -
- -- -      -  --               - -    --         -   -          -      --  -    -- --  - -  - - - -
--     -           -     -  -  - - - -  -     -  --- -   - -     -         -    -      -       -   -
- -- -  --- -       -  --- - -- -   -    -- -  --      -- --- -        -   - -- - --    -    -     -
-  -       -   -  ---  -    -    -  -   - --    -- - --  - -  -   -         - -  --  -  -    ---   -
-  -      -   - -       -           - - -   -  -   -   -  -  ---          - --  -      -     -- -- -
--        - - -- - ---   - -  - -  -  -  ---        -    -   -   --     --    -- - --- - --    -  --
-   -   -  -        -       -  - -  --       -  -  -    -       - -- ---   -   - -    - -  ---     -
-  -  - ---   - -     -    -  - -    - -  - - -    -- - -    -  - - --  -   --  -   - - -         --
--     -   -   --  -- -- -  --  - -- --   -  - --  - -   - -- - -   ---   -   -      --    -     - -
- -     --   -       - -   -     -   - -    - -  - -     -     - ---  -- -    --  --    - -        -
- - -  - -  -  -       - -    --    - -  -- - --  -  - -   ----       -  -     - - -    - -   -    -
- -           - -   -  - ---  - --   -  -      -   -  -- -    -  - -   --  -- -   --  -  - -  - -  -
- - --  -   --   -    -  --    - --- -  -  -  -- - --        -   -   -      - --             -     -
--           - -         -  -  -  -      - -    -  -- --     -   --- -    -    -  -    -   --   ----
- - -  - -  - --- -   --- -- -     --   ---   ---     -- - - - -   --        - -    --  --   - -  --
- -     - - -  -   -      -    -   -     - - -   -    --  - -  --    - - -   -- -- -  -   -  -  -  -
--  --   -  - -   -    -    --  -   -   - -    --  -         -  -  --  -   - -    -  -     -   - - -
--          -   -   -   -  --  -  - ----   --  - -- -  --- --   -     -  -      -- -- --  -        -
-  - -  -- -    -  -  --                 - -  -       -  - - -  - -     - -   --    -- -  - ---   --
-  -- -   -   -         --   -    -            --  -- -    --    -       --           --       --  -
-    -   -        ----  -       -   - -     --   -     --   --   --  -     -   - - -- -  --- --  ---
---   --  -   -         - - -                 -  - -- --   -   - - -  ---      -   - -   -   -     -
-       -    -      -  -       - --  -- - - -          -- --  ---     -       -      --   --  -    -
-      --   --  - - - -  -   -- -  -     -    - - -    --       -     -  --- - -   - --    ---- -  -
-  - -   --     - --      -    --    - -  -    -     -    -   --       -   --  - -   ---           -
----------------------------------------------------------------------------------------------------
