100
100
----------------------------------------------------------------------------------------------------
-   -- - -   - -   - - -- --   -        -  - - -   -- --  -- -  - -        -             --     -  -
---  -           --  -   -    -- -       --- -       -  -      - -- - --  - -  - -- -  --  -- -    -
-      -- -   --   - -             ------  -- --    -  -        -     -           -      - -     ---
- -   -     -   --  - - -  -  -   --   -      -- - -      - --   -  -   -    -  -      - - -       -
-  --   -  -- --         --  -      -   - --  - - -   - - -  -       - -      --  -   - -   - -  - -
-  --        --  -   ----   - -    --        -  --  ---  -      -- -   - ---  -  - -    -- -  - -- -
-            - -   -  -       --- -- -     -          --  -      -        -    -   -       -  - - --
- --- -   -   - - - -  -   -   -   -    -   --  -     - -     -  -    -     --       -       -  - --
--    -   - --    - --- -   - -- -     ---  -   -    -   -       - - -    -    -    -   --  --  - --
-   - -   -      -    --  ---   -            - - -- - -     - - -        -  - --   - -- -     - -  -
-        --        -  -   -   ---  - --       ---     - --      - - -    -     -     -       -     -
-    - -  - - -   --   -  -      --  --      -   -- -    --  --   -   -  -- - -   -  -  -      -   -
-  - - --    -    --- -       -  -      -   --      - -     -  -  -   -    - ---       - -     - - -
---   -- -     --   - - -   - -    - -    -  -    --   -         - --- - - --      -- -      -  -- -
-  -  - -       -  - -  -   -  -     - - -    --    -   -   - -    --        -  - -    -    -   -  -
- -         -     -   -  -  ---- -- -   - -   -- -- -     -   - -- -- --- -- -     --   --       ---
- -  -  -  --   -- - - -- -  -    -  --  --     -    -  -- --- -      - - -   - -  --- -   - --    -
-  - -        - - -----   -    --      --  --- - - -      -    -  -  -    -    -  -  -- -- --      -
-  - -           -                -       -  -   - -  --    --  --  -   -- -    - - -- --          -
--    - -       -   - -- - -     -    -        --    -     -  --            --  -- -       - -     -
-     -      - -- -  -    - -     -    --- -  -  - -     -  - -  - - - - --      - - - -  -    -   -
-   -- -- --  -       -    -   -- - -                ----    -          - - - -- -   -  -     - -  -
-  -    - -    -       -- - - ---      -  --       -  -   -        --  -  -      --   --    -   -- -
-  -  -   -  - -  --- --    - --  -        - -- -- --- --   -- - - -    --  --- -    -   - - --  ---
-  --         - -  -  - -       -   - --  --    -    -   --  - - - -- - -       - -  --    --- -   -
-    -  - -      -      --  --   -  -                 -     -- -- -  -  -      -  -   - -          -
----         -- -   - -  -      - -- -    --  --   ----  -  -- --- -  ---     -    - - -  - -     --
-     -   - -  - -      -- -             -        -       - -    --   --  - -    - --   - -    - - -
-    -    -  - -      - -      - -    - -     -  -    -       -         --      -    --      -   ---
-  -    -  -    -   --    -  - --        ----      -   - -  -  ---  -     - -  -  ---  --    ---   -
-        -    -      - ---  -  -- --  --     -- -   - ---      -  -   --     - ---   --   - -   -  -
-     ---- --- --   - -   -     -      -   --    ----    -- -       - -  -- -        - - -- --- - --
-   -     -  -   - -     ---   -    -  -- --   -      --  --      --   -   -  -    -   -   -     - -
-   -   -  --     - --- -  --- -- -  - - -   - - -- ----- -    -   - -      --    -   - -      -   -
--- ---   -   -- -    - - -   -      -   -  - -   -      --    -     - - --  -  -     --   -  -   --
-      -  -            - -     -   ---- - - -   -   - -         -  - -      -  - -   -    - -      -
- - --    -- -   -     -     --      -      -  - -- - -   --           -     - -  - -  - -    -- ---
-            -   -----   -         -- --- -   -             -   --- - --    - -  ---    - -    - - -
-  ----        -- -  --       -  -- - -  --   -       -             -      ---  -          -   - - -
--         -       --  --  -   -      -- -  -  ---    - -      -     - -    -       - -  -  -      -
--   -      --     -  -- -  -- - -  --         --   -             - - - --    - --         -  - - --
-    -  -- -      -       --   - ---   - - - - - --      -    -----  -   -  -- - -   -   -  ---   --
--       ----      -  -     --          --- ---   -  - -   - -  -  -      -   -  - --  - - - -    --
-  --- -       -      - -     -  -    -    -  - - - --     --      - -   -    -  - -               -
-- -      - -     -   --        -  -   -    -   - -   -      - -     -- - - - -    -   -  -  --    -
---           -          -    - --    -     -   - - -      -   -   -    -   --     -  -- - --      -
--  - -  -      - -     -   --   -   - - -- -   -       - -   -  -         --      -- -  - -    -- -
-       -     -         -- -     -- - ---  --- --   --    - -  -      -      -  -- - -  -  -  -    -
-    -  --   -  --- - --  - --     - -    - -   -   -    -        -  - - -  -    -  -           - --
- - - -  - -     -    --   -   - - -- -  -   -    -      - -      - -   -       - --  - --  -  - - -
-  - - --   -    -    -  -  -        -      -   - -   ---     -- - -    --   -  --  -  - -       - -
-  -      -     - - -  - -- - --  -   --  --   -              -   -   --   -  -   - - --   -       -
-   - -         - - --   --  --  - -     -     -- -     -       -     -         ----  -   - --     -
-   --     -     -  - --      - -  -  - -  -      -           --       -     -      -   - --  -  - -
--   --  -   --   ---       -  -           -- ---- -    -   -    - -  -  - --     --     --     - --
-     -    -   - - - --     ---        - - -         -           - --  -  -   -      -   -- -- - - -
-    -  ---    - -   -   --   -  -   -- - --   - --    --      --  -    -  -- - -  -  --   -     - -
-    - - -- --    - --     -   -  -    --   -- -      - -   -- - - -  --           -- - -          -
-    - -        - -        -  -  - ---  --- - ---   -   - ----     --     -     --      -     --   -
----      --- -    ----   - -   -    -   -   - --   --  - -  - -   - - -  -    -  ---      - -    --
-   --   --          -    - - -- --     -- -- -  -  -   -  --- -     -- -   --  -  -  -- -     -   -
-      -      - -  -- -- -    - ---     ---   -  --  --  --  -    --   -  -  --      -  - -      - -
-     - - -       -  -     - -   -  - -  -             -  ------   - -    -  -  --       -  -- --- -
-   -- - ---   -  -   --   --- -  - -   -  ----  -               --    -     - -     --  -      -  -
-   -  - - - -   -  --           -  - --  - -           -   - -     -   - --  --     -    -       --
---  -   -     -  - - --   ---  - --     -       -     - -      - - - --- -        -  -  - -    -  -
-    --    ----             -  -  - -     -   - -   - -  -  --       -  - --  --  -  -  -   - -   --
- - -     - - -  -  -  -   - -    - - - -           --     -   - -    - - -   --  -  -  -- -  - ----
-   ---- -   --- -      - --         -  - - -  - ----- - -- - -     -  -  -  -  - -    - -  -    ---
- -          -  ----   -    -  -  -         -- -        --     - - --  -   -  -    - -    -  - -   -
-  --   -         -  - -  -        ---    -     --- ---   -      -   --   - -     -      -- -    - -
--       ----   --  --   -- -- --   --      --    -  --   -     -        --         --- -- -    -  -
--     --  -    -    -- ----          -  --    -   -    -   -  -- -  -       -    -  -    -        -
- -   -      - - -- -  - -    - - - - ---    -- -         -         -- - -- --  -     --  -      - -
- -  - -  -  --     -  -   -- --  -       -- -     - ------      -  -      -  - - - -- - -   - -   -
---- ---    -   -    -   -    -                  -   --         -  -       --  -       -     -  -  -
-   -   -  --      -  -  -  --    --   -- -   -  -     - - -       --  ---- --  -   --     -  -    -
--   - --       - -     - -     -- -  -  -- - --      -      --      --   --    --- --            --
-   -   -  -       - --    -     -  -   - -     - - - - -       -  --  --   -   -        -        --
- -       -  -   -      - -    -    -      --      -   -  -  -  --- -   ----    --- - -   - ---  ---
-- -  -      - -  - -----   -  -   -  - - -   --    -  --     - -   -            -  -   -    - -   -
- - - - - -          -  -    -             --   - -- -   - -   - -- - ----     -   ----     -  --- -
-    -  --   -  -  -  -      - --    -     - -  -   - - -- -  -  -   -    ----           ---       -
-  -  -   ---   --      -  -          -     -     -    -   -    -   -  --  - -  -   ----   -   -   -
-   -    -       - -   -      -  ---  ---   -   -- --  - - - -  -   -   - --   -    -       --     -
- --   -    -  -               -  -- -    --     --   - ---- - --  -   -    -    -  - --  -- ----  -
-    -  ----- -   -  -   -- - -  --    - - -  - -            -  -   --  -  -    --- -- --      - - -
-   -- -    --     - -  -     -  -       -        ---    -    - - - --    --  -    -     -   --- - -
-  -  -   --       - -         -    -  -- - - -- -  -   -  - -  -   -     -   - - - -- -  -   --   -
--  - -          -  - -  - -            -         ---     -  ---  - --- - -  -         -  -  -     -
-    -    ---     -   - -   -   - -   - -- - -    -   - -  - --  --        -     -       -- -      -
- -- - --          --   - -  ---    -       -  - -    -  -        -- -- - -  -  -     --  -  -   - -
-         -   -     --     -     -   - -  -    - -  - -             -   - - - -  --  - --         --
- -  --  - -  --  -     - --- --  -     -  --  -       -         - -  --       --     -    --   -- -
-      -- -     ---- ---- - -  -   - -    -  -  - -   --   - -   -    -  -  -            -   - -   -
---  --     --             --    -     -       -    -        --      --- -      - -- - -   - - -   -
-  -        -     -  --        -   - -    -- -  - -  -- --- -     - -   - -  ---       -  ---   -- -
- -- -     -    -  - - -    -   -     - --        - ------- -   -  - - -         -   -   -         -
----------------------------------------------------------------------------------------------------
