100
100
----------------------------------------------------------------------------------------------------
-  ---     -- -     --   --   -----  -        - -  --      -       -   -   --      - - - --        -
-      ---   - -   -- -  -  --      -- - -- -     -    --- -    -  -          -  -     -    -  -   -
-- ---  - - -- -            -  --   -  -       - --- --        -   - --- --  - -         - -   - - -
-    --   --  - -- -- -      -- - - -- -        --- - -- - ---  -   - -- --    -     -      --   - -
-  -        --        --- -- - -  -     -- - -     ---  --   -    -    - -- --   -             -   -
- -   -  -   ---  -     -- -          --- - - --- - ----    -  -  - -    -  -  - -  ---  -         -
-  -  --   - --  -    -      -       -  -   -  -          --    --- ---    -  - --  - --  -        -
- -       --   -  -   - -  -    -            - -  -   -        -         -        -     -- - -  -  -
-  - -- -    -   -   --  - -          -     -        -   --    - -    -  -   -  -   - -   -- - - - -
- -  --- - -  ---  -  --     -  -     --  ---- - -       -  - --       - - --       - - -    -   - -
- -    -         -  -       - -   - -     ---      --    -     ---  ---  - --- --      --      -   -
-         -   -  -      -------   - -   -    - -  --  - -- --    --   -   ----    -   -   --   -  --
-     -   - - -- -    -      -     -     --     -- --     -  - - -    - -     -- ---   -      - -- -
--  -- -  -    -        -     -- -----  -  -   --  --    -  -    --  -    -   --    -- -      - -- -
-  - - --     -    -        -    -   -    -       - - -  --     ---   -  - - -  - -    -    -  -   -
-- - -  - -       -   - -      -    -      -- - ---   ---   --          -    -    -  -   - ---   - -
--      - --     -             -- --   - -    -    - -     -  -  -       --      -  - - -   -- -- --
--   -- -    ---      - --                 -    --   -      - - -    -  -    - -  - ------  -  -- --
--  - -   -        --     --  ---     -- -    -     -   - -- -  -  -    -  -   - -    -           --
- -    -- - -  -- - -- - --   --   -    - ----  --     -  - - - -  -- -      - -  --        --     -
- -  -      -          -   - -  ---- ---- -   ---   - -- -  -- - --           -- -  -       -  -- --
-       -   -    --        -   -           --- -     -      - -   -  --- ----- -   -    -- - -   - -
-         - -  -  ---  -   -  -   - -                 --  -- -              - -    - - -     -  -  -
--- -    -  -     -   -  -- -    - -- -- -   --  -         ---   -    -     -    -    ---         --
-  --       -  - - - -- - - -    -- -     -  - - -   --        - --  -  -  - --   --         -     -
- -          -   --  -  -       - --   -   --- - --     - - - ---            -  -  --   ---   -  ---
-   --    - -    -  --    --    -       ---   - -      -- -   -  -            -    ---   - -     - -
--  -    -    - -   - -     - - -    --    -  -    - -   - - -  -- - --  -  - -    -  - -    -    --
-    -  -     -      -- -- -      -      --     -    - -         -    --   -- - --     -  --       -
- -   - -    - - - -  -  -        -    - - ----- -   -    -- --   -  -   -   - -   -    --    -  - -
- - -    ---         -  --  -    --    - -  - ----  -   -  - -- -  -  -   -    - - --     - - -  ---
- -    --     -      -  --     -     -- - -   -       -    - -  -   -  -   - -- - --  ---  --    - -
-- --- --    - - -   - -   -  -   - -  - - -   ---          -         -      -   -  -    -    --  --
-  - -       -  - -           -     --  -   -    - -   -    - --  - - --  -       -- - -   - -   - -
-   -  -- --   --   -- - - --   ---     -   - -  - - - --         - -       - -   - --   -    -   --
- - -   -   --     -  - - -  - -- ---     --    -  - -      -  -  -    -- -           - - --       -
-   -         --  --   -- -   -    - - --- - --     - -    -    -    -   --   ---  - - -        -  -
--  - -   -  -  -        -  -      -   - -   -   -         -  -    -- -     -- -- -  -   - -- -    -
-- -- -- -           ----  -  -   -  --     --   -   ---- -  - --- -  --- - - -    -  - -- -  -   --
--  - -    -       -      - -       - --  --   -  - --     - -           -   ---        -        - -
-  -  -    -  - - -- -  --  -    -   -           -    -   -- -     - -   -     -  -  -    -     - --
-- - - -   -- -   -      --        --   -   -           - -     -- - -   -  ---  --    -     --    -
-- - - --        - --  -  -  -    -      -- -- - -    -- -  --       -        -  -    --    -    - -
- - - -   -  -  -  -- - - -  - -   -  -   - -     -  -  - - -  -    - --- - - ---- -   - -- - -    -
-       -- ---  --           -- -              -  --             -        -   --  -    -       -   -
--   --   -   -       -- - -       -    - - -      -  - -  ---   -   - -   -    -   --     - -   - -
-   -    - --  -    -- --      -   ---      -  --          --  -- - - --              -  -     -- --
-    --  -    -       -       -- ---     - --      --      -  -  - - -   -- -     -  - -    --  -  -
- ---        - -- - --   -  - -            -  ---         -  -      -     --    --   --- -- - - -  -
-    -   -         -   -   -        - - --  -  -   - -----    -  ----  --   -    -       -  - -   --
-  -  - -   - - --      ---- --   -    -         -   --   -       -        - -  -  -   - - - -  -  -
-   -         -    - -   - -  - -    --   -    -       ---    ----     -  -     - -      -  -   - --
-      - -  -  -  -        -     ---   -     --- -  -- --   -   -- ---   -  -  -  -     -  - - -   -
-     -      -- --- -  -     -  - - --- -    -- -  - -  - --  - -      - -          -    -    ---- -
- ---        --  -- ---         -  -      -  -    -         -  -  -     - --  -  - -   -- -        -
---   -    - -     -    - -    -    - -- - -     --    -  -  -   - -    -       --         - --   --
-        - - -  -    --   -  -  -           - -- -  -  -   --- - -    -  -   -       - -  -    -   -
- - -    -   -  -   -   - -           ---  - - -   -   -    - -  -            -   --    -  -    -- -
--     - -    -  ----  - - ---  - - -   -  - -  - -  -   --- - -       -  -  -      -       - -  ---
-     --   --   -    - - --  -  -   - - - -   -  -  -  -       - ---  -   ---  -  -- - -   -       -
-- - -   -    -- -  --    - - - - -- --      --- -   -    --   -- -   -    -   -  --    -     -  - -
-  -       -  -    - -    -       --- -    -      -- -    - -            -       -   - -   --      -
-- - ---  ---  --     -   --      -      -         -   -- -      --              - -   --  -   -  --
- --  - -     -       -       - -- - -      -  -- -  --    -         - --         --  -   -  -  - --
--   -   --   - -   -  -     --  -        - - -- ---   -  --  -  -- -  -  - -      -- -  -   -- -  -
-   -        -  --- - -  -  - - - --   - - ---        -  -    -        -    - -   -- --   --     - -
-  - -       -       -  -      -  -- -   -    - -        -    - - - -     - - -    --- -     - -  --
---       -     ---  - -  --    - - - -        -     -    -    --     --     - -     --    -    -  -
-      - --     -  --    - - -   -      -        - -      -            - -     - -     -- --- -  - -
---- -     - -       - - -  -  -   - --  -     -   -       -      --    - -  - -  -   -   -   - - --
-        -  -  --   -- -  - - -  -  - -     ---    -     -    -       -    - - -   -  -- - -- - - --
-    --   - -     -    --  -    - -   -  ---     -    --  --  -   -- -   -          -  - --      ---
-   -   ---  ---   -  -   -- -   -   --  - - - -  --    -    - -    - -     -   --  -       -  - - -
-    ---   -        --  -       --  -      - -    -  - -    -- --    -   -        -  - ---   - -  --
-         -   - - -- -    -      --     --     -  -     -    -   -    ----    -  -    -       - -  -
- --  -   -         -  -  -  -         -    -     -- -        -- -  -     --- -   -    - -  -  -  --
- -  -       -   -   -  -    -  - - - -    - -- -        - - -     ---   -     --  - --  - - -     -
--  -       - -    -  -  -     -  -    --     ----    -  -   -   -  -    --  -  -- --   --      -- -
-  -   -   --  -      --        - -  --        -       - - - - - --   -        --   -   -- -   - - -
- -    -  -  -      -    - - - - --        -  - ----   - -- --   - -  - -- ---      -  - -    -  - -
- -     - -  ---   -- -  - - -     ---      ----   -- -    -         - -   -    --              - --
-  -             --    - -  - - -       - - --- - - -      -       -  -     - - - - --  -    -  -- -
-       -    - -     -    -  -  - -   -    --  - --  -  - -      - -      -  - -   - -   - - - -  --
- -    -   -  -      -  --    -    -- - -   -   -  - ---    -  - - --         --    - -    -    -  -
- - -      - -     -     -  - -     -  -  --           -- --   - - -       -     -  -  -  -- - -   -
-   - -   --- -   -     --    -              -- -- - -- - - --    -  -- -   --       -        -- - -
-    -            --            -      - - -                - --      --        --        --    -  -
--- -  -          -     -  -- - -  ---  -  - - -     - -  -      - - -    ---  - -    - -  - ---   -
-   - -     --  -  -- -   - - -- -    -     -     -   -  ---           - -   - -         --- - -   -
- -      -  -      -  -   -  -   --     - --   - - -    -    - - -   -    -- - -   - - -    - ---  -
-     --- - --   --  - --   -  -    - -      - ---       -  --  - --  -   -   - -    -  --    -   --
- --      -      -  -  - - -   --  -   - --  --      -  -- -   --   --  -- -      - - -      -  -- -
---  -     -   -  -    ---     -   - - --    --- -  - -     -- -       - - -      -- - -  -  --  - -
--     -     --   - - -     -  -      -  - --- -         - -  -  -  --  - - - --  --    - --      --
-    -   - --  ---   -   -          ---     - -  -  -      -  --- -   -  --  - -    - - ---       --
- -- -    -         - -   -        -    -   - -  - -         -   --   - -    ---  -     -   ---   --
---- - -     --- -   -      -  --   -     -   -      -   ---          - --            -  ---  - -  -
-       -  -  -     --     -  -    -    -      -     - -     - - -           -       - -         - -
----------------------------------------------------------------------------------------------------
