100
100
----------------------------------------------------------------------------------------------------
-   -             -  -   -        -    -   -        -- -    - - --  -     -   -  - - -      -      -
- -   - -      - - -   -  - ---   --    -   --             -         -        - - - -    - -       -
-   -        -  -  -        -- --     - -   -  -  --    --    -- -- --   -  -  - -  -          --  -
--      -   - -    -      -     - ---    -   -       -              -      - -    --- -  --   -    -
--      - - --   -     -  --   -- --    -  -    - ---  - --   --  - -  - -      - - -   - --- - -  -
- --  - -  -  -          - -   - -     -   --  - -   ---   -- --       -   -- - - - - -   - -  --- -
-   - -       - -    - - -  -- -  -  - --- -      --    - -      --      -       -  -     -        -
--  -   -  - -   -  -    - -  -- - - --   -  - -- - -  - -    --   - -- - -  - -   --  - -    --- --
-      -  -    -   -   -        --   --   -- -  --  -  -   -  -  -            --      - -       - --
---      -       -    --- -- --    -  -        ---- --   - -   -  ---- --- ----  -- --      -    - -
--    - -   - - -  -      - -    - -     -             -- -    --   ---   -   -             -    - -
-           - -  -  --   -  -        ---   --  - -    -     -     -  -  -   --- - ---     - --    --
- -   -    - - -      -  --   -    -   --  -        - -         -   --   -             --        - -
- -       -    -- - -     -     - --        -  -   -    -  -  --  -  --    -- ------  -   -- -  - --
- -  -  -              -        - -     --       -    --       -        - -   -- -  -- - -  -- - - -
-- -    -    -   -   -   --    - - - -   --   -   ---        -- - -    -  -    -    -   --- -  -----
--   -    --  -      - -   -- ---  -   -   -     - -       -  ---      - -  - - -    ---    -    - -
-   - --      -- -  --  --    - -  - -----   --  -  -   -   -       -     - -- -- -   -  ---   -  --
- -     -   -   - --  -                  -   - -   --- - -    - -  -  --   -  -    --      - - -   -
-    -  -     -        --         -        -- -   -   --  ---    --  -    -  ---        -  -       -
-   -         -           ---   --   - -       -    - - - -   - - --   -  -          --    -   -   -
-   --    - -  --   --  -      --  - -- -    - -  -   -      - ---- --- -   - ----      -  - -     -
- -- --   - -          - --   - -  -      -   -  -           -   -     - -   -  -   --  -    --- ---
--   -      - -    -- -   -   --   -  -----          -   -      -       -  -   - -     -- -     -  -
- - ---          - - -    - ---    -   -    -- ---   - -   -  -     -       - - -         -  ----- -
-- --- - -     -     - --   -    -       ---      -     --  -   - -- - -  -  -  -    -   - - --    -
--       -     --     -      -   -   - -        -   - --       -  -   -  -  -    - --    - -       -
- -    -       -    -  --     ---  -   - - - -      -  --      - --    -  --   -     -   -   ----  -
--   --    - --    ---   --      -   - -   - --          -    --  -- -       -   -   -     -- -    -
-  -- -  - -  -  -      -             - - --- --    -   -    --  --    -   - -- - ---  - -  --     -
- -- - --  -  --  ---  ------         - -- -            ---        -       ---          - -  -   - -
--   -     - -     --- -- -  ----   -    -- --   --   -   -   - -     -     - -  -   -  -     -    -
-- -  --   -  -  -  ---- - -            -       -  -  -    -        - -      - -  - --    --- - -- -
-  --   --  -            - - --  --    -  --        --    -  -- --     -----    -- - -   --  -- -  -
--    - -   - -   -  -  --  --     -     --  --      -     -- -- -  --      -   -   -     -    -   -
-- - - - -     -         --  - -    -      --  - - -- -     -     -     -   - -       ---  --  - - -
-  - -- -   - -      -- -   - -- - -  -      - -- -      -     - -   --   - - -  - -      - -     --
--   -    -   - - -       -    -    - --   -     -  - -  -   --     - --   --  -    -  - - -    -  -
- -  -           --   ---- -      -    -  -    -- --   -  -    - --           -   -      --- -- -  -
-      - -           -  -  -    -   - - -  --   -  - -  - ---     ---  -  - -     --    -  -   --  -
-- - -      - -     -  ---- - - - --   --- - - --    -   -  -- -    -   -   --  - -  -  -  -       -
-  --   -       -   -   - -         --    - --     --- -  -- --  - -     --      -   - -    --  -  -
-    --    ---   - -    -   -  -        -  -   -     -- -  -   -               --    -    -        -
-  - -     -   -   - -   -  -    -- - -  - ---  -        --- --  -  - --  -  - -    --- -  --- -   -
- - --  -    -   -   -   -- - -     ---        --- -  - - ----  - -       -- -     -    --      -  -
- -         -- -    -  -  --      - -  -  -   -  ---   -- -    --      - -       -  -   -  - ---  --
--  -   - -      ---    -         --   -    -    -  -    -  -  - --   -  - - - - -                 -
-- ----    - --   ---- -  -  -   -       -  -  -      --    -    - - - -  -- - --  ---       - -   -
-  --        -  ---   -  -  --        -        -    - - -  - -       - - --  --  -   -   -- - -  ---
-- -  -  -    -- -     - ---     - --   - -  --    -  -  -        -  ---    --  -  -- - - -   --   -
-             -    -       --  - ----  -      ---   -  -      - -        --       -  - -- -   --   -
-   -  - - -    - - - - - -    --     - - - -- -    --  - -    - -   - -         - -  -  -         -
- -             - - - --  - -   -    -- - -      - -      -  - - ---   -- -  - -    --    -  -  - --
- - - -  -   - --    -    --      - -- -     ---  --   ---   - - - -   -  - -      - --          - -
- -    --       -   -- -      -    - -     - - -    -- -     - -  -  --- - - - -   -- -          - -
- ---  -- -- - -  -     ---    -      - -      --    -    --   -  - -       - ---      -  - --  -- -
-           --   -- --   --  -   --      -    -- - --    --    -   -    -          -      -   --   -
--  -    ---        --          ---    - -  --  -   -  -- - -         -              -    - --- ----
-        -  - ---     -  --    -  -   -- -    --   -  -    --    - -   --      --      - - - - -   -
-    -   -       -- -   -   - -   -- -- -   -    -     -        --    -   --    -   -  -  -   --   -
-  --  --  - - -                        -       --         - --    - - -     - -  -     -   --     -
-      -  - -    -      --      - --    -  -- --       --  --- - -  --     -- -      -   --  --    -
- ---   -   - -   --    -- -   -  -    --- ---   --     --  -     -    -     ---   -   -   -  --   -
---    -     -  --    -  - - -  - - -   -- --  - -    --       -  --   - -     -  ---    -     -   -
-  -   -- - -- -   - --  - - --       --  -  -     -  --   -  -     --   - -     --     - -  - -   -
-- -  -           -        --     -     - -- - --  -- -     ---   -       - --    -  -  -   --  - --
-- -    ---        -         -  -       - --  --    -  - -    - --     -- -  --   -  -  -  -   - - -
-     -    -    -         - - -      -     -- -    ---  -   -            -    -         -    - -   -
-  -      --- -     -  -  --    -- -   -      - -  -    -  -     -   -     -    -  - - --  -  - -- -
- -   --   -    -        -    - -     -      -   -   -  - -  - -       - ----  -     --  -    - -  -
-  -   -- -  -     -           -  --       -     -    -- -    --    ----    -     - -- - -  -  - ---
- -   -   -    ----- ---       - - -    -  -  --         - -    -    - -  -              -         -
- - - -- - -     -- -    -  - -     - -             --    -   - --  - -- -    - -  -    -  - - --- -
-            ---  - - -- -   - -  -    -  --- -- --  - --- - -    -       -   - -   -     - -     --
- -     ----  -- - -   -   --  -    -  - -    -        -   -  ---    - - -        -          ---   -
-         -   -  - -  -    - -    - - - -   -  --  -   -   -   - - -       - --     --  -   -- -  --
-- -   - ---       -   --        --   -  -   -  ---    -        -  -- - --       --    -     -    --
-    -  --    -  --      - -  -- -     -   -- - - ---        --    -    - -    -  - ------        --
-  - - -  - -    -  -  -  -  --        -     - -     -- -        -    --   -   - - -- - -   - -  - -
-     -   -  -- -  -    --       - -  - - --  -  - -    -  - -   -  ---  -   -     -- --          --
-      -   -  --  --- -        -         --  -  -- -     -  -- -  -       --    - -  --      - -   -
-   -        -    -    - --    --      --- -      ---      --    -- -- -  -  --  -      - - - -  - -
- -- -- -       -    ---   - -    --     - --  -      ---   ----   --   --    -   - ---     -      -
- -       - -- --   - ---     - -     -    -   - -- -     -    -   -- --   -- - -       -   -      -
-    -   -     -    --  --  -- -        --  -- -     ----            -   --  - -  - - -  -  -    - -
--   --    -    --     - - - -   -  ---    - --   - - -     - --     -- -       -  --          -   -
--          -   --  -      -                   - --   -   - - - -           - - --  ---- - -       -
-- -  - -  -         - -- -   -  - -     - - --     - -  -    -    -     --   -  - -  -  -- -  --  -
--- -  - --        -   - - -    -- --- --      -    ---  -      - --  - - - ---  --  -            --
-  -     - - --     ---       -  -        - -- - -             --  - -     -  -    -    -  -    -  -
--    -   - - -         - - -  -  -  --    - - -       ---   - -  -- - - -   -- -  - --     -      -
- -   - - - - -   ----    -      -  -  -  -----   -    -- ---  -- - -  -  -    -    -      -   -   -
--   --   -   -- -     -  -- - --        -      ---  --   - - -   - -   -  --    -           -     -
- ---   --  -     - -- --- -     - -   -   -- -  -    -  - -    - -    --     -      ---- -   ---  -
-       ---   - --      -  -  - -  - -   -          --    - --  - - -      -- -  - -         -    --
-  - -       -      - - - -   -   --     - --- -  --     - - -   -       -      - -       ---    ---
-    -   ---  - - - -    - -  - -    -     -    -  --  - - -  --  -- - --   ---  -  -  --  -       -
-     --                        -      --  - - - -             -            -  -   -        --     -
----------------------------------------------------------------------------------------------------
