100
100
----------------------------------------------------------------------------------------------------
-   -   - -   -   - -   - - -  -        ---   - ---       -     --  --    --      -       ---  -   -
- -  -   -  - -   -  --   -       -   -     -    -  - ---- -    -     - -       -  -  -- -    -  - -
---- - - -  -       -     -   -    - -    -     -- -  -  --     -    - -- -  -    -       ---    - -
---  -    -  - -    --    -   - - ---  -   - - -  - -    - --    -   - --            - --      - - -
----   - -  -     -    ---- -        - -- -       - --   -  ---   --  - -    -      ---    -  -  - -
---  -       -  --   - --  -      - --  -      - - -    -        - -  -     - ---  ---    -  -  -- -
---     -     -    --         -       -  ---   -   --    - -- -    -      - --        -     - - -  -
-         - -   --    ---   -  - -  - - -           - -     -   - -    -      - -   --  - -  -     -
---     --   -     -- -   --    -   -       - -   --      --  -     -   ---      - -               -
-- --            ---           --  -  - -    -  -  -  -      -   ---     -  - -    -  -- --     - --
-    --     -  - -   -      - -  -     -      --   - -- -  -  -         -   -  -  -         --  - --
- --      --   -     --     -- -       - ---       -     -           -- - -  - -      -       -   --
----           ---   -  -  -- - -       -  -- -            -    --  --      - -  --        ---- - --
----   -  -   -- --     - --   -  --   -    ---- - ---- - - --        -      --      -          - --
----  -  --     -  --  --             -  ---    -   - -- -   ---       ----    -    -- - -         -
----- -  -   -  --- -- -  ----  - - - -    -  -   --  --     -   -                    -  -     --  -
---   -  -      - --    - --  --  -  -    - - ---  -- -   - - --         -  --  -    - - - ---- -- -
-     -  - --  -    -  - -   -  -- -  -        --  --  ---   -               -      --   - ---     -
---       -       -   -   --   -    -  - - -  - --   - - -          -       -  -- --  ---     - ----
-      -          -  - -  --- --          --  --  -      -  - - -- -     --- -            -  -   - -
-        -  -  -      ---    -   ---  - -    -          ---         -- - - -----  - -   -     -    -
- -        -  - -    --  -    -- -  - - ----   -    - --       -  - -   - - -    ---     -  --    --
-   - ---        -    - - - -   - -              --      -  - - -                       - -   -    -
-  - -  -     -   -        -     -  -    --   -         - -    -  - -      - -  -   -    --        -
-   -  -         -     - - --  --  -       --      ---  - ---   -    -  -        -  -  -   - -     -
-  --- -                  -      -       --   -  -      -   -       - - - - ---- -  - -  ------ -- -
-   --- -  --  -  -   -  ----  - --- -            --      -   ----  - - -    - - --  -        --   -
- -  -       -   --  -  -    -   -     - --   - -    --    -   -      -  -  -         -- -- -      -
- -    - -     - - -  -   - - --  -- - -  ---       --  -     - -               -      - -  - -    -
-- -       -   - - -- --  -   --   --    -        - -        - -       -   --  -     -      -      -
-    --  - - - - -      -   --  --  -  -   --        ----  --       -   ---  -- -   --  -          -
-   -  - - - -      -  --    --   - -  -  -    -- -           -     - -      --         -- - - -   -
-    --     --      -  - -  -   -  -  -           - -  -     -            --     - ---   -  -      -
-  - - - -  - -  --  -  --      - -  -   - ---  -  -   -         --        -     - - ---         - -
-  - -   - - ---    --    - --  -- - - -   -     -  -- -- -      ---       ---    --  - -    -     -
- --       -  -  - --   -- - -   -     - --  --   -          --    -          -  - -    - -  -     -
-   --    -    --    -- --    -      --             - --   -     --   -   -- -      -  -  --      --
-   - - -  ---    - - --     - -- -  -   --  --  --  - -     -    -        -   -   --- -    -- -   -
-  -   - --      -      ---- -   - -  ---  -  -   - -   -- --  --  -  -   -       -     - - --    --
-      -   ----     -    ---     -       -     - -- --   -   -       -   -  -   -   - - -   -  - - -
-  - -   --    - --  -     -      - -   --- -      -    -       ---       --   - -   -  ---  -- -  -
-  - - - - -  -     -  -   -    --  -- -    -  -      -            -   -           -       -   - - -
-         -- ---- -           - - - - - -      -  -   -   -      -  - -    - --   -   -    -- -  - -
--- --- -  -- -   --   ---   --     -   -    -- - -- -- - - --   - - -           ---   -  --  - -  -
---        -    --   -         -- ---    -- - --      --      - -   - - -  - -   -    - -        - -
--  -  -   -  -    ----    --   - -       --   --  ---  -  -      -- -           -   - -       -   -
-  -  - - -     -             -   --   -- -      -      -   -   -   -  -     -- -  -  -  - --  - - -
-    --   --        ---    -   ---    -    --  -- -    -   -   -  - -   -         -  -  --   - -   -
-  --      - -    ---   - ---- -  - -   -        - -    ---- - -    --     ---   -         --     --
--     - -- --   -   -  -     -          - --     -- -- -  -     - -  -- -- -  -     -    --     - -
- --  - --  -          -    --  -    -       -      --     -  - - - -   -    - - -   --        -   -
--       --   -    --- - - -    - -      --   - - --            -               --         - -  -  -
- -   -  - -      --  - -    -- ---    -  - -     -       --    -  -    -  - -   -  -  - - - -  - --
-  -   -- -   --      -  -- -  -      -- - ---         ---    -  - -- -  -   - -- --         - - - -
-- -           -      -- -      - -      -   -  - -    -    - - -        -     -  -    -    - -  - -
- -    --  ----   -  -     -  --- - - --- -   -   -  -   --  - - - -  -- - -   -    - -  -    ---  -
-    -  -  --      - -      -   -   - -      -   - -        - --  - --    -   -    - -- -          -
- -  - -   -  -    -    - -      -    - - -      -   -  --      -         -  --- -   - -     - -  --
- - - ---- -  -- --    -  -- -     --     -   --   -      -    -   - - -  -       ---   --- - -    -
- -      -- -   -   --   --  - - --     -   -   -   ---      --    --  --  --- -     --       - - --
-   --  -      --- -       -    - -    -   --  -  -       -- - -    -     - --       -    --   -   -
-    -    ---  -  -         -    -   -  --      - - -  ---         -         - -  -- -       -     -
- --  - - -   -  ---  -     --  - -  --- -      - -     - --- --  -- - - - - - -     -    - - -- - -
-- -  --- -- -   - --  -   --   -  -        -     - -     -          -      --- ---- - --- - -  ----
-- - - - -    -    --- -- - - -    ---  - ---        - -  - -- -  - - --  -- -            - - -   --
-   -    -- -  --  ---     - -   - -  - --  - -  --    -   -    -     ----  - - -     -     -- -   -
-         -       -   - ---- -  -- -  -   -  - - --  - - -    -      -   ---- ---      ---   -   ---
--- -      -    -      -   -               ----  - -    -    --   - - --   -    -         -   --   -
- -     -   -   ---  -  - -  -- - ---     -- -    -- -  ---         - - -   --    -    -  -   - -  -
-   --      -      -           -- - -  --      - -        - -  --    -     --  --      --     - -  -
- -  - - -     - - -   -  --    -   ---   --     --     - -   -   -- --            -     -    - -  -
-- --  - ---   -        - -    - - -    --  -                  -  -       -           -- -- -    - -
-    --  - -  --   - - - --        -  --  -  --   - ---  - -    --  - -- - -     -    ---  -    -  -
-- -          -    -  - -           -  -   --            -     ---      - - ---   -         -  -   -
-    -   -  -  -   -- -   -    -    -   - -   ------ - --    --         - --    -   ---     -  -   -
--   --  -  --   -  - -    - - - -    - --      -       -  -  - - -     - -  -   -- --  -  -    -  -
- --- --  --   -  - - - --         - -    - - ---   - -     - - --- -- - -        --     -   --  - -
--   -  --    - --      -  ----    -          -- -  - --    --    -    -  -   --   -- --      -  - -
--  -     -      -  -  -      - -  -       - -     -  -   -    -    - -        -   --  --     - - --
-     -  --    -  -- ---     -  -  - -  -  -- -  -   -  --      - --     --  -   -      -    -    --
-- -   -- - -   - -     -  -              - --        --- - -- -     --  -   -- - - -      -   - - -
-  -  ---  -   -  - - - - - --  - -- --   - - -   --          -     -  -           - - - - - - --  -
-   --    -       -     -  -  - --       -  - -   -       -  --  - - -    - -  -- -----  ---  - -  -
- -- -        ---   -  -  - -         -  - -  -         -         - ---         -    - -    -  -   -
-    -    ---     - - --         --  -   -    ----     - -  -   -   -  -       -     -   -- --   - -
- - -  -     -   -- -   -    ---  - -    -   -      -  - - -      --    -   -      --  -      ---  -
---    -    -  --  ---     -     --  -      -  - -         -      -- -             - -      --  ----
-   - -  - -        -   - -  ---   --  - --  -    --   ---  -       -- -    -  -      -  - -  ---- -
-   --   -  -   -- - - ---       -- - -    -  - -      - ---     --    -    - -         -   --    --
--        --     -    -   - -          -  -   -              -  -    -   -  --- -    --    - - --  -
--  -   -    - -    -    --  -    -  --  -  -  - - -  ---  --   - -   --       -  -     ---       --
- -   -  -  --   -  -     -   -- - -      -   -  -  - -      -- ----     -- -- -      -  -    -    -
-  - -  -  - -- -  -- -  -- - -- --        ---    --          -     - -      --  -  -   -- -- -  ---
-- --      - -  -  -    --  -    --   ---   -  ---      -     - ------ -- - -      - -   -    -   --
-   -         - -       --  -  ---  --- -     ----   -  -   -   -     -  - - --      ---          --
- - -- -    --- -      --   - -       -     - -      -    -   -   -   -- -    -- - -    --   - -   -
-     -  -   - -     -      -- - -   -         - -- ---  ---         -      --           --- -  -  -
- ---  - - -  -   -    -- --           - -   --  -        -         --  -      -       --   -   -  -
----------------------------------------------------------------------------------------------------
