100
100
----------------------------------------------------------------------------------------------------
-   -   ----   -     -   -- - -   -   - -   -- - ---    -  - -   -   - -    -             --       -
- -   -         - -       -  - --    -       -   -    - - - -    -     ---  - - --  - --    -  -  --
-    -  -- - -   -      -     ---  -    -- --        -   --   -  --  -     -     --  - -   -   - - -
-- -  - - - -  -          -  -  -         -      -    -      - -    -     -   -   -   -    -- --   -
-   --   --  - --   -    -   ----     -- -  --     - -    - -   -       -  -   -   -  -- - - -   - -
--          --       - --  --     -  -       - ---  --- -  - ----  -- -    - -- -            -  - --
-   -     -     -    - -  -  -     --  -           -- - - -- -   -   - --       ---  - - - -   -   -
- -           -   - -- -    --   -    -  -  -- -  -  -     -   -     -        -     - --    - -- - -
--        - -  --        ---        -  -     - - -    -        --      --   -- - - ---   --   --   -
-   --   -    -  ------ --  -    -      -  ---    -  - - --  -       - -   - - -   -   --        ---
---      --    -          --   - - -- -  ---    -- -- --   --- - -  -   --  -    -     -  - -   -  -
-    -    -   --         -- -   -   -    --      - -     --   -    -  --  -      --   - -- -    -  -
--- -     -     -  -   -  --    - - -  -      - -    ---       -           ---      ---      --  - -
- -   --  -- ----  -  --  -- -   - - --      -    - - - - -    -   -    -       -  -   --  - - -   -
-- -        - - -    -          -         -    --  ---    --- -     -- --   -- -     --    - - - - -
- -   -- -     - -  -  -    -    --  - -       -        -   -      - -       -         --   -   -  -
- --    -      -- - -- -   --  --  -    ---  -  --   -       -- --   -- -   -    -- - - -----    ---
--  - -  -  --   - --  - - -  -  --      - --         --  -  --   - -     -  - - -         -    -  -
-              -- - -   --   -       -   - --   -  ---   --       -- -  - -       -       - ----- --
- -- - - -     -    - - - -- -  -- ---       -   --     - - --  --  -     - - -    - -- - -   -    -
-    -  -  -  -      - -    -  -  -   ----  - -      - -     -  -   - -- --   -      -     --    ---
- - -    - ---    -       - -  -    - - --  -       - -- - -- -   -          -   -       -    --   -
- -  -       --- -  - - -  -  -- -     -   --      - --  -  -- -   --   -   - --      -  --  -  -- -
-  -          ---  -    - --    -  -  - - -    -   -        -                   -    - - --  --    -
-       - - -      - -          - - --   -         --  - -           -     -   -   -      -        -
-   --   - --   --    - ---     -    - -  -  ---- -      -- -          - - - -- - -     --  --    --
-  -   -      - - ----     - -   - - -     --        - --   -  -- -    - -- -   -  - - -      -    -
-   ---  --- -  -     -  -   - - --- ---    - -  - -    - -        -        - -   -    -   -     - -
-      -          - -  -    -       -   -  -       -      -   --  - - -   -  -  -   -  -  -      - -
-   -   -----     -  --   - -- - -     - -      - --   - -  -       --    ---  - --       --- --- --
-            -   - -    -  -   -     --     --  -   -  --    -   - -   - -  -          - -       - -
--      -     - - -    ---- - - - -      - -    -  --    -  --   -       - - --- ---- - - - -   -  -
- -    -   -   -- -  -                -  --   -   -- --   --  - -  - - - -   --      ---  -  -     -
-   - -- -     -      - -- -    -     -            -     --      -     -   -  - - -    - - -   -   -
- -    -  - - --      -  -   --  - --       -- - -    -      - -- -    -   -   - -   -- -  ---     -
-      -    - -  -          --      - -   --       -    -    -   -- --  -    -     --  -- - -   -- -
-- -      - --  - - -     -    - - -     - -- - - - -- -    ---    -     ---  -  -   -- -  -  -    -
-     - ---  -- -  --  -             - -   - -- - - -      -  - - -   --        -      --       - --
-   -   -  -      --- -  -     -    - - - -- -   - --  -       - - -     -- --     -   -  -- - -- --
- -  --  --   --  -  - -    -- - - - -  --  -  -         - -  -  -    --     --- -   - -   - - -   -
- - --  -      ---   - -  -          - -  -      - --        -  ---  -    --- - --- - - -    -     -
- -   -       -  -  --    -     --    -        ----  - -- --           - -   --- -  -  --    - --  -
-  --   -- -- --  --  -          -       -     -    -  - -  -    - -    -     - - -- -     - -     -
-  -    --   - --   --    - - -  -  -   -   --          -    --- -     - - --- -  - -   --- - ---  -
-    - -       -     -      -          -  -    - -        - -     - ---  - -    -   -      -      --
- -       -  -   -    -       -  -      -    - -   -   --  -  - --    -           --  ----  - -    -
-   -- - -   -  -        -          --     -  -    - --           -  - -- -  -- - - -- -    --    --
----       -  -  --    -          -  -- - --- -  -      ---  - -   -   -   --        --  -  ----   -
- - -  -   - - -   - --         - -        -  -      -     - -   --      - - -     -    --        --
-  -- -      - -  - -  --  -- - -     -  - - -  -  -     -   -      -- -           -  --  - -    - -
- - -  - - -    -    --         --  - -  -- - -  ---- -  -     -     --   -  -    -      -         -
- -     -  -- --   -      -  -      -       -         -    -   -   --  --    -     -   ---  - -  - -
-    -         -  -  - -   -             - -    -   -   - --  -- -   ---- --  -  --  -      - -    -
-      --  -     --      -      - - ----      - --- - - -          - -- - - - - --     --   -     --
-----     - -   - -     ---    --     -  -   -     ---  -     --- -        -      - - ---    -  - --
--      -  -  -  - -  --         - - -  -  - - -   --   ---       --  - ---   - -- -       -      --
- --  -  -  -      - - - -   - - - -      -   --   ---  -   -   ---   -     ---   - -   --- ---   --
--     - - ---  - -  - -    -       - -    --  -   -     - --- - -  -  -  -  - --   --      -  --- -
-    -- - -  -- -  -- - - -        - -  -       -- -   -- -    -   -  -    --      -  -  ---     - -
- - - -  -      -  -    -        --  --     - -        - - -  - - - -    -   -     --  - -  --   - -
-   -      -      --  - -  -      - -    -- -         -   -       -    - -     -     -        -    -
-     -    -  -  -     -  - -  -       -     -  - -- - -    - --  - -   - --     -   - -  -        -
--  -     -   -   --    -    -    -   - -    -  -  - - ---- --  --  ------    -   - -      - -  -  -
-   -  -      -          -        -             -      -   -  -   --   -  --        - -  -       - -
---  -    - -    -  -  - -   - -   -    ---    -  -   -       -      -  - -       -      - -    -- -
-- -  -  - - - --    - - -      - -    --  - -   -      -       --      -   --   - -    --   - -   -
-  -- -    -  -       -    --        -             - -   - - - - -  - -   -  - - --       --- --  --
-      - --    -    -  - -  -     --   -    -    -  -  -     -        -- - -              -  -    --
-  -  -     - -      --  ---    --  --   -    -  --- ---       --       -  - -    -  - - -   --  - -
--  -   -    -- ---         -      -   --   - -         -     --    - --    - -    -- - -         --
-  -   -- -  ---  -  -- - -- -- -- - --   -        --  -- ---  -         -   -      -       - - -  -
- -    -   --    -  -   -        --   --  - -- -    -   - - - -        -  -  - - --   ----  -  -  --
-  ---  -   -           - -  -        - -  - -       -- -   -  - -- - -  -     ----    - -- -  -   -
-   -  -       - -     - - -  --           -       -    --  --  - - - -   --- -     -    - -- -  ---
- -   -         --        -  -   - --- - -    - -        -     --- - --       -  --    -- - -      -
---       -     -  -    -    - -- -   -   -     - -   -                 -  -       - -  -- -  -  ---
-   - - - --       -       -  -  -  --   - -   ---   - -- -  - -- -   -    -     -  - ---    -   ---
- -  -        --    ---          --   -  -        --   -     - -   -- -    - -     - -     -   -  --
-      -  - -  ---        -  --   -  -   - -- - -  ---   -   --   ----- -   -  -    -  -   -- -   --
-  - -  ---  -   -  - -  --  -  -     -- -     -      -  -  ---- -     -      -           - - - -  -
-     -  -       --    --- -    -    -  -     - -  -  -   -         - -  -      -  - - - -   -   ---
-   - -    -  -  -   -   - --  -     - -      -   -    ---- -     -     -     -          - --- -   -
-  -- -  --   -   -   -  -     - -     - - - -  -         --   -  - --  -- --       - -   -      - -
--  - - -   -- -    - -   -----       -- - -     --- ---    -   -             -    -  - ----  ---  -
-- -   -- -     -  -  --   -  - - - -      - -         --- -   --  - - -  ----   -- -    - --- - - -
-  -    - -      -   -- -  --  - ---    -   - - -    --  -       - -        - -  --   --  -   -   --
- -  -    - - -  -     - -  - -      -     - -   - -    -   -- -   -  --   -        - -      -- - --
--  -        -----     --   -  -    -     - - -  - --         - -  -     -       -     ---  -- -  --
-  - - - - - -    -  -    --  -  -  - ---   -    - -  --     ---  --    --    - - - --    --   -   -
-    -   -    -  - - --  - --         -   -  --    -  -    -- - -     - - -   - - -    --   --    --
-  -  -   - -                 ---   -     -- -  ---    --  -- -   - --   -  --            -   - - --
- -       -     -            -    -    -- -- - - - --  --   -  -       -  --          -            -
-           --   -     -   --  --   -        - - -   -      -      -- -  -    -  --    -- - -      -
- -    -- -  -    -    -      - -         -   -  - -         - -   -  --      --        -       -  -
- -   --        - -        --     --  -     -     ---- -- -   -    -   -   --      -   -    -   - --
-   -   ---    -   -  -     -  -- -  --  - -  -  -    - ---   -   - --   -   --  ---    -  -  - -  -
---    -      - - -  - - -- -----                   -- -      -   -  -- -    - - -  --- -  - -    --
-    - ---  - -  -     -   -  -  - -       - -   -       --       --  -     -      - - - -         -
----------------------------------------------------------------------------------------------------
