100
100
----------------------------------------------------------------------------------------------------
-          -               -          -     - -  -  -   --   -    -     -  -         - -         - -
- --  --  - -  -- -  -       - -    -   -     --     - -  -      -  ------   --          -  --     -
-    - -    - -        -- -  -     -- --- -     -        --   -      -    - --  -   - -  ----  - - -
- -       --     -  --    - -    -   --  - -      ----  -          -- ---         -  - -----    - --
-  -     -  -  --          - -    - -  ----  -   ---- -  ----   --    -  ---  ----   -         --- -
--   -    ---     -     --   --   - - - - -       -         - -       -  -  -         - -         --
- -    --    ---         -- --   --     - -  -  -- ---   -  -- --    -  -  - - --   --    - -   -- -
-  -    - --          -        --        --   -               -   -   -- -     -  -   -  --  - - - -
- --   -  -      -      - - - -   ------ ---      --  -  --    -  --    -   - -  - -        --   - -
- -   -  -  - - - - -  - -              -       ---   -   - - - -     -   -  - -    -    - - -- -  -
-                -      - --  --  - -  -  -   -  - - -  --   -  -  -   --     -        -      --  --
-     --   --   -   -      - -   - - - -    -   - -- - -      -     - -  -  - -  -   - -    -   -  -
--   -   --- - ---- --  --     -       - -  -  --   ---- -       -- - - ---    -       - - ---    --
--         -  -   -- --   ---  - -   - -  -       -  --    --          -     -         -  --   -   -
-  - -- --     -   --           - ---    -    --     -    - ---  -- - -    --  -- -    --- -       -
- -  - -   -  -- -- - --   -   --  -  --   - -   -  -      -         -    ---- -   -       --      -
-    - -      -      -   - -      -    - ----      -  -  ---      -      -    -   - --     -   -   -
-      - -   -  -     -     --  - -   - -   -                 -  -  --- -   - -  -      - - -- -  --
- -        - -   -  -   --    -     -- -    -     -     --- --  -  - --- ---  - -    -   -   -     -
-    - - - - - --     -  --  - --    - --  -    -  - -      --          -   -        ---   --  -----
-   -  -    - -   - -  -  --      -    --  -   - -   -          - -   -- -   - - -     ---   -     -
-  -       - - --    - --   -       -  -  -   -   - - --    --     - - --        -- -    -         -
--  --- --       - --             -        -   - --    -- -     - --       --      --- -- --    -  -
-     - -   ---         -    ---     -- -       -      -       - -    -       -   -              - -
- --  -          --        -  - --       -      -    - --  -  -  --- -      --  -   -   - -   -    -
-         - --- - -  -   - --  -   --  -       - -     -   -  --  -    --- -   - -   ---  --       -
--   -    -      -   --  -         -     ---- -   --  -  -- --   -   -- -     --  --       -  - -  -
-  -        --  - -  -   - -- -   -         - -- -   - -      -- -  - -     --    -- - -  --       -
- -    -     -  -- --   - --     -- -  - ----   - --         -  -- -   - --           -- --   --   -
- -  -         -      -               - - --         --   -     - ---    -- - -- ---   --   --  - --
-----   -  --    -   ---- -      - -- ---  -    -     --  - -         - -- - - -     -     - -  -  -
-   -    -       -   -   -   - - - - -  - --- -    --  --   --     - -  -  --- - -  - --    -    - -
---  - -- - - -     -   -    - - -  - -   -  -  --   -    --  - -  -  -- -   -- -    -    -     - --
--  --    -   -   -       ---     - --    ------  -   --    -      -  - -   - - -   - - - -  --   --
-  - --- -    ---   - ---   -   - - -   -       -   -  -- -    -    -- - - -    --      -- -- - -- -
--            -   -    -        -   - -   -- -- --   -         -  -- -  -         - --  -  --  -   -
- - - -       -  -        -     - -         - - -  -   -  - -- -   - -   -       -    -       --   -
--   -  -    -  -        -- -- --  - - -   --  -  -   -- -  - - ---        -   --    - --       -  -
- -  -  --  - --- ---   -        ---     - --  -     -  -- -      -  -     -  -    --     -    -   -
- -     --  -  ----  ---    --   -   -         ------ -   ----   --        --   - -   -- -      - --
-- -   -    -- -   -   ---        --   --  -          -   -   - -     -  -     -          -- ----  -
-- -  - --  --- -   ---  --  -- -    --    --   --      --        -  -- -  ---  -- - -- -- -  --   -
-    -  --  -           - - - -    ---   --  -  -  --  -         - -       -  - - -    -- -  --    -
-   -    - -- -    ---  -            -  -   - - -      -        -  -   --       -   ---   - -  -----
--   -   - - - --    -   --    -- --   --   -           -   - - --   -- --  -   -   -     -  - -   -
-- --  -   -   -   -   - - - -  - --- -    --  -   --    -         -         --   --  - -  -    - --
- --      -        - -    - - -             -   -        -   - -      --     --- ----    --       --
--  - -           -   - -   - --    - -            --  -- --  -    -      -    -   - -   -    - -  -
- -       - -   - - - -          -       -       -   - --    -        --   -  - --   -     ---- -  -
-- -      - -     -   -  - -- -  -- -   -   - -  - -- -  -    -    -- -  ---       -    -          -
-   --  -    -  -   -  -- --      -  - -       -  - - ---- - - -  -   - -    --   - - -  -  --  -- -
---  -  -    - -    - -  - -  - ---   -            -  -   -   - -- -- - -   -      --   -    -  -- -
--  -- -- - --  -             --  -   - -- - -  -  ---   -     - - ---   -   -         -     -     -
- -- - - - - -   -  --   --      -     -  -  - -   -   -- -   -- - -   -    - -     -            - -
- --    --  - - --- -        -  --      -     -  -  - - - -    -      - --   -  -      -    --     -
-    -    - - -- -   --    -  -  -- -     -  -  ---     --  -    -    -      -     -  - ---   -  - -
- - -  --   -   -   - -- -- - -     -- - -  -    - - --    - -   -   -          --- - - ---  - -   -
-  ---       - -  -      ---    -       -   -  -     -- - - - --  -   - -    - - --   -  - -       -
--   ---   -  - -  - -  -     -    -  -      -  - --  -     --   - - - -   - -       -  -   -      -
- ---    - -  - - -  -  -  -        -      --- --   --    - -  - -    -    --   - ---  - --   -  - -
-     - --   -  - --    -        - --- --  --      -    -    -  --   --   -- -- -- -      -     -  -
-      -          --     -   -      - -      -    -  -    -   -- -   -- --- -- -   -- - -          -
- -   -    -    -  -    -       --- -  ------   - - -       - -    --  -   - - -                  --
-  -     - - --   - ---   -   -     -      -     -    --  -  -  -        --- -     --              -
- - -  -   - ----   --    - ---         -     -    ---  -   --      -       ---       --      -- - -
---   - - --    - -   -     -  --       -     -  - -  -  - - - -        -- -   -   -        -   -  -
- -  --- -    -  -      -      ----  --- - --  --     - - -  -       --- -  -- -   - -- -- -   -- --
- -    --  ---  -   - -  -  -  -    - -      - -      --    -  -   -       -   -  -      - --  -   -
- --      - -- -   -   - - - -- --     -  -   ---  ---   - - - - --         - - -       - -   -    -
-          -  -      ------  -   -      - -   ---     -   -      - ---  - - --    --   -- --  -    -
--    - -            -   - -  - -    -    - -    - -      --           - - -  -      - - -  -  -  --
- -     - - - -  -  - --- -       ---     - ---  -   --   - - -     - -    -        - -            -
-             -   -   -  --- ----   -  ---           -          -  -    -  -    --  --     -    -  -
- -  -      --  -    -       -            -  -         -  -            --         -   - -       -- -
- -  - -- --- -   --      -          -- -  -  -- - ----     - -   -   --   -- -  --     -   - - -  -
-       - -  --   -    - -   -- -   -  -- -  -    - -    -       ----   - --    - - - --   - --  ---
-          -    -   -  -   -              ------         -   --       --     -  -   --   - -   -   -
- - -----    -  - -  -    - --- -- -   -      -       -  -  -- --  -  - - -    -   -  -- -- --   - -
--     -    --    --      - -    --   --  - --      - --  -    --- --     -  -            -  - --  -
- -     - --    -   -       -  -       - -     -  --  -      -    -  - - - ---    - --  ---  -- -- -
-     -         --     - --  -    - -   -- -     -  -   -   - --        -       -      -   -       -
-    -  -    -  - -- -  - - -   -  - -            - -    -- -  -     -  ---  -  - --     -   -- ----
-  -    -  -       --- -         -      --- - - -  -     -     -   -    - - -     ---  ---         -
-   -- --     -- - --  -    -  -      --  -    -  -  --  -   - -     --  -    -      -    ---   - --
- -     -    - -   ---   -- -    - -  - --    --  -  -   -    -    -  --   - -   -- -         -   --
-    -     ---                     -     -   -  -- -  -  - -- -  ---  --     -- -   -- -   -    - --
- -        - -   -- -   --         - -           - -  -      - -       - -  -  -- --   --   -  -  --
-   ---  -- - -                   - -   - ----  --- - -   -  --  - - -   --     -  - -   -         -
- -    -    -   -    -   -    --      -     - -  -  - --  -   - -      - -     -- - --   -  --- -  -
- -  -   -   -        -  - - - - - --   -   -   - -         --           - --    -       -     - - -
- -    --  --    --     - - --  -    -       -  - - ----           -  -  ---  - - -      - - - -   -
-      - -    -  - - - -      - -          - --   -   --   --       ---     -        --            -
-  -- -    --      - --     - - - --  - - -    - -  -   - -   - - -       - ---    - --  -    -   --
-    - - - -  -- - -- --- -  -   - - -  --     - - -  - -   - - --   -  - -   -              - -   -
---   --  -          - --  - - -  -   -     - -  -- -   -           -   --  - -  -    -  -      -  -
-  -     -  --- -          - - - -      -  -     - -           -- -  -  -         -       -  -     -
-   -- - -    -  - -  ---      - -      -  -  -  -- -- --  - ---- -  -  -         -- - -    -      -
-   - -    -   -          -           -    -  - -    -    -- ---  - -      -    -     - - -     -  -
----------------------------------------------------------------------------------------------------
