100
100
----------------------------------------------------------------------------------------------------
- -  - - -   -       - -    -       --   - - -        -     -             -    ---  - - -  --  --- -
- -        --  - -  - -- - - -  -       -   -  - -   - --- -  - -     --    -                -    --
-      --     -  --- -- - - -   -    --  -  -   -        - --    -        --   --     - -   -  --  -
-   -  -     -    -  -  -  - -  -     -   --   -  -  ---  -- -   -  -- - --    -  ---     -  --- ---
-    -    --   -- - ---       - - --   - --  -  -        -      ---   -- --- - -  --    -          -
- -  -  -     -- -   -  -   - -     - ---     -    -   - -                  ---   --      -     ----
-    -   - -       -     --  -  -  -     --   ----      - -  -  - -- --         --  - --           -
- - - --    -  - - -  - --- -      --- -   --  -   -               - ----         --     --  -  ----
--      -   --    -   --  -    ---     -- -  - - - - -    - -    --  -  ---         - -            -
-     --  - --  -     -      -     --   - - --         -      - -         -  -         -  -- ---   -
-    - -   --   ----      - -  - - --   - -- -  -   --   --   -    - -  --  - ---  -         - -  --
-- --   -     - - -            -    -           -           --   -         - - -       -      - -  -
-  --    - - -    -   ---- -    -   -     -  - -    --  - - -     --- - --      - - -    -- --   - -
-     - --    -    -     -     -  - -  ---   - -----        -   - - -  -      -    -  ---- --   -- -
- - --   -         --  --   - -       -   -   --  - -   -  -- -        --   -- --     -  - -       -
- --   -     - --    -    -- -    -  -  -  --           - ----  -   --  --  -     - - --  --   -- --
-  - -  -      -  -      -   ---   - -   ---  -  - -   -       -     - -- -    -   - --   -  - --  -
-      -          -    -              -   - -  -    --   - - - -     -  -  -  - --    -            -
-           -  -- ---    ---  -   -   -   -     - -  - -  -     -- - - -   ---      -     -  - -   -
- -- -  - -    - -    -   - -   --- -  -       - - -  --   -  -        ----   -   -    -  -   -    -
-  -   -  --  --    -   - - -   -  -  -  -  - - -   -   --  --   - - -- -  ----    -  --  -- --  - -
-     - - -       --  - -   ----   --  -  -     -     -- -        -    - --       - -  - - -  -   --
-   - -  -   --     - -  --     --      - - -       - -- -      -- ---                   ---       -
- -  -      -  --         -  -   -           - -   - - - -- --               -        --    ------ -
-   --        -  ----   -------- --    -  -     -   --            -      -     --    -            --
- - - - -   --  -  - -                -     -      --  ---  - -   -  - -   -  -   - - --   - - --  -
- -- -  --       -    -    --   - -      - -      -  -- --      -  -  -   - -   -  - --  - --     --
-         -     -         -   -   ----      -  - --    -  -- -       -- - --    -  -     - -    -  -
- - - --      -  --   -     -          -- - -       -  - - -      - -  -  -  -  -  -    - - -      -
-  -   -   -  --    -  - -     - - - -        -   -  -      - - --  -      - --   -    -   -   --  -
-    -   -  --    -         --    - -  -  --  -  -     - -      -   - --     - - --             -  -
- - - -  - -     -   -     -  -  -            -    -   -   -  -- --     -   --  -  -  --    --  -- -
- - - -     -   -  - -   --        - --      -- --   -   --- -  -   ---   -    -  - - -      -     -
- - - -- -       -    -     - ---  -        - --  ---- -      -  --     -        -  -      - -     -
- --   -       -     -- -   - - ----   -   -     ---     -      - ------        -    -  - -  -     -
-- -  -   -- --  - -- -  - -     - - -   - -     -  -  - -- --   - - -            --    -   - - -- -
--     ---        -   -   -        - -  -  - - --  -      --     --     -- -      --    -    - - - -
-    -- -    ---      -    -- - - -  -    -  - - -  - ----    -    -    -- --- - -    -   -      - -
-  - ---       -       --   - -  -    - -  --    - -      - -  - -- - -     - -    -      -  ---   -
- - -  - - -  - -   -- -  --     -  --   -       -   -  -  - -   - -  ----     ---      --   --- - -
-      -    -         --  - -         -   --  -    --  - -    --   - - -           -  -           --
-   -   -   --  -  -      --        - -        - -    --     - ---   -- -              - -    -   --
-  - -     -   - - - ---- -     - -    ---   ---   -  -  -   - -- - -   -    -  -  - -  -  -   - - -
-- - --   --  -- -    -   - -- -  -- -- -        -   -     -       - -     -  - -   - - --   -  - --
-     - -    -  -    -    - -  - - -  -   -   --   -   - -  -  -    -   -    - - -    --- -  -     -
- -  -  -  -- --     --   -            -- --   ----- -- - -    ---   --    -- -  -- -    -     --  -
- -  -     - ---   - -  - -  -           - -  ---        -  --    -   -   -    -  - - - -  - --- - -
-  -- -- -  -  -   -     - - -  -      -      -   --   -  -    -    --  -  --         -   -   --  --
-- -  -   -  --        -   -        -- --   - - - - -  - - -    -  -   -    - -  --        - -    --
-      --  --     -         -        -      --    -  - -    --      --    -  - -   - --  ---     - -
-  -       --- - - - -  - -   --       -      -- - -    -     -    -    -  --               -  - - -
-  -     --       - -        -   --  -- -  - -     - -    ---- - - -  -       -  - -    -   -   -  -
--- - -  -  -  - --- --- - -  -      -  -    -   -    - -  -                              -- --    -
--       -  --     -    ---   --           --  --- -     -  ---     --  -     -   -   -            -
- -  --     -- -- -- -  --      --   -      --   --    - ---   -   -   ---  -   -     -  --  - -   -
-  --     - - -   - -     - -  -  --    ---  -       --  -      -    - -   --  -        -  --      -
-  - -   - --            -  --          - -   -  --      -- - - -  --   ---  -    - -- - -  --- -  -
--   - - -         -   - -   - -   -   -   --     - -  -    - - -- - -     --       -     - --- ----
- -       -     -   - --   --- ---          -- - -  --   -    - --   -        --   -      -  ----  -
-  ----         ---    --    -       - --  -  -    -  -  - -    - --  --   - -     -   --  - -     -
- --    -   -----           -    - --  -    --- -  -   -    - --    --   --  --       -   - -     --
-  - -- -- -           -  -  - - -         -  -     -   -   - - ---  - --  -        -  -   --   -  -
--- - -  -- -      -      -  -   ---  -    -    -   - --       --     -  -       -- -    -    -    -
--          ---   ---- -   - - -    -   - - --  - -- -   --      ----      -    - - -  -      ------
-  --   -     -      --         ----    -      -- --  -   -    --  -  -- -    --        -      -   -
- -  --- - -  --   --  -     - --        --- --     -  -  -- - -           --   --- -------        -
-  - -  -    -   -   -- -        --  -     -       -  -        --    -   --    -           -       -
-   -        -   -   -  - --  ---      -  --        -     -- - - --       -  - -   -      -    -  --
--       -  - --   -      - - -     - -   -  -  ---  -- -       -  ------   - --             -- -  -
-  -    -        - -         -- - -    -             -   --  -          ---  -     -    --  -    - -
- -    - -- -  --- ---           -  -     -    - -  - --    - -    -   -  -    -            ----   -
-- -  - ---  --  -       - --  --      -        -  --    --    - - - -- ----- -  --   -  -   - - - -
-   -  -     -     -- -  --   -  -    -   -  -         -   --       -       - --  -      - - -     -
-  - -   -- - ---      - - -     ----   --      -  -      -   -- - - --   -- -  -      - -- -      -
-  -      -  -  -  -  --   -     -  --       -   -    -    -    - -  - --    - -  --              --
-      - -    - - -     -       -  ---  -   -  ---   -   -   ---    -    -  -  -       --- -- --  --
-       - --- -   -   -         -- -  -    -  --  -   -   -  --  -   -      -  -  -   -            -
-        -         - -- -  --            -  -   -  -- -  -     --- -   -     - -- - - -    --    - -
- - -- -  -         - -    -  -  -     -  - ---- -       -  --     -          --  -  -   -    -- - -
-- -  -      - - -  ----  -   -     -- - - -    -     --   - ----   --  --  - - - --  - --        --
--  - -- - - -  -  - -- - - -  -  -       -  -  -             - - --    -      ---   - - - --  -   -
-- -  - - - --   -           -   -  ---       -  -   -         -- - -  -   -  - -  -    --      -  -
-                 -  -  - -     -   -   -    ---    -  -  -- -  - --  -  -   -   -- -  -  -      - -
- -  --- - -     -   -      - - -   --  -   -    -- -   - -  - -     - - --         --       -- -- -
-  -             -       -      - - --   --  ----  -     - -   --   -  - -    ----       - ---   - -
-  -  ---- -    -    --    -  -    -    -          -- -  -   -- -  -  -  - --- -  ---   -     -    -
- -     -       -  - -   -  -   - -- - - -     -  - --  ---  - - -   -    -          -  - ---  --  -
---  -     -  ----     - - -  -  -          -       ---    -   -  -      ---  - - --     -         -
-- -      --- -  -    ---  --      -  --  -  -      -      - ---  - -   -    -    -- -  - ---      -
-- -       -   --  - - -  --      - -  -  - -        ---        -    - - ----       -   -  -   --  -
-  --  -  -    -    -       --- -     -   -         -   -  -  -   - - -         -  - - -    --    --
- -  -   - -  - -  - - ----        -     -      - -   - -   -- --   -   -  -           -       - - -
-    - ---    - - -  -  -  - - - - - ----  -     -     - -   -        - -  -  -  -       --       --
-  --      --  - - -  --  - - --  -   -  -- -  --  -    -      -  - - -      -  --  --- -  -    -  -
-   --   -    -- -   - -  -   -      -    - -  --- --     -      -- ---  - -  -   --  -   - ----  --
---  - -- -      -- --   -        - - - - -   -  -    -     --  -      -     -    - -   - -      ---
-  --  -      --     -  --   - -----   -    -   --     --  - -   -                    -     -      -
- -  -   -    -    -  -              - -   ---   -  ---     -    -   -      -  - --      --  - -   -
----------------------------------------------------------------------------------------------------
