100
100
----------------------------------------------------------------------------------------------------
-    -- -      -      -    - -     -    -        - -        -           -        -   - -      -    -
-      --   -    - -     -      -    - -- -       - -   -    -  --  --  - -  ----  -- -    -  -  - -
- -      -     -     --    --  -         -  - -  - --    -  - - -       -       -    --- - - -     -
--   -- ----       -    ---  -- --      -  -  - - -        -  -      -      - - - -    - -         -
-    - - - -   - -- -- -  - -    -   - - -   - -   - -- --- -   --  -      -          -  -    - ----
- -- - -       -  - -           --  -- - -- -  - -- -        ----  -   - -  - -       -    -       -
--  - - -  - ---         -   -  --                 - --   -        ---   - -  - -   - -        --  -
- -    -   -    - - -  - - -   - -   - -- - - -  ---        ----  - --        -     -  --      --  -
- -    -   --  -     -    - -     --- -     --  -  -  --        - -    ---            -  --- --  ---
-    -        -    -  - -   -          -      - ---        --   -       - -          - - -   -  - --
-- -- - - -  -       ---  -    - -    - - -         - - - -  --  -   -   -   -     --     --    - --
-  -          --         -   -    -   -   ---   ----  -         -- -- -   --           -        -- -
--  --  --- -- -  -   ------   - -  -- -  -  - -    ---   -  - --         -           - -- ----  - -
- - - --  -      -       --       -    ---  -  -   - -     -  -  - -- -     -  - -   - -   - - -   -
--   -  - -  --        -   - -  -  - -       - --     - - --  -  -   - -- -   -  -- --  -  --  --  -
-   -   - ---     ---  - ---          -        - -- -  -    - - -     -  - --       --   -         -
--   -    -    -  ---  -    -- -- - - -  - -    -   -              --   --    --- -  - - -   -    --
- - -  - -  -   ---   - --          --      - -   -  - --  - - --        --       - - ---  - -  -  -
--     --- - -   -    -     - --  ---  -  -    -     -  -   -    ---    - -- --    - - ---  - --  --
- --   -  --   ---  -   -- -    --    - -   -    -     -             -   -- -    -- --     -    - --
--     -    - - - - --            -      -    --   --   -  -  -         - - - -  -  -     -      - -
- - ---   -  -   -     - - -     - ---  -  --       --      - -  - - -    - -    -     -       -  --
-       -  -----   - -         -   -  -   ----- ----- -     -  - -- -       - - -- - -    --      --
-  --      -   - -       - --     - ---      -         -   - - -      -  --   -           - -      -
-     --- -    --         -  --             -  - --  -   -     -- -        --   ---  --   - --- -  -
- --      -                    -        -    -  -      - - - --  -   -  - -  -- - ---     -    --- -
-     - --       -- -  -   - - --          -     -----    --    - -     -   --            - ---    -
-  --     -  ---    - - -       -    -- -   - ---      --- - - -- - --    -       - -   -- -   -   -
-- --     - - -- -  --    - -----     - -  -  -  -  --     -  --    -  -   -  - --           - -   -
-- -    --     - ---     -  -    - --   -      --        -   ---   - -         -   -       -- -- - -
--  --  -    --   --  -       --    -    -        ----     - -  -   - -      -             -  -    -
- -  -   -  -  ---    -   - -  -  - - -     - --   -      -          - --      - - --       ---  - -
-  -- -     -  --            --    -  -    -    -       -   - -      -- -    -  - -   -- - --  -   -
-  -- -   -    -     --  - - --   --- - - -        - - --    - --  -    - - -   -  --     -  ----  -
-  -   - - - ----    -   -  -  -    - -   --               ---   - - -       - -     --  -  -  -  --
-  - -  -- -           - -          -  -     -  -   -- -      ---- -    - - -     -      --  ---   -
-    - - -               -  -  -      -     -    --               --  -   -  -    --  -       -  - -
-   -     - -   - - - - - -    --      --   -  -   --    --   -    -           --      - -  -  -   -
--- -    --     -     -   --         --   -   ---    - -- -   --  - -- ---- -    --    -      -  - -
-  - -- -- -   -  -     --      - - --     --    - -           -   -   -  -    --   -  -    -   -- -
- - ----  -    - -              - --     -----  - -- -  ---     --   - -  -  --    -- -- --        -
- - -        - - --    -  -- -    - -       - -  -  --  -  ---   -          -   -               -  -
-      --   -   -   - --     ----   -   -   --  ---            -  - --    -   -  --  - -          --
- - - -   --  -  -- -          -  - - -    -        - ---  - ---              --   --  ----  - -   -
-   - -  - -    - -    - -    - -   - ---    - -     - -  -     - -   -    -  --       -     -     -
-- -  -  - --   -    --      -  ---    -  -- -     -- -    - -- -       -        -- -    - ----  - -
-       -  -  --  -    -   -  -         -   -- - -    -           -   -  -     -       -    -     --
----   - -- -     ---- ---     --- -----   -       -       -          -   -     -  - -   ---    -  -
-    -  -   -  -          -- -- -- -   --- - -     --   ---  -   - -              -   --    -  - ---
-       - -   -   -   -    --  -     -  - -- -  -     -  -     - -  - --   -         -   --   -    -
- - -  -       --  -   - -   -   ---         -   --- -- -     - -- -     -   -  - -     ---   -    -
- --  -  -  --       -     --- -    -- --  --          -  - -          -   -               -      --
- - - --  - -   -  -  -              -   --   -    -   -  - -      -- -  -        -   -   - - -- - -
-   -- - - -  -----         -- - - -  - --      ---     -  -   -     -  -  -- ---  -     --   -    -
--  -      --    --- --- -       --  -  -    - -    - -   - -    - -    - --- -   - -  -   - --  - -
--     -   -- - -  -  - -  - --  -  -    - -     -    -- - -  ---  -  -  - - - - -   -- --  -  --  -
-  -- - -   --   -     --         - - -    -    -   --  -   -     -   -             -  - -- - -   --
--  - --    - - -        - - - -  -   -    - -   -  --  -           --  --  --      -   -       -- -
-    -   -- - -           -     -  - -  --    -  --        ---     - ---   ---  -   -- -  - -      -
--  - -   -   -- -  - - - --    ---- -     --- -      - --      -     -      - --  -         - --  -
- -    ---     -    --  --   -- --- -     -  - -- -  -- -    ---    -  --  --  -   -  - --- -  -   -
-  -   -  -        - -  -- -    --- - -      --   -           -     --   -   -  -- --        -     -
-  -    -- - -    -   -  -- -    - -     --    -    - - -- - - -- -- - --    -    -  - - -   -   - -
-  -      -  - - - --  -- - -  -  -       --   -      -  --- -- --- -          - -       -    - -  -
- --     - -- - - -         - -  - - --    -    -      - -   - -  --    -   -    -  --  -   - --   -
-             - -- -  - -  - -   -  -  -  -  -   -  ---    --    -  -    --- --        - -   - - - -
-    --      -   -      -    -    -      - --- -     - -     -    -     -   - - - --       - --    -
--       -   -  --   - -   -  -    -   - -    ---  -     - -   - - -    -- -         --  --  - -   -
-   -      -      -   -   - -         --  -  -  - - -  -  --          -   --   --           -  -   -
- -  - - -- --    --       -     -   --      ---  - -  -       -   -       --- -  -      -     -   -
- - -- --      --      -   ----        -   -- -        -    - --   --  - -   -    -  - --    -  -  -
-   -         - - --    - --  ---  --  - --    --    -  -   -  --    - --  --  --     - -          -
- -     -   -  - -    -  -  -     --      - --  -      -- - - -  -- -- -     - -     -     --    - -
-    -  - -  - ---   -  ---   --- - - -       -   -  -   - -- - -  -     -- - -          -  -  - - -
-  - -    -- -    --   -    --   --        --  -       --- -   -   -    - --     - - --      - -  --
- -  -   -  -- - -- --  -- -  --  - -    -  -      --  --  ---- --- -  ---   -               -     -
-   --     -  -   - -  -    -- - -  --- -     -   --       -     -   --             -- -  -  - -   -
- -    -  ---  - -  - --      -  --     - --   -   -   - -   -   -   - --   --    -- -  -   -- -   -
--- --  -      -  -  -     -      - -  -         -   -       --    -  -          -  - -   - -   -  -
-           - -   -- --   --- -  - - -  -   -       -     --   -- - -    ----    --       ---     --
---  -  -    -     -  -     -     ---         -  --   -   -  - -- ---  --         --  --- - - -  - -
- -- -     -    - --      --  --  -- -             -  -- -    - --       ----      - -        - -- -
--  - --  -  -            - ----  -  - - -   - - --      - -   ---  -   --  - -  - - - --     -- - -
- - --- - --      -  --  --      - - -    - -      -           -    -          --- -     -      - --
--  -   -     -   - - - - ------ -  -      - - -  -     - - --    -  - - -     -- ---  - - -   -  --
--- -   -    --      --- -  - - --  - -  -                  --  -           -   --    --     -     -
-      -  -   - --  -   -   -   -       - - -      - -- -      --   - ---  ---   ---    -    - - - -
-  -     --      -             -  -      - -   - -        --   -   -         -           - --    - -
-      ---  - --   -- --  -      -  --  -       -   -  --  -  - -  -   - --       - -   - -        -
-  -   - - -  -       - -     -    - -- -- -  -   -  -           -  -  -      -- -     --   -- - - -
--- -            -- --   -               -   -    --- - -    - - -   --   -- ---       - -    - -  -
-  --             -  -       --      --   - -         --        - - -           -       -        - -
- - - -       - - - - --     -    -       - -    - -         --  - -  - - --   -  -   -   -  ---   -
-   - -     -  -         - -    --  - -- -- - --  --  - - - --    -            -    - -  ---       -
-- -  --  -    --  - -    -     -  - --     -   -      -   -  - -    --     - -   - -             --
- -  --  -   -      -    -     - -      - - -- ---       -- --   -   -        -  -    - -  -- -- - -
-  -- ---   -  -      ---  -  - -     - - -- -   - -  -               -    --  -   -      -  -  -  -
- -    -  - -    -  -----             -             -   -   -       - - -- - --- --  --     - --   -
----------------------------------------------------------------------------------------------------
