100
100
----------------------------------------------------------------------------------------------------
-  - - -       -             --  -  --   -  -             -        -  -            - --            -
-       -      -- -       -- -  - -  - -- -  -  -  - -  --  -  - --  -     -- --     - -  - -     --
-  --- -  -   -         -- - -      -  --     --- -         - -   - -- -   - --   - -- -      -   --
--  - - - -  ---- -     -     -   - -       -      --- ---- --   -- -  - -  -   --- -  - --       --
-    - -  -      -    -     -  -  -    - -  - --   -       -   - ---         - -   -  -      - -   -
-     - -     - - ---   --    -       -        -  -         -       - -   --  - -     -- - -   - - -
-  --     -  -  - -  -  -    - --- -  - -   - --      - -    -  - -  -    -            -     --  - -
- - -- --     -  -       -- -       --  -        --  -   -       - --   -     - -   - - ---  -  -- -
--    - -   -  --    -             - -- -   -   - -       -  - - -- -      -   -- -   -  - - - - - -
- -- --   - --   -         -   -- --     -  -   -   - - --   -     - - -- --  -     -- -  -      - -
- -      -    -  - - -  -  --        - -   -- - -    -    - - -   - --  -   - -   -   --     -     -
- ---- --      --      -          -  -    ---  -     --- -- -- -           -      -     --  ---    -
-       - -         -  -   -  ---      ---   - -   -     -  --   - -  --  -     --   -   - -       -
-  -- -   -    - - --   - -    -  -- -  -  --  - -    -    -     --   -    - -   - - - -  -  -   ---
-  -   -      -            -  -   -      -   -   -  -  -- -   -   -          -        -   - --     -
-  - --      -- -  -- -  - -   -    -    -    -    -   - - -     -   - - ---    -       -      - - -
-             -  -       --  -- -   - -- -   -- -     -     - --     - -   - --  --     - -- - -  --
- ---     --   --- -  - -   -   - - -  - - --     - -         -   -        -    - -    --        - -
-- -     -  -           -   --  - -     ---       - - - - ----     - --  -     --     -    - -     -
- - -   -   -- -  -  - -   ----  -    - -    - -    - - -      --  --  -  --     -  - - ----  -  ---
-  -- --     -  - --  -    ---    --      -  --  --  --- - --      -          ---    - -  - --  -  -
-   ---        - -  -   -   - ---     - --  - --- -- - ----     --     -  -  -    - -  - - - --    -
- -          - -  - -   --- -  - -- - -    --    - -  -      --   -    -        - -       -        -
-   - -  -     -  -      -               -   -  -   -    -                 -   -    --- - - - -    -
---        -    -   -- --     -- -  -    - -     - - ----      -   -- - - -  -   -   ---     --  - -
-   -- ---  -    --  -- -   -       -  -- -    -  -        -         ---    - ---   -      - ----- -
--  -- -- -      -       -  -     -         --- --  ----- -   ----      - --  -  --  --     -    - -
-   - -         -   -   -    - -  -  - - --    -             -   --  --  -    - --  -     - -- -  --
- -   - -               ---  -   -     -   - - -    -- - ---                - -   --- -     - -- - -
-   -          ---    --            - - --- -  -  -  -      -  -- -   -  --  -  --      -- --      -
- -- - - -- -         ---        - - --    -    -- --  --         - --      -  -  -   - -     ---- -
- -- -   -   --      -     ---  -- -   - -   - -    - --   -    -   - -  - - -  --    -    -  -  - -
-   --   - --  -      -  -      -   --- --   -     -   -     --   ---- -   -  ---   - -    --     --
--   -- - -   - - ---     -  -    -    - -   --  -  -     -    -- -        -        -    --        -
--   -  - -  - -       - - --   -   - -- -        ---    -   - - -  ---    -  -- -     -           -
-- - - - -   -       ---  --  -     -    --   --     - -      -      - - -   -  -  -- -   - - -   --
-    - - -       -      -  -     - --    -- -  -             -  -      - --   -  - -   - -   -     -
-    - -      ---- --   -    -    -   -   - -          ----       - - -         -    -- - -   --   -
-  - -   - -  -  -  -  -  -  -  - -  -  -   - --   -  -        - - -          -      -   - -- - -  -
--   -   - -   --  - --  -    ---    - -  -    -  -   - -- -- - -  ----     --    - -    -         -
-  -    -          --      -    -- --   - - - -    -    - - -  -      -       -- - -  - -     -    -
-   --- --- -   -      -  -          ---- - -  -        -   - -   ----     -        --  --- -- -   -
--         -   -  --   -  - ---    -      -        --  -               -      - -  --    - - -     -
-   -     -- -    -  - -- - --   - - - -    - - -    --   -      --     ---  - -  -  -  -      --- -
-  --- --   - --    - -- - -- --     --      -   - --- -- -         - - - - -    -       --        -
-       -  ---   --      --  -     - --    -  -   - -     -  -    -         -  -      --  - -      -
-            - -- - --- -   - - --  - -  -   -- -   -  --  - -- -   -  - --     -   -  - -   - --- -
-  -    --- - -   -    --         --   -  --   -     -   -    -  --   -          -    --  - -     --
-  -  -- -  -  -    -     -  -        -  -   - -     -   -     -  - ----       - ----         -    -
--    - -- -     -   -    -    - ---       -   - -- -  -        - --   - -           - --  -  --   -
-- -    -    ---       ---  ---- -             -   -     --- -- - ---- - -- - - - - -   -     -  - -
-       - --          - -   --  -  -       ---      - --            - -  -   - - -- --   ----  - - -
---    - -- ---     -   - - - -        ---      -       -  - - -  - - -- -     -         -   - -  --
-   -    -   --    -  -     - ---- --   --  -   --      -       - -        - -    -- ---  - - -  - -
-  --       -- --  -  - --- -          - -  -   -   -  -   -- -     --  ---   - - -- --  -    ---- -
- -  -   --   -   -    - -      -     -  - - - --    -  -   ----        - -   -- --    --      -   -
- -      - - -        -   - - -         - -  -  -  -   - --        - ---    -    -        -  -    --
- -    -     - -  -     - - -  - -  -  -   -- - - -   -- --- -  - -  -    -  -  -  --- -      -   --
-   -        -        --  -      -     - --       -- -    -       -       -   - -- -          --   -
-    -  -- -    --    ---  -   - -    -    -  -----  --       --  -  - -    -  - --       -      - -
-   - --   -- -  -  -  -   -  -   ----    -  --    ---          - - -    - -       -   --  -       -
- --    - -   -            --  -       - -  -      -      -   --   -      -   --     --- --  - -   -
-           -      - --      --  -      -       - --   -- -   - -    --      - -    -  - - -      --
- --   - --   -- -- ---      -  - -    -  - - ----   ---     - --     - - - -   -   --    - -      -
-   -    -         --  - -   - -  -- -   -  -       -       -  -    -  --  ---                   - -
-  -- -   - -    - ----  -       -    -  - --   -  -      -   - - -  - -      --  -        - - -- --
- -  -  -     -          -  -    -     -           -     -  -- -  -  -   - --         -     -    - -
-           - -  -  -     -   -      -- ---  -   -- -  -  --                    -  - -       - - - -
-  -- -   -     -  - -  -   - -  - - --   -  - -         - -     - --    -  -      - --- -      -- -
-  -  -- -    -     -  -        --   -   -    -     --- -      -   - ---  -     - -    -   ---     -
- - -  -  - --    -   - -   - -    -- -- -   - --      -         -        -   - --- ---- -- - -  - -
-  - -     -  -       -   --  --- --   -        ---   -  -- -  - -    --- -     - --      - - -    -
-   -   --    - --     --  ---  --            --      - --       - -  --  -   -- -   -     -    - --
-    --           -  - - - -  -     ----  --        -  -     -  --   -       -   -  -    -- -   -- -
--   - -         -   - - -   -          -   ---   --     -     -    ---            -    -     -    -
-- -  --  -  -    -  -   -   -- --        -    -  -  - - - -     --         --- -       -   -     --
- --   -      -   -        -- -    -         - -  --     -        -  -- --         -- ---   --     -
- --      -   -    -      -- -       -     -  - - - - -  - -   - -  -  -    - - --- --  -  -  -    -
-         - -    --  - -  -  - --    - - --     --   -       -         --    ---      --  -- --  - -
- -    -- -- --   - -   -  - -    --  -  - - -  -     - -  -   - - --  - -        -       --  -    -
- -          -  - -   -    -    ---  -  - -      - -        --  -  -   - -- -         -        -----
-  -          -   --      -     -     - -- --  - -- ---   -    --   -   - - --   - -   -  - --  -  -
- - --     -    - --    -- -      - - - -   -- -- -    -      -  -- -   -   -  -     -  - -- -    --
-        -      -  -  -  ---  - -    - - - --- -- - --   -  -     -  - - --   -  -    ----  -   -  -
- --        -     -  - - -    --   -        -- --     --          -  --  -    -   - - -   --  -    -
-     - -- -   --- -      -  - -  --- - ---   ---  - -  - --     -    -       - -   -   --    -    -
-  -     -   - --   -    -           --  - - -     -  - -- -  --  - -  - - --   - -----  - --    ---
- - - - -   -- - -  --        -  - -- -   -    ---        - - - -   -  -       -  - - -         -  -
- - - -   - -  --  ----  ---     --  -----         - - -        --    -       -      -- -- -- -  - -
--  ---  - ---            -     -       - -             - - --  -      --  -  - -      - -         -
- -      -     --- ------  - - -  -  - -- -      - ---  -      - -    -      -       - - -  -     --
- - - -  -    -- -    --      -  -- --     -     -     - - -     -  - -   -   -  -   -  -- - -- - --
-      --  -    - ---   -- -   - -  -   -      -  --  -  - -    -          --     -     - --       -
--   -   - - - ---  - -      - -   - -   -  -  --     --   -      --       -      -   -       --   -
--    - -- - --   --   -   - -  -  -   -      -        - - -- - -- - -    --   -           -  -    -
- --   -- -     -      -    - -          -- --    -----          - --     -     --  --     - - -  --
-        ---- --   - - -    -   --  - -- - -      -  -    ---   - -      -     -   - -- - -   -    -
-  -                 - -   - --  - -- -      -         - -   -   -      -    --      ---   -   --  -
----------------------------------------------------------------------------------------------------
