100
100
----------------------------------------------------------------------------------------------------
-      - -   - --       -        -   -- --       --   -            --- -         -   -     - - -   -
-                 - ----     -   --   -   -   - -- ---  - - -            ---   -- - - - -    -     -
--- --          -        -    -  -   -     - --- -   -     -    -  ---    ---- -  -       - -    - -
--  -  --   - -    -   --     --          -  --    -- -    --    --     -  -  -  --  --   - --  -  -
-     ------ - -           -    -      ---  - --- - - --- -    --     --       -    ----     -   ---
- --       -  -   --  - -     -     -  -                     -- -      -          -  - -   --      -
--- -       - - -         - - -  -        ---- - - --  -      -  -  - ---  - -   -    -    -  --   -
----      - -    -   -           --          - - --  -      - -  - -      -  - -  - -   ---  -  -- -
-        -  --   -  -  --  - -      --   -  -    --     -     -  --  - - -- - -- - -  ---      -   -
--    - - -   - --- --   --     -   --  - -    - --   -  - - - - - -       - - --   -     --  -    -
-     -     -   -   - - - -- -- --  - -     -           -    -   --  -   -   --  --  -   -- -  --  -
-  -    -    -   -  - -- - -      - -- - --    - --  -  -  - -    -      - -     -   ---       - - -
---         -- -    -      -           -      -   -          -  -    - --   -  -- ---- --   --   - -
- --             --   - --     - --  - ---    -   - -- -  -   - -   - -    --      -         ----- -
-    -  - -- -   -      - -   -- -     -       -- -- -     - -   -  --     -   -  -- - -      -    -
-  - --            --      - -    - -     -                     -  --   -  -  - - --     --    --  -
-  -   -- ---    --   - --      -  -  -  -  -- -  -  - --   ---        - -  -  ---   -     ---     -
- -            ---         -     --- -   --  -     --  --             - -  - -     -   --  -  -- - -
- -  --   -     - -   --    --    - -   -   -   --  - -  -    -      -- -    -- -- -         -     -
--  - -     -         - ----  -      -      -      --     - -  -   -        -    -   --  ---   --  -
--   -     -  -  - -  - - -   ---   - ---    -      - -   -   - -   - ---       -         -    -   -
-   -  ---       -     - -      -      -   -   - -     -  -      --       -   - -- ---- -    -    --
- -    -       -- - --- -- ---- - --       ---   -- - - -   -  - -   -- -     --      -     -      -
- -        -     - -       -            -   --  --  - -- - --- -   -- -    - -  -     -    -  -- - -
--  -      - -    - -     -- --    - - - ---   -   -- - -    -   -        -         -  -- -     -  -
--    -        --       --   --    -  - -  -  - -    -    -   - --  -- -    -- -  -   -- -    - -  -
-   --  -    -   --     ----   --     -        -    -  -     -      - - -     -    --   - -       --
-  - -  - -     - -   -      -  -  -    --    -     - --  -    ---  -   --     --- - - --- -    -  -
- -                  - -  -         ---           -       -   - -  -- -  -   -    - - -   -     -- -
-   - -    --  - --  --  - --   -  - - -  - --  -   --- --- ---         --  -  -         -  - -   --
-    - ----  -    - -         -   - -     - -    ---   -    ---  --      -   -      - -- -     - - -
---    -  --  ---   --     -- -- -  -      -    -  --        -       - -    - - - - --    --    -  -
-      -  -  -- - - --     -        --  --- -     -       -        --     -    -    - - - -       --
-   -         - - -   -  -    - --   - -            -  -        - -           -    -  -  --- -   - -
-    -      -    -      --         - - -- -  --    - - -  - - - --   --         -   -   -      -   -
-  -         - -  -   --    - -  -   -  -         ---  - - - - -  --  - -           - -  - - ----  -
-   -  - --    - -    -- - -   - - -      --  - - -       -  -- --  -       -   ----   --    - -   -
--   -- -  --     ----        -  -   -- -  -  -       ---   ---    --     -- --  - - --     -  -   -
-    -          -   -   ---     --          - -  -    -   --   -        -                 - - -    -
-- -       -  - -- ---       ---      -   -     - -     -   --  --               --- -  - -  - --  -
-   - ---  - -      -        -  -    -     -- -   --    -    -      -  - ---  -        -- -       --
-  -    -- - -  -   -     --  ---   -   -- - - -     - -   -- -- -         -     - -- - -  ----    -
- -  - -  - -- - - -  - --  -    -    -   -   -    -  -- --     - --- - --   - -    -- - -      -- -
- - -- -       ---   - -         -  -   -- -- -      - -   ---   -  -     --  - -            --    -
--               - -    - - -  -  -     -     -   -  -       -   -  - - -  - -    - -- -           -
-   -     - -   --     --   --- --  --   ----   -    - --     -       - ---     --   -    --- -    -
-   -       -    - --    -     -       --   --   - -   - --    - --       - - -     -  - - -    - --
-  - -   -   - -   --  --  -          -  --   - -         - -- - - - - - -    -   -  -         --- -
-- -    -   - -    -      --   --  -- -  -    -  -   -          -   -        -   - -    -          -
-  - --   - -   - -  -  -   -  --     -  -  - - -- - - - -        - -- -- -- -    - - -  -   -     -
- - -  - --  -   - -- -- -       - --  ---  -    -    - - --- -      - -- -- --  - -    - - --  -- -
-  - -   --       --    -    - -  -  --  -               - -    - - -      -    --    - -    --    -
-- - - -   ---- -- --     - - - - -       - ---       -                  --   --  -   - -       -  -
-       -    -   - -     - - --   - - - -  -   -- -     --    --  - --  -  - --   -  - - - - --   --
-  - -      --           --       -- -   -    -    -       --     --     - - --   -   ---    - -   -
-    - -    -- - -   -  -  - - - - -  --    -    -  - -  - - ---    -            -      -   -  - - -
- -   -    -      -  - - ---- - -    -          -    -  --  - -      -    -         -      -       -
-    - - -          -          -  --        -    -           - -    - - --     --   - -        - - -
--          --    ----  --      -   -- -  -  -              - -         - -  -- --      --- -   -  -
- ---  -  -   -- -  -     - ---   --     -          --      - - -             -  - -        - --   -
- -  -    --      -   ---    - -- -- -  -         - - - -    -        -    -  - -   -      ----  - -
--   --    ---  -     -       -     -   ---   --    - -   -     -   --- -- -  -    -  --   --    - -
-    - -  -     -      -     - -      --   -             -    -  ---     - -    --   -  -   -      -
--- --    -  -- -    -- - --        -   --      - -- -       - - -  -     --   -    - --       -   -
-  -    - - --   -- - --   --   -  -  -   -- - -  ---  - -   - --  - - -   -  -    -     -  -  -   -
-    -     --  --  - --- --      -  - --- -   --    ---     -   -   ---  -    -- -   --  -       - -
-   --   -    -    - -       -- - -     - --       -        -- -  --   - -       - -     - -      --
-- --  -      -   -   --          -  --      - --  -- ---    --   -     -  -- -   ----     --    - -
-    - - -  -    - -  -  --  -  - -      -  -  -       ---  -       -   ----   - -    - --      -  -
---   -     - -      - - -  -         -  -   -- -    -   --     -     -     --     -     -         -
-       -- - -  -   - -       - -   -   --- - -  -   -        -   -     --   -  --       - -     ---
--   -   - - - -- -  ---       - --- ---    -          - --       --     -- -    - -- - -  -   --  -
-      -    - - --   - --  --   -- - -  -- -  -  -  --        - -   - -       -       - - -      ---
--   - -    - - - -   --      --   -       -      -    ---  -    -- -- -  - - --   -    - - - ---  -
-     --   -   --- -    --  --   -      - -- ---- -  - ---- ----      - - -  -    - -   ---- -- - --
-- --   --   -- -    --  - - - -  - --     --         - -  -     --  - - - - -  -- -  - -   -    - -
--    - -   -   - - - -  - -   ----      --  -    -  -        -    -   -  -           -  --- -     -
-      -  -   -    - - - -   -            --- - - -  -  -  --    --      -          - - --  -   -  -
--    --  -    - -   -    --      --      -    -    --        -  -   -       - -  - - - - -  --- - -
- - - -   --                 -  -   -    -          --   -   -  -    ----   -    -  - - -    -   - -
--   - -     -     --   -    -  - -   - -        - --    ---  - -      -- --  -     - --  -       --
-  - - - -   - -    - -    -     -   - -  -  -  -  --       --     -  -  -        - -  -          --
-   --  -     ---     --  --  -   -            -   -     --  --- -  -- -   -  -   -- ---  ---- -----
-  -    -  -  --- -  -        -- -  - -    -    -    -   - - -  -  - - --    - -   - -  -- -  -    -
-   - --      -        --    -  -   -   --   - -  --   ---  - -  -    - -     -   - - -     -- --  -
- -   --- -- -  ------- --    -     -   - - --   - ---      -  - -  -- -- -   -   - -  - ---  -    -
-     -           --  -    -         -- -  -  -   - -   --     -    -      - -  - -   -    - -  -  -
-----     ---- -    -   -     -  -- -    --     --- - -   -          --- -   -  -      --    -     -
-     ---     - -     - --  -   -    -    -   -   -  --- -   -     - - -    -   -      - --   - -- -
-   - --   - -      -  -    -  - ----- - - ---- -  --           -- -     -  -      - -    - - -    -
-    --  -  - - - -   - - --           -      - -  - --- --  --     ---- --   - -       -   --     -
- --    -- -    - -    - -       ----  -  -   -   -  -    - -  -- - --  -  ---- -  -    -          -
-- -  -   -     - -    -  -   -    -   -    -   -      -- --                  -        -     ---  --
- ---  -    -     -  - -   - -  --- -  - - -  -      --  ---   -   - ---    --            ---   -- -
-      -  -- - -   - - -   - -     - - - -     - - -   -          -      - -    -   - - --  - -    -
- - - -   - --  -     -  -     -- -     -  -  -    - -   - -  - - --   -  - - - - -      - -- -  ---
-- - -   -   -               -  ---  -  -   -    ---  -  -   -    -- --  - -        -- -         - -
-  - -      -  --    -    --     -    - -           - - -  --       - - -   - -   --       -   --  -
----------------------------------------------------------------------------------------------------
