100
100
----------------------------------------------------------------------------------------------------
- - - --                              -   -   -  - -        -   -  -   - -    -          -     -   -
-              -        ---      --  - --  -- - -     -  --- - - -    --  -      - - -  - ----   - -
-  - - -  -   - --      -    -       --   - -     --    -    - -   -- -     -  - - - -- -  - -  -  -
- - - -    -- --    --   ------          --      - -  -   -   -   - -     ---  -    -  - -  --    --
-       --   -      - --   -   -      -        -      -      -  -    --     -  -    -    - ---  ----
-   -   -  - -    -      -       - - -    -  -  -   - --       - -    - -  -   -   --       - - -  -
-  -   - - - -  -   -      - --            - - - -   ---  ----    -  -      -  -   -  -   --  --  --
-   --       ---     -- -   -  -   -  - -         -     -      -           -  -    - - -      - -  -
- --  -- - -  - -     --- -      - -  -    - -       ----         ---   -- - -  --  -  -- - --- -  -
-    -   -  - -- -  -     -   -     - -      - - -  --      --- -     ----             -     - -   -
- -  - - -      -- --- - -  -    - -    -   -  --    -   -   -  -   -     - -    -  - -   -  - -   -
--           ---   -  -    -   -  -   - - - - -   -    - -  - --      -    -  -   -    -    -- -- --
-      -                 -      - --     -- - -  - ---  -   -        ---    -- --  -- -  -        --
-     -   -- -  -- -   --   -   -   --     -  --- -  ---   --       -    -  -- - -- -    - -  --  --
-  - - -  - --   - -- --   -  ----       -  - -  --    -                - -    --  -    -    --   --
- -  - -- - -  - -       ---   -  - -- -  - -         - -  -     -  ----          - -  - -     --  -
- - -    - -- --   --   -      -      -  -  -     -       - -     --     -  -  -    - -  -   -- -- -
-  -----  -     - -- --      -   -  -  -- ---  -  - - -  - -   - -   -   - -        - -- -         -
- -     -      -    -   ----  - -       -       -   -  -- - --  - -     ------  --  - -            -
- -   --- -- -      ----    -     -    - - -  -   - - --    - -    - --            -   - -- - - -  -
-           -    -      - -      - -  -  -- -  --- - -    -- - --   -     -    - --     --    -  - -
-   -  -  -- - -    --  - -    ---    - -- --      - - -   - ----- - -   - -    - --    -  -  - -  -
-  - --         -     -   -  -    - -- - -      --- -   -  - -               -    -    -   - -- -  -
--        --    -   -   -   -  -  --        -        -  ---    -        - -         -       - --   -
--  - -   -- - --   -      -   -        -   -  -  --    - -   -  - -  -     --   -  -   -   --   ---
-     -   - - -         -    -     -  -  --- -   -    - - - -  - -- - -- -       --       -- ----  -
- --    ---  -      --       -     -    -   - ---         - - - - -  -    -   -- -         -     - -
--   ---  -  - -  -- - -  --              ---   -   -     - -   - -    ---    -- -  -  - -- -----  -
- --    - - -     -   --    ---          -   -    - -- - -   - -- -   - - -            -         - -
--- -  - -   --  -     -       -   -   -  - -         -  -- - -  -- -   - -   - -    -  - - --  -  -
-      -    -     -   -     -- - -  - -  -     - -  --    --  ---  -    -     -- -- - --    -    ---
- --  - ---  - -        ---  - -   -     - --  - - -   -  -  -  -    -         - -   -  -    -  - --
- - --  - - - - - -  -       - -     --- --    - -   --  - --  -- - -     -  --   -   - -         --
-    -      --             --            - -  -     - - --   --   --    -    -  - -    - -        --
-  - -- - --         -      -       -   ---   --- -  - - --    ---    - -    -   - - -- -  -   -  --
- --   -  -    -   -      - - - - -- --    -    - -  -   -  -    -        - -    -    -       -  - -
-   -   -  -  -    - -   -  -       --    -  -      --     - --     - - -  -        --  - - - -  - -
- -  - - - --             -- - - -     -         --      -       --      --  -      -              -
-     -     - -- -  - -    -    --  --- --- -----  -- -  -- --- - -   --         --  --    -  -    -
-    -  - - -       -  ----  -     -   -  -  -  --        -  - --     -  -   -    -                -
- -  - ---     -       -           --        -     - --  -  -   -  -   -   -     -    -    - --    -
-       -  - -    --  - -   -- -    - -   -   - --        -- - -   -     -   --  - -      - - - -- -
-   --   - --         -    -      - --  -  -   -    -  - -   -  -   -       -  -       - -- --     -
-          -   -  -- -  - ---- -    -    - -    ---- -  -  -- -   -   -- -   -  - - --  -      --- -
--      -- --  -    -- - --  - -  --              -  -     -   - - --  -  - --  - --   -         - -
-      -    --      --- - --    -- - -                 ---  - - -    -    --  -  -  --  -     -    -
- -  -----     -   -  -  -    -    -  --- -   ---  -  - -       -    -  -  - --  - -- --          --
-            -      -       -   --  -       -- -- -  -    - - - -- -- -  ---- - - -      -   --- ---
- - - -  - - -  --      -  -  -- - - --     - -  - --- ---  - -     -     -     ---      - - -    --
-  -  - -- - --  - -  - --    -       -   -    -    -      - ---- -   -    -  -      - - -  - --   -
- ---    - - -     --         -  - -        -   -  -   - --     -    -     -     - -    -   -    - -
- -- - - - - --        -  --  ---- -        ---      --- - ---  -  -  --    - -  - - -   -   -     -
-- -   -  -   -     -   -- -   - --       -    -        -   - -   -  - - - - --       ---- --   -  -
-     -- -  - -  -- -   - - --            ---- -   -- --- -    -              - -  -    -   - -    -
--    --  -    - - - -  - - - - -  -    - -- -    - - - - -   -   -   -            - -  --         -
- -      -      - -     -      -       - --       -   --   -  - -  - ---      --   -      --     - -
-      -   -   -- -   - -      -  -   --  - -    -    -  -   --    -      -  - --      --  - -    --
-   - - -- - --   -       - -    - -   -     ---  -                 - --   -   -- -             -  -
-    -  --   -   -        - --            --     -   -  -     -  -    - --           - -    --    --
- -  -      - - - -- -- -   -      - -  - - --       -     - -   --  - -   - - -   -     -   -     -
-  - -   -- -- -   -       --   -- -  -- - -    -   -  - - -            -     -  --  - -   -      --
- -    -      -  - - -   -  --    - -        ----    -- -   -      ---          -- -       -    -  -
-    - --  --    - -     - -      - -      -- ---  - - -  -    -  -   - --  -  -   - - -  -- -     -
- -    -  -   -    -       -- -    -  -  - - -     ----  -  -   -- --      - - -  -  -        - -  -
-  - -      -  -  -  -    --  - --  -       -----     - -   - - -     --- - -     --     -  - -   --
-       - -            -    -      -     -      --      -  -      ---   --      -  ---        -    -
- - -   - -     - --   -     - -     ----      --     - -     -    -     -   -  -   - - - -      - -
-  --- --    - - -     -      -  -      -    -  -   -  -        -     - -- -    ---      -     -   -
--- - - -     -  -   - -        -- -      -  -    --  - - -     - --- - -   ---   -   - - -- -   ---
---          -     - - -  --- --    -- --   - -  - ----     -   - -        -   -- - -       -    - -
--  - - - -   - -   -    -    - -     -      -        --- - - -    -- -        -  -  -  -     -  - -
-        - --    -  --     - --      -  -     -- -       - -  -  - --  ---- -  -             - --  -
-    -   -     -- -- -  -   -  -  -- - - -----  -       -       -  - --- -   -       -    -   -   --
- -  ---       -  -   - - -- -   --    - -  - -      - -  - - -  -  -   --       -        -  -   - -
--     -- -         -      -      - -- --      -         -  -  -- --        - -    --   -    - - - -
- -----      --       - -       - - -    - - -              -- -- ---      --  -   -       --      -
- -   - -          --     --    --  -       -- -   -  - -- - -- - --        -   -- --  -  -        -
-       -- -   - -  -- -    -    - -   - -    - -  --      -  -   -  --  -    --- -   - -  -       -
--  -- -     - -    -  ---- - - - -          -    --  -         - -      - ---   -  --  --   -  - --
-    -   -  --   - --      -     -    - -   -  --    -  - -   --     -- - - -   - -   - - -  -- -  -
- --- ---   -        -     --    - -  --- -    -   - -      --   -           --   -  -      - -    -
-    -    - - -  -- -            - - -   - -   - --- -- - -         --       -- - -    -- -    --  -
-- -  ---    -     - - - -     -            ----  ---   -   - -      - --    - --       -  --  - - -
-    -     ----     ----- --  -  ----   - --  - -   - - - - -   -- -  -- --   -     - -- -      -  -
- - -   - - -  --  --    -   - -  ----  -   - - - --   -       -   -   -   -  -  -       - -       -
-  -  --  -- -- - -   -- -- - - -    - - - - --  -   -- - - -       -   -          --     -   ------
-   - - - -  -  -- -  -   -       ---  --  -        --    -  -     -    - - -   --    - -    -  -  -
---         - - -  - -  - -   --            -  ----- -    --      -        --   -- -   --   -  -   -
-  - --   - - -    -   -- -     -   - -      -       - -  -   --     -      - -- -   --- --  -   ---
--  - -  -        - -       ---  -       -- -    ---    -  -- -   -           - - -  -  - -   -    -
- -  -- - -       --         - - -      --   -  -        - -   -        - -    -      -     -  --  -
- ----          -    -  -- - - --   -  -     - --       -   - - -  - -    -     --   -    -  -     -
-  --- --- --   -  -- -     - -  -   - -    -  - - -     -- -   -        -   -      -   -  -  -  - -
-  ---       -    -   -    --    ---   -      - -- - -  -  --       -    -   - -     -   ---   -   -
-    -  ---- -    ---   - -   - -    - -          -- - --      -        -  --             -    -  --
-           -  - --    -    -  -        --     - -       -- - -   - - ---    -   - - --- -- -      -
-            - -  -  -   - -       -  - -   --  -     -  --  -        -  - ----        - - --    - -
-      -               -     - - - -          - -   --      -   -- -    -    - - -- -   - -  -- -- -
----------------------------------------------------------------------------------------------------
