100
100
----------------------------------------------------------------------------------------------------
-          ---      -    -     - - -----  -  - -           - ---             -   -  -           -  -
-  --   -     -   --   --   - --  -     --  -    --- - --   -    --  --    -  --        - --     - -
- -  - - -         - --  -  -  -  -- --   -  --      -    ------           - -  - -          -- -  -
-  - - -     - ---  -  --- - --- - --    -    ---    -    --     -          -   -      -         ---
-        -  --- - -  - -    -  -    --  - --  --     -- -- - -  -   -   -   --     -     --      - -
- -   - --     -               -  - -       - -      -- ---- -   -      - -  - - - - ----     -- - -
-  -    - -  - -     - --  -     -  - - -  -    - -  - - -   -   -   - --  -        ---  -  -- -   -
-  -       - -   - --    --          -   --    - - --  -- -     -  -  -       -  -               - -
-     -  -     -              - --  - -      -          -  -  -  -- -  -  ----   - -    --  --     -
--- -  -   -  - -   -   -      -- --  -     - -   -  -     - - --       -     --    -  -  ---     --
-    --   -  --- -   -   -- -     -   -  - --  --        -     -- -- -----  -    -- -    ---  -  - -
--   - -- -   --     -  -   -   -  -  -   -  -      -  -   --   - - -    --       -  - -   --   -  -
--   -    -  -   --- -    -    - -  -    - - -           - -      -  - - ----   - -  -  --  - -    -
-   -  -  - --     -  -   -  -- -  - -  - -- -    -  - ---    -    -       - ---         --   -    -
- -  -  -  -     -    -    --   -- - -    - - --        - -- --  -  -- --    -      -    -  -     --
- - - --   -----   - - -   -        - - -  -    -     -    -   -     -       ---   -            -  -
---- -   - - -   - - -   -   - -   -  --   -  -        --    --   -  -  --   -      -    --  - -- --
--    ---- -       - - ---  -   - --  - -    - -        -    --  - -- -    -- ---    -  -      -   -
-     --    --   - -  -       --  --  --  -- -- -  --    -  -- --   - - -- -    - - -  -  -  -  -- -
-  - ----  - --   - -  -  - -- -     -             -     -- - -    - - -  - -                   -- -
-- - -- -   -   --   - --        - -   -  - - -     -   --    -  - - - -  -- -  -  --    -    -    -
- -      -          -  -  --   -   -  -       - -        -      - -     --           -  -    -  -  -
- -- - -      -      ------ --    - - --      --  - -     -  -        -   --  -   - - - -- -    -- -
-   --   -- -   -  --  -   - - - -     -  -   --    -      -   -   - --  -           -  - - - -  - -
- --   -  -  -- -      - --           -   - -      --   - -        -      -   -    -  - ---   -  - -
-        - -     --     -  -   -  -            ---        - -   --    -    --  --   - -      -  - --
-  -  - - - -  -  - - -   - --        - -- - -   -     --         ---   --         - -             -
-  -    -  -      ----  - -  -   --        - ---- --        -  -  - -    --   --   -   -    -- - - -
-   --  -  - -    --     -- -    -    - - -   - -        - --     -    --  - --  -    -  - - -    --
- ---      -     -- -- --      -   - --     --   - -  --  -  -  -               -   --        -    -
-    -        -- -    -  - - -    --   - ---  --    - - --      -- -  -  -  - -  - -  -- - -   - - -
-    -   -- -   - ----  -  --  -   ---     - --   - -  --  ---  -  -          - -  -   -- -  -     -
- -   - - - -   -      -  --     - -     - - --    -    - -   - - -   - -  --   -    -  -    -    --
- -  - -     -    -     - --      -  -   - - - - -  -   -  -     -- --    -     -  -  -        -- --
-   -      --  -- -- --            -   -  - - ---- - -- -- -  - -  -   - - - -   -  -    -  --     -
-- -- -- -  --- -  -   - ---      - --     ----     -  -  --   -  -   -  - - - - -   -         - - -
-   -  -- - - -        -       --     ----     - -  - ---   - -- -  --    -   - - - -   --  -  --  -
-  - - - -  -- --  -   - - -   - - - -   --  -        -       -   -    -       -    -          --  -
--  -   -- -    -   --   -   - -      - -   - - --   - --      -   - -    -- -   -       -  -- -----
-    -        - - --   - - --       --   -  -     -- --  - -   -  --          -  -- -  -   -   -   -
-- -- --  - -             -  -    -       - -    ----  -  - -  --   -- -        --        - - -    -
-    -   -        --  - - ---  - - -- -   --   - -          -      - -     -    --   -  - -  -  ----
-       - -      -  -  -    -             -  -    ---     -   --   -       -      -         -  --  -
-- -    -    -  -  -    -      --   --     --    -  --       -   -  -   -  - -- --  - -   -      ---
--   -  - ---  -    -         -   -   -    -    -    -- -        --  --  -      -      -        -  -
- - -  - - --   -     -  - -  --       -   -   -        -     - -     -   -  -    -    - - -   - ---
--    -  -    --     ---- - - - ---  - - - --  - -- - -      --  -- - - - --  - -    -    -  -     -
-  --   ---      -     - - --    --   - --       -     -- - -  -     -- -  -  - -  -   ---  -  -   -
-- -   - -  -     - -  - --    -     - - -- -  - -   -  - - -- - -- -  ---   --      -  ---        -
--    - -     -     --            --     -    -   -     -      -  --  -   -   -  -    -- -   -     -
- -- -- - - -  - -     --       - --     -     -   --    --     -  - --  -      -  --  - -  --  - --
- -   -     -  -  -  -  -       -  - -           -    - - - -  -   -   -  --     -   - -       -   -
-   - --    - - -  --              -   - - -   -- -  -   -- --  --    -        -  -- -  --    --   -
-  - -   -     -    - - -     -  -    --   -    -     -     -    -      -- ---        -  -      -  -
- -       - -  -  -        - - -  --   -  -  - - - ----- -  - - -      -     -  -  - -  --  -- - ---
-      ----        - --    -                - -    -     --- - - --   -    - - -  -      - -   - - -
- --          - -   -    --  - --           -     -  --- - -    -    -     -    - -  - -  -     -  -
- ---    --  -     -      - -     --  -  -  -      -     -  --- -   - --     -     -  -       - -  -
- -          - -   - - --    -           --  -  - --    -  --  - -  -- -   - -   --    -         - -
- ---     -     - -     --   --      --     -   -  -  - -    --   - --  -- -   -            - -  - -
- -   - ----   - -   -  - -   -  -   -      --   --- -          - -    - --   - -    -   -   -   - -
----   - -       - - --     -       - - -  - -   - -    -      - --      -      --    - -  -  --- --
-    ----  -- - -         -- -         -    -  -  -  - ---    - - --- --      -  --- --  -     -  --
-  - --- -    --    - - ----  -- --                          - -    --        - -  -     -   - --  -
- -    - - --    -- ---  -  -     -- - - -  --  --  ----  ----   - -    -  --    -   -- -  -     ---
-   --- -  -  --           --       -   - -     -        -   - -   - -    ---    ---- - - ---- --  -
- -      --   -       --       -   -   -  -       --  -  - -      --- - -       -     -         -  -
- -    -      ---- ---   -- -- -    -  --     ----               - -   -       - --   -- --- --    -
-    -  -  ---    -  - -  -  -   --   - -     -   -  - - - -     -    --- -  --            -   --- -
- --     -    ---  -- -  --       ---  -  -   - --       --     - - -  -- -        - -  -      -   -
-     -- -  -  - -  --         -- -    -    -  -    -       -    -    ----   - - --- --    - -  -- -
-  -- ---   -      -  - -        - --- -     - -   -      - - -    -     -                - -- -   -
-         -    -- --  -   - --   --   -         - -  -    --     -     -  -  - - - -   --- -    -- -
- -     -    -  -   - --           -  -    - -   -  -     -  -     ---    -    -      -      --   --
-   -   -    -   --        -     - -     - --- --   -      - --  -     - -      - - --   - --  -  --
-   - --       --   - -  -  -----  -  -    -  --     - -    -                - - -     -     --    -
-  - -            -   -  -- -    --   -        -   - --  -     -   --   -          -       -    -  -
-  -  --   -     -  - -    - -- -     --     --   ---    --  -  - -    --   -- -   - -       - - - -
-   -  -      ------    - - - -    -    ---      --   -   -   - -  - -    -- -    -  - - - ---   ---
- --       -           --    - --  --    --   -   - - -  -  - -     -- --  -  --     - -           -
-    -     -- -     -    - - -  -- -   --     - -       -     - -     - -       -       -  -    -  -
- -  -  - -- -  -    -   -   -- -      -    -   - --  --  --  -  --    -  - --       - - -     -   -
-- -  -    -- - --  -    -                  -   -     --   - - --   -- ---     -        - --  ---  -
-   -  -  -    -    - -   ---  ----    -   -- -         -                  -      - - -    - --    -
- -       --      -     -           -- -    - ----    -- -  -  -    - -   --   -   - -- -- -  ---- -
---       -     -- ---  --  -  - - -    -  -      -  -      - -           -  -  --  -  -    -      -
-   -  -   ---  - - - -- -  -     -   -       ---- - -- --      -   - - -  --     -   - - -      - -
- - -  --   - --  -  ----      -  -   -  ---   ----  -  - -           -        - --   - -    - -   -
-- --- -- -  -  --    -   -    --   -           -      -- - -- -    -   -  -     -    ---  - -   - -
--    -  --   ---        -                - - -- -     - -      - -- -- --  -   -     -  --   -   --
- - -- - -  -  -   -     -     -   - - --      -       - -      -  - -     -  - -          -       -
- -   -----  -   -   - -              -    -        -   -   - ----  -   - --    - -      - --    - -
---   -        - -- -- -      -  -       - -   - - -   -      -   - - -     -  - -       - -       -
- -- - -- -----      - -- - - - -  -      -  -  -         -     -  -    -  - -- -      - - - - --- -
--  - --           -    - -   - - --- - -     -     -    -  -      -   - --   - -      -   -       -
- --        -  --  -      - --     -      -      --- --    -  --  -- - -  - -   -           -- - - -
--  - -   -    -  -    ---  --     - -  -        -              -  -- -    - -     -  --  - - - -- -
-     - -- --    - -  -             -   - -  -- -   -          -      -- -           -     - -     -
----------------------------------------------------------------------------------------------------
