100
100
----------------------------------------------------------------------------------------------------
-       -   - -        -   -           - -    -  -  -       -  -- -    --     - - -     --  - -    -
-- --     -   - --      - -- -  - -        -     - --- -      -  -   --   -      - - -  -  -    -- -
-     -  -   - -     -- --    -  -  - - -  -   --    --    -   -  -   --  - ---    --     --  - -  -
-         -    --  -   -     -     ---    - - -         -  -  -- -  -- --         ---   --- --    --
-  -  --     -    - - -    - ---    -  -  -   --   - --          - - - - - -   -              --   -
-        -     - -- - -  - -     --   --   - --  -  --- -  --   --      --  -   -   - ---  -    -  -
- -    -  -                    -   - -- - -      --   -  -  -  ---     - - - ----         -  -    --
-   -     --     -      - -- -  -   -  -     --  - -         -    --   --    -  -  - ---   --  -   -
- -- -   -   -      --     -   -  - --- -  -  -   - - - - - -    -   -  ---    -  -     - -      - -
-  -- -   - --   ----  - -      --  -       ---   -  --   -  - -  ---  -  --   -   --  -         - -
---     ---   - -      -- --        -     -        -  -  -    --        - --    - - -     --  --- --
-    - -  ----   -  -      --   - - -  -    -     -  -- ---  -- -     -        -      - -       - --
---     -- - ---   - -    -    -  -      -       - - - -   -  - -  -       --   --  -    - -   -   -
-     -   --   --  - -           - - --  -  -        - -  - -    --  -         - -         - - -- --
- - -  --     --   - -  -   - -     -  - -    -                 -        - --  - - - --       - -  -
- - -      -      -    - - -- -  -    --       --  --  --    --  -  -    -       - - - -      -- - -
-- -   - -  - -- -   --  -  --   -  - - --          -      -- -  -  - --           ----- -- --  -  -
-  - - -   -   -    -   -- -   -  - -   -     -   - -  --     -   -  - - -    -  -   -  -         --
- -   -   - --- -  -     -    - -     --     --  -- - -   -- --   -   ---         -    - --- -     -
- - --     -  -- --   -   -    - -       -- -      --   - - - - --   -    - -- - -  - -   --   --- -
- -     --   - --  ----  -   -          - -      -  -       -       - - -   -  -   -  -  - -  -   --
-        --  -- -  -            -  -  -   -   -    --      - - -   --       --  -   -   --         -
-    --    - - -  - -    -  --    - -  ---        -              -  -       - -   ---   --       - -
-       -    - - -  --    --    -- - --         --  - - --   -  - --      - - - --   -   - -  -  - -
- -  -    - -      -- -   -    -        -     --    - -     ----- - -- -                      - -  -
-  -   -   - -     -- -     -  -   -  --  -  -  --- - -       -   --      -  -   --       - -  -  --
-   --  - -            -  --  -   -  -  -       -     -    --- -- -- - - - -- --  - --  - - --  -- -
-  -   --  -      -     --  -  - -  -  -  -  -    --- -   -   -- --        -  -  -   -      -----  -
-       --   -       -         -   -     - -           -   - -    -  - --       -    -   -        --
-  -       --    --- --- --           -  -   -     --  -  -  -   --      -- -- -  -   -   - -     --
-   -  - -          -        --- - -     ----   -     - -   -- -     -     -  -    ---   -   -    --
- - ----   -  -   - -     - -  -    -  - -   -   -- -  - --     ----- --   --  -- --  -      - --- -
- -     -   - -- -     -  --- -- -  -  -- -   -- -          -      -       -   -  --    -  -   -   -
-- -     --   -  -   -   - - -  -     -      -  -  -- --    -  --   - - -       -   -- -- -   -   --
-   -  --    -  -      - - - -  -     --   --- - - -- -   - - -      -   - - -   --  ---  -        -
- -- -- - -    -- -   -    -  -            -         - - - - -  --  ---        -    - - -    -  -  -
-      -        -- -    - - -    -   - - -  -    ---- -       -       -      - -   -   --  --  -   -
-       ---   - --     -  -    -   -  - -   - -   - - -  -      - -  -   -     --    -   -        --
-     -    -- --   --      -  -- - -- -      -    -- -         -   - -   -         - - -       -   -
-       -                  --     -  -  -    --  --- --- -- - -        -  - -- - - -     - -      --
- -   -   -         - - -   -  ----  -    -      - -    -         - --  -   -   -    - -  -    --- -
-                --- --- -   -           -  -- -     - -    - - -   - -    -     --   -   - -      -
-    -  - ---      -  -         -  - -    -  -- - -    -    ---    -    -    -  --   -    -    --- -
- -   - - -     -        - -  -  - -    -- -----    -    -          --      -  -  -         --  -- -
-- --    -  ---  - - -   - -  --   - - - -      -   -     --   - -    --  --  ---   ---    -   -   -
-      -   - -  --          ---   -   --  -         -   -     -  - -    ----- -  -  -   - -    -   -
-   --             -   --  - -  -   --  - - --  -       --   - -    - -     -   --   -- - -  - --- -
- - - --    -   ---  -  -            -       --      ---  - - -  -   -- - -- --  - -- -    -  -    -
-       -   --  -     -  -    -   - --- -- --     -    - -     - - -   -   -   -   --  -    - - -  -
-- -- - -        - -    - -      ---- - - -    -  -   --  -    -   -- - --    -  --- - -           -
-- -   -  -   -      -- -     --     -        - -        - --  -    -- -     - -         -   ---   -
- ----  - -  - -   -  -     -   -  --    -       -   - -    -   --   - -  - -  - - -            -  -
-  -- --  -    -   - -  ---  -   -     -- --   --  -  -           -   -   -  - --     -  --   -  - -
-       -   --  -       - -- - -            --     --  -    -  - --    --    -- - --  -         -  -
-  - -          -     -     -      -     -  -  --   -      -- -   - - -  -        -  -            --
-     - -  ---    -    --- -  --- - --    -- --   ----      - - -      -     -         -   -    - --
- -     -      -         -- -  ---     -   -  --   --  -   - -          -    -     - - -       - - -
- -   -      -      - -- -   -  --- - - -   - -- -        -  - -   ---     -  -- -  --  ---- - - - -
- - - - - - -  --  - -     --          --- --  -  - - - -             -    - -            -   -- - -
- -  - - - -  --           - -  -   - -      -     -     --  --     - -- - - --        -- - -  --- -
- -- - -     -    -        - - -  - - --     --- -  - -   -        - -   -         - -     -- - -  -
--    - ----  -  -     - -  -  -  -     -   -         -  -    --  -        -- --  - -      -- --  --
- -  --   - -     -  -       -      - -  - --     -- - -    ----          - - - - -- --     -   -  -
-      -     - -- --    -   --    ------        - -   -                   -                    - - -
-  - - - ---         --       -   -   - -      -   -    - -  -   --  -    - --   - -  - - -----    -
--  - -   - -    -      -   -      - -  ----      -- - -    -- --  -    --  -  - -           -     -
- - -      - --     -   -  - - -     -             - -- -     -   --       -  --   -   -      -    -
-        - -    - --   -  -    -  ---     -    - -        -           -  -    --  -  -----      -  -
-     - - -      -       --      - -      -    -  -     --        -    - - - - -  -      - -   -  --
-  - --     --  - --- --    --       -  -   -   -       -       -   -    - -      -- ---  --  - -  -
-        -  - -      -     -     - -      - -    ---  -         -    ----   --    -   -    -  -   --
--- --- -    - -- -      -  -    -- - -  -   - --  -  - -   - - - -       -  -          -  -       -
-  -    --- -   -   - -    --  -   -  -  ----       - -   -    - -   --    -- - -   --        -   --
-- - -- -   -   -     -  -- -       -  -    - ---  - -   - -   -  - -   - - -      -  - - - -   -  -
-   -  -  -   -     --   -     - - -- -     -    -  - --    - - - --    -                       -  -
--   ---   --  - --         -- ---    --  - -  -       --   ---         -  - -  -     -     -    - -
-        -   - - - -  -   - -       -    ---    --  -      - - - -  -- - -       --    --      -   -
-   - --- -      - -   -  -- ---       -       -   - -     - --     ---- --    -- -- - - --   - -  -
-  --      -      ----       --   - - -  - --- - - -   -  -  - - --   - -  - -  -            --  - -
- --    -    - -   -  - -    -     -     -   --- - -   ---     -    -     --   -  -     -  -       -
-   --- -- -- --    --  ---    --      -     -  -         --  -  --  - -- - -     - -   -- - - --  -
-   - - -      -     -- -   -    - -- -- - - -  -  - -       - ---      --    -- -    -   -   -  - -
-      -              -    - -  -  -  - --    - --    -    - -   ----     --      - --  - ----    --
-     -- --   ---  - --       --- --   -    -    ---  -- -  -  -  -  --      -- - - - --      ---  -
---- --           - -      --  -      - - ---    -     -  --  -     -      - -         --  --    - -
-        - -  - -      -          --  --  - -  - -   - -    --          -- -       ---   -      -  -
-----    -     - -- --- -  -       --      -    - ----  -          --        ---  - -     -- --    -
-         - --  -  -     -           -    ---  -  -  -    -     -               -    --   - -  -   -
-- - ---       -  -      - --- - -- -        - -   -           -     --   --   -  -    - --- --   --
-   -    --  --  - -           -    -- - -     -    --   -    --  - - -    -    -   --  -   --     -
- - - - -- -   --  -  ---  -   ---   --   -   - -        -      -  - - - -  -- -----   -  -   ---- -
-    --   --  -- --  - ---    -     --  -      - --    --   --   - -  --    -     - --  -  - - -   -
-      - -   - --      -    --  ---  -  -    --- - - -    --  -    -      -  -  -- -   -   --- -   -
-  - -  - -   -     -   - - -   -  -  -     --  - --    -   --    -   - - -   -   - -  -      -    -
-    - - -   -  --            - -   ----   --   - - -- -        -        --    -        - - -    ---
- --   -   --     ----- -  -      - -  - - -     -   - - - - -   -  -   --  -  -    - ---    --  - -
- -     -     -       --- -  -     -   - --  -- -      -  - - - -     - - - -- - -  -      -   --  -
-          -       - -  -  -     -  -   -       -          -   - -- -  -    --  -- -               -
----------------------------------------------------------------------------------------------------
