100
100
----------------------------------------------------------------------------------------------------
-  -    --- ---   -                 -              -   -   -  -        - -   -           --     -- -
- -   -         -  -      -- -      -  -        -  - - - - - -  --- --  -     ---      --     -  - -
--  --  --  --           -     -   -   -  - -  - -    - - - --  -  -     -  -     --   - -- -- -- --
-   -   -   -  ---    - - - -     -- --    - - -    -- -   - -  -      - -    -  -   - -    - - - --
-  -    - -      -   -   - -         -  -      -  --    -  ---     --   -    --     -      --     --
-  - -   --  -       - - - -     -     - - -   -    ----  -     -   - --       --  -  - - -  --  - -
- - -   - -      - -       -  --  - - -     --- -       --   -- - -   -- - - --    -  --   - - -   -
-  - - - --      ---- -      -  - --       -   -   -- - -   - - -   -- - -     -- - -  - -    --   -
- -   -          -    -    -   - -    - ---      -   -    - - -    -             - -     -      -  -
-   ---   --      -            -- -        -     - -    -    --  -    -       -   -    -     -    --
-      -    -- - - - - -- ----       -  --   --  - - ---  -  --      --  - - -      -    -- -      -
--    - ---          ---   -   - -    -       -     -    --  -   -  - -  - -- -          - -   - - -
- -   -    - - -   -        - - - -  -  -  -  -        -- -    - -     - -     - -- - -   ---      -
- -       -    -  - -- -           - -- ---       -      ---     - --      - -      -  -     --   --
- - -- -   -     -  - -   -  --         -    - -   -    - - -            - -  -- - - --     -  --- -
-   - -    - --    -     -        -   -  -- -   -    -- -  -            --   - -           -     ---
-  -  - --       - -     --          -           ---- -  --      -- - --  - - -  - -  - -  -    -  -
- - --     -    -  -  -  -      -       - -    -- -  --       ----     --    - - - ---    - -  --  -
-  --  -- --- - --  ----- --    -- -       -- - - -                  - -   -  -   --    -  -       -
- - - ---  --- -            -  - --     -   --  - ------ -  --  -   - -       -   -      -  -    - -
-    -       -   - -  - -   --  -  -  -    - -                - -      ---    - --  --  - -  - -- --
-    -  -  ----- -  -   --   -   -  --       -     - -     --    -         --      -     -         -
-     - -    ---           -  --   --      -   -             ---  -         -               - -- - -
--            -    -      -     -   -   --        -    -    - ---  -        --- -             --   -
-----     ---- - -             --     -  -  -   - -- -   --  ----    ----          --    - - ---   -
-     ----  --  --  - -      -  -    -   -   -  --         - -  -   -     -   --- -     - -  -   - -
- -- -           -    -        -      -   --- -   - -       -       --  --        -  - -  ---    - -
-  -        - - -      ---        -  --  --    -     --    -     -         - -- - -- -- -     -- - -
-   - -       -----  - -  -       ----- -- -  -- -    - -      --  - - -     -  -          ---     -
- -  -     - -       -         -     --   -      -   -  - -     - -    -      - - -- - - - -  -  - -
-   -  -   - -   - -    - -  -- -- -   ---- -  - -      -  -  -- -  - - --        -  ----   -   - --
--- - -  -  -         --- -  -   - -       -  -     -  -  -       - -       - ---    -     -   -  --
-    -    - - - -   -   -    -  -    -  -- -   --    - - -    -   -   -         - -  - ---  -  - - -
- -  -     -- --  -      -   --- - -     - -  -        --   -   - - -  - - -      -- -    -  -  -- -
-        -           -  -   -       -- - -     - -            - -      - --   - -   - -            -
-        - - ---   - ---   - --- --- -   ----  --    -            -   -          - --           -  -
--   - -          - ----- -   - --   -    -              -              -     -     - - -    -     -
-           - - -   -----  - -     -- ---    ----  --      - -      - -   -- - - - -  - -  -   -  --
- -- - -  -- - -  - -- - -  -   --- -  -    -- -   -  ---  -  - - -     --   -- --  ---   - -     --
--   -    - -           ---- - --   - - -     --    -   -- -- -   -    -  --    -     ------     - -
-  -    -  -    -   -  -               - -  - ---          ----      -   - -      -  -     - - - - -
-      -   -  --  - -   --  --  ---  -    -  -   -  -    -          -      -      - -  - -    - -  -
---        - -     --  -       -   -----   -   - - --     --   ---       -- - --   -   -   - - -  --
-    -  -   -  -   -       --    --  -       -  - - -  - -    -- --   -   -    -  - -- -  -- - -- --
- --    -    - -       --         - -     -  -  -     -        - -   --     -- --      -     -    --
-  - -- -- - -  -   - -   -- - -- -  -   -   -  --  ------       -      - ---  --- -  -  --  - - - -
- -  -    - -   -- ---  -     -  - --     -    -  - - -       - -     -   -    -  -   -           --
-  -     -  -      -     -     --- - -- -        --         ----       -   -   -       -   --  --  -
- -- -    -     -       -  - -- -  - - - --   ---  -     -  -  - -  -   - - -    -     - ---  - - --
-    -  -   -    - --- ------ -        --       -  - - -   - --- - -- -     -    -    -     -- -  --
-  -    - - -          -     -      - -  -    - - -  -- -  -  ---   -          -    --   --   -- - -
-  --- --           -    -  -  ---- -    -- -  - -  -    ---      -  -  -  - -    -  -  -    - -  --
---    -  - - -    -- -- ---       -- - - - -   - -             - -  -   -     -   -   -   - -  -  -
-    -    -  -    -   -       --      -   - -   - - -  --       - -  -           --- - - ---   -  --
-- -   -         --     - -         --   - -         -    -   - -       - -  - -   -  -     - ------
--  -- -    -    - - -  -  --  - -  -  -    - --      -  -  -   --    -      -   -- -     --      --
-       -    - -            - - -        --      - - --    -- - --   -         -    -  -  -   - - --
- - - -   --   - --   -    --  -  - - ----     - -- -  - -- ----      --       -    - -   ---      -
-    -  -     -  -- -    -       - -             - --  -  - -    -         -  - - -    -   -       -
-  --   -  -  -    -  -- -- -       - ----- --  -         -- -    -    -- - -      - -  - - --- -  -
--    --    -- -   -   -- --  --- -- ---      -  ---         -  --- -   -        ---      -- - -   -
-  - - --    - -  - - - - -   - -  -  -    ---   -   ---  -  -----    - --   - - -           - -   -
-     -   - ---- -  -     -   --   - -   -        --         -         - -     -- -   -   -- ---- --
-      - --   - - -- -  --      -      -  -   -   -    - -  - - -   -  -      -   -    -    -      -
- --     -   -      --     -  --   -    - -    - -   --  -    - - - --   ---- -            -   -   -
-      - ---     -   - -      -   - --     - -----      - - - -  --   --- -  -   - -    -  -       -
- - -- - - -- -  - -      - - -- -       -      - - -   -  -     --   -       ---      --  --  -   -
-    - -- -- -  -     ---      - -  --- --             --   --      --    --     - -  - - ---  --- -
-   --    --       -  - -  -  -   - -      ---   -   - -  -     -    -   -   -     - - - -   --   --
--     - -        -  -   -       -  -      -  --   - --    -  ---         -     -         - -   -  -
- - -- -    -  - -  - - -  -    -- - -  -        -  -- -  ---     -   -    - -  -  - -        - -  -
-    --  - -        -    - --  -   -        -   -  -   --      --     --    - -     --   --  --    -
-  -   --     -  -  -  --       -  -       -   -   - -       --     - -- - - -    -   - - - - - -  -
- -           --   - -   - -   -     -     -    -  -     --- -      -    ---  -  - - - - -  -      -
-  -   --   -     -     -  --   - -  -   - - -    -  -     -       --- ----  -- --       -     -- --
-   - - -      -  - - - -        -- ---    -     - - - ---   -  - -        -   ---     - -   -  -  -
-  -     - --  --   -   - -  -    - -  -    -   - --- - --  -- -- --   -- -        --  - -    - -  -
-     --  - -     - -   -  - -- --   --  -- -   -   - --- -          -  -  -     -   - -  - -    - -
- - --  -  - -- --   - -   -      -        -  -      - -  - - -  - -   -  --      - --    --       -
-  -  -- -- -   -  -  -- --    ---      - -   -  -             ----  -  -   -  --- ----   -     - --
--   -   - --    -  -- - - --        -  -  - -   --   ---   --           - -   --      --  - -     -
-  -   -   -  - --      - -  --   -  -       ---              -   -   -- - - ---  -- -  --         -
--  --    -      -     -   -- -     ---  --     - -      -   -     -   - - --      -   -   ----- - -
- --- - - -   -      - - --    - -    - --        -  -  -  -- -  -  --- -  - -     - -  -     -    -
-     - - -        --   -         - -- -- -- -  -           - -  ----  - - -       -  -    -   -   -
-  -   - -     - -   --- -  -     -           - -     -    -          -  -  - --  -   - - --  - -- -
-     --- -  --   ---  -    -  -- -    -    -    - - --   -  --   --- -      -         -           -
-    -  --    -  -     -  -   -      -  -        -   -    - --    --  ---     - -- ---   - ---     -
--        -  - -  -  -  - - -  ---    - -   - -- -   - - ---  -    --    -  --  - -      - -     - -
- - -    --  -     - -     -- - -- - -- --  - -   -   --- - -      - -    -           -     -  -  --
-  -  --      - -     - - -     -- - - -   -    - -- - -   -  -  -  --- -            - --  - --   --
-  -   -  - - -               -       -     -   - - --           -        -     -      -  -   -    -
---   -   -- -  -      - -    ---       ---   --        -  - -    - -  -- -   --    --- -  - -     -
-     - -   -   - --  -  - -- -    ---    - ----    ---       --      -    -   - - -  - -   -      -
--   -   --       - -        - --  -        -  - - -- -             -    -  ---  -  -      - -   - -
-- -- - -   -    -   -        - - -   --   -- -       - -     -  -- -           -- -  -    -  -    -
-    -   - --       --   --     - -       -   -  ----  -  -  -  -- -  -       - - - -   --         -
- - -  --    -   - -    -    -          -            -- -        -  -     -- -  -   --    -     -  -
----------------------------------------------------------------------------------------------------
