100
100
----------------------------------------------------------------------------------------------------
- - -             --         -         -- --- -- --   -    - - -    -  -   -- - - - -  - -         -
-  -            - --- --       -        - --- --   -  - --       --  --    --       --  - ------   -
--   --   -   -   -   -     ---    - -   --     ----         -     --  - -  -     -         --     -
- -  - --    -  - -   -     -    -     - -  -  -       -    - -   -  -  -     -        ---  -  -   -
--   -  -          --   - -  --         - -        - --  -       --       --       --  -       -   -
-  - -  -      - ----  -- -      - --    -     -    -  - ---  ---  -        ---            - -   - -
-   -     - - -  - -                   -    -   - -                - -  - --  -   -    --- -   -  --
-       --     --  -         -   - - -  -    -      -  --         - -  - -- --  -  -        -      -
- -   -   -- -       - -       -    -  -  - ---   - --     - -   -- -          - -    - -  -  - -- -
- ---- ---  --   - - -   - -  -         --     -  -- - -   -        --   -  -    -- --   - -  -    -
-- --- -      - -  --  -- -     --- -       --       - -   -  --- - --  --   -  -   -        - --- -
- -  - -      - - - -         --       -    -      - --   -      --       -          -             -
-   ---   -      --- --- -   -      -     - - - -  -- -  -   -          --       - -- - -   -      -
-      - --  --     --  -- - -   -   - --   -  --  - -      - -   - -  ---     -   --        - -- --
-  -       -  -  -   --    - --      -   - - - -     -   -- -  -    - -    - - - - -  -    --      -
--  - --  - -     -  - - - - - -        -  --   ---- -         - --  - - - - -  -- -     -   --- - -
-  -   -------  - -    -- - --    - -   --  - - -     -- -    - -     -   -        -     -- -  - ---
-       -   - - -     -                - -        -- - -  -    - - -  -  -  -  -     --  - --  -   -
-  - - -          -    - - -             -- -- -       -     - - -- ---  -    - -          -- -  - -
- -          --     ---     - -  -    - -  --   -   --- - - ----  - - -    -     - -  -           --
-- - -   - -   -       -  -   ---- -- -      -   -   -     ---  - - -  ----   - --     - --  - - - -
-   -- -     -          -  - - --  -- -   ---  - ---    -    --      -     - -   - -  ----     -  --
- - - - - - ---       -      - ---      - -          -  -   -    - ---  --      -   ---            -
-      --           -      -- -  -  -    -  ---- -  -- -  -  -    -- ---      --   -      -   -  ---
-       -    -  --   --  -    --        - --       -        -   --     - ----   - - ---  -- -  --  -
-- -      - -   --        -   - -  - --      --   - -- ------  ----    -   -       - --     -    - -
--   -- - -  --  - -   -  - -   - -  -     -   --     -  -  - - -    -    - -     ---  -   -     - -
-         -      - -   -  -  ---   -- - -- -  - --- --  -  -  -     -   --            -    - - -   -
-     -  - -  -  -      --  -    -    -  -   --  -       -        --         - -  - -    - -- -    -
-  -  - -      -      -- - - - - --    - --   -               -   --- - - -- -  -   -          --  -
- - -- - ----   --   -     - -    -      -   --       --            -- -   -    -- -  -           --
-- - -  -    -      ---  --- - -      -   ---    -   --  -   -       -   --- --- -- -         - -- -
-        - ---   --  -       - -     -   -         - - -  ---  -     -     - -  - -  - -     -     -
----    - -           - --           ---   -        - --     -- -   --    -   -   - --  -  -   --- -
-         - -   -- - --     -    -    -          -   -         -  -   --- -  -       - -  -  - -   -
--     -       --  - -    -    --    - -  --    -    -  -   - - -  --     -   -       - --     - ---
-  -   -  -     -  - - --   - - -      -    -    -       -- -        ---- - -   ---- - -      - -  -
-- - -      -- -  --  - - -    - -  - -    -    -  -  --    - -   - -         - -  -   ---  -  - - -
----  -- -      -    - -   - -  -     --    -   -      - -  -         -- -     - - - --   -     - --
-   -  -         --  --   - -     -     --   -- -  -          -  - --  --     -   -  - - -      -  -
-  --  -       -  -    -     -  -      -      --    - -   -         -         - -  --   -  --      -
--    -  - -   - - -   -  --      --    -  - - - - -     - --   -         -       -        -    -  -
-  -   --    -   --  --  - -   - -        -    --  -  --    -  - -   -        - -    - - -   -  - --
--    - -  -  -- -     - --  -  -- -   -        - - -   -   --  - - -  -     --  -  --  - - -  -   -
------ - -  --    - -   -     --  -- -- -   ---- ---  ---  -- -   --    -  -   -    -  -  ---- -  --
- --     -- - -  - --    -   -      -     --     -          - - -    ---- - --  - -   -  -  -  -   -
--    - -   -    -     -      --     -- -   -  - - -   -        -  - -- - -   --             - --- -
-  -     ---       -       --    -   -    -- --   - -   - --  - -    --       -  -    ---    -- - --
- -   -- -    - --    -  -        - -     --     ----  -   ---      -  -   - --   -      -   --    -
-  -  -         - ---     -   -    - - -      - ---   ---     -      -       - -     - -  - -   -  -
- -  -       -  -  ----- -  - -   -  - - -       -  -         - -     - -- --  -- --    -   - -- ---
--   ----       - -   -    -  -  ----         -    -    -          ---  -  -                -      -
--  -  -  --    - ---    -   - -   - -    - -  --    - -   -  -   -        -    - -      -      -  -
-   - - -    -      ---  -  -        --     - - -  - -- -  -   - - --  -     -   - --      - - --  -
-       -   - -       -      -  -   - -      -   -    - - -          -     --   --    -  ---   --  -
--  -  -  -   - --  -      -   - -      - -  -              -   - - - - --   ---   -  -      -     -
-  - - --   --    -        -  -    -  -     --    - --   -    - - -- --    -  -  -   -       -- - --
-  - --       -  -     - -    -     -     -   --    -   - - -     -- -       --- -  - - -    --    -
-  --   -       - -   -   ---   -       -        ---- -    -  -  --   --  -     --    ---  -  -  - -
---  -      - --  -- -   ----   -  - - -  ---      -   - -      -   --   -   -       -  --  - --   -
-- --- - -         --   -   - --- - -- - - --   - -  --   - -     -   --    -  -- -    --- - -     -
-   -            -    - -    -   -  -  -           - -      -        -   -  -    -- -  -- -  -     -
-- -- --  - -- - -    - -  - -    -------             -- -   -  --  - --   ----  --  --        - - -
-    -    -  ---  -      -   ---           -  -    - -   -  -  - -- -   -   -      -    -     -    -
-   -       -     -    --     -   -   --    -- -         --   -  -- -- --       -      --      - - -
- -  - - - - -  --- --     --   -   -  -  -  ---- -  --     - - - -    -   -   -   -  - - -  -  -- -
-       - -  -  -  - --   - - - -       -- -    -   -        - -    -    -  -     - -   -  - -    --
- -  -     -  -   -  --   -       - - -   -  ---  -   ---       - - ---- -   -    -   -    --   -- -
-  -    -   -        -    -   --    -  -   - -    -- ----  -  -   -    -       - - --   -  -     - -
-    -  --    - -- -    -        - - - -  - -   -   -    -   - -    --     - - -   -  -    - - -   -
-   -- -- -    - - -  -  - - --    --   -   --  - -    -   -  - - --       -    - -  -   - - -- -  -
-- -    -     --    -  - --    - -  -   - -       -   -   - --      -        - -   -   -  -        -
--     -    ---   -     - -      -    - -       -    -        - --     -   - -  -    -     -  -  ---
- -        -    -  -- -   --  - -   -- - -   -   -  -  ---- ----  -   -  -- --      -   -   -      -
---           -        -  -  -   --   -         -   -  -  ----  ---    -  -- --   - -- -  -     -  -
-   -   -   -  - -- --  -       --   -  -  -  -  -  - - ---   -  -        ---    -- -         -  ---
-        - --   --    -    --  -  - -    - -  -     -      -   -    -- - - -       -      - --  -  -
-      -  - -   -- - -    -  -   --  - - -  - - --      -     -     -     -    - -  -   -      -  --
-- --  - -   - -  - -  -- -   -     -  --  - - --   - -         -     --- -- -  -  -      - -    - -
- -   -  -       -    ---    -  --    -  -  ---  -      ----   -  -   -   - - -- -   ---  -     - --
-   --  -  - - -              -  --    -   - -   -  -  - - - -    - -  --  - -          -  --      -
- - -  -     - - -   - --        -- -- -  --- - -         - - -           - -  ---   -      -      -
- - --   -- --      ---     - -           -   -- - -  -     -   --    -      -  -   - --      -    -
- --     --  - - -  -    -      ---    ---  -  -  - -        - -        - -  --    --  -      ---  -
-  - --   - -   -  -          -     - - - -  --   -     -   ---   - - --       - --   -          - -
- - --  - -   -- - -  - --   - ---- -     -   --    - --    --  - --- -    -     -- -   -    --  ---
--     -      -   -        --    - --       -   ---  -  -      -   -   -  -    --     -  -     -   -
-    -   -  - -- -  -  -   - ----- -    -    --      --  --  -  --   - - --   --  - - - -    -  -  -
-  ----   -   -    - -  ---      - - --- --  -  -- -   -               -   -        - --  -        -
--  -   -    -     -  ---        -            -      -   -  - - ---     - -  - -   -    -        - -
- -  -  --    -     -    -    -  -  ---    --  ----    -  -- -- -    --  -     - - - -         -   -
-   - -      - -- -     -  --          -     -    --  -   -  --   -  --- -   - --   - - -    - -   -
- - -    --- -  -    - - - - ---        -----    - -    -       -       - -  -    -   --   -       -
-  -- - -        -  -- -   --   - --  -  -  - -       -    -  ----    -  -- - - -     -  -- - -    -
--  -   --  -    -           -- -   - -   --        -      -      --   -  -  - -  -     -    - --  -
-              --  -  -  -  -  -- --         ---  -  -   - ---  -   --     - -  - --      --  - -  -
- -   -     --  -   -   -    -   -      -  - -  -      - -   -     -  -- ----  -   --  --         --
-       - - - -         -   --- -  -   -  - - -     -  -                    -   --- --         -   -
----------------------------------------------------------------------------------------------------
