100
100
----------------------------------------------------------------------------------------------------
- --    -    - -   -   -  -  --       --  ---  -  -     - -  -- - ---        -  -    -    -        -
- - - --    - - ---  -    -  -       -         - - -  -   - -  -  -     --  -    -     ---   -  -  -
- - -    --     - - -   --   -      -   -    -   --     - - - -    -       -  - -    - -  -- --- - -
-  ----  - -      -       -- - -- -  - -   --     -    -  -   -  --    -- --        - - -  -       -
-      -     -     --- -    - - --  -            -        -     - -      -      -  -               -
- - -  --- -  - -      -   -      -  -  --- -    -- -- ---- -   -     -   -  -     --- - -- -  -   -
-          - -- -- - -   - -   --- -                  -      -    --   -    -     -- - -  -   -    -
- -   - - ---              - - -   -  --  -    -    -    - -    -- -   -    - - ---  -      -  -   -
- - -   -   -- -  -      -  -  -  - --    -       -         -   -- - - ---   -      - -  ---- - -- -
-  -  ---      ---           -   --    -      -- -     ----  -- -- -        ----        -      -   -
-           -        - -    -  -- - - -    -  -             -           -       -  - -       -  -  -
- -- --   -      -    -      -  -   -       -  ----  -- ---  - -   -   -    - --   -     - -    - --
- --   -  - - -  ---    --  -- -          -   -     -   -  -           -        -     - -  -- -- - -
--- -             -   -    -  -----      -      -  - -      ----     -  --   -   --  ---  -     -- -
--  -  -       -    -  -- -        ---    - -           - -   -    --  - -           -  - ---  -   -
--   --- - --    - -  -  -- --      - -   - -   -   - -  -  -   -   ----    ---            -  -  - -
-- -       -  -  --   -  -   - --     - -     --          -    ---     -  -  -  --    -     - -    -
-        -   ---    -- -  -  -  -   - -            -  - -            -   - -- - --    - -  - -     -
-- --     -     - -  - - -    - -  --   -  -   --   - - -    -     -  --     -- --     - - -       -
-- --     --  -  -   - - ----  -            - -  - -          -      - -  -- -  -    -       -  -- -
-  - -          -   -        -    - -  -     -  - - -   --- -   -      - -     -  -- ---     - -  --
-        --- -    -  --   ---    --    -   -        --     - -- --  ---    - -  -           -   - --
- --    -   -  -      -  --   - - --    --- -    --     -  - --        - - --   -   --- -    -- - --
-              - -     -        -   - -   -    -    --- -     -   - --   -     -  --   ---         -
-    - -  - --  -- - -  --  -  -    --   -  -   -- -    -  - - - -  -    -  -  -  -  -   -    --  --
-  -  -- -    -    -  --    - -    -  --         -     --          -  - -         - --      -    ---
-    -- - -     --- -- -    - - -      -   -         --         - - -  --- --    -   --       --- --
----  - - -       -         -    -    -    -    --       - -   -  - --      - - -    -         - - -
-     - -- --        -   --     - -  --   -       -   -     --           - ---     --  -          --
- -  --  -       -   -   -      - - -   -      - -     -  - -        -   --   -     -   -     - -  -
- -   -  -    -- -   -      -     -  --   -  - --  - -    --   --      -      - - -  --   - -     --
-     -     ---    -       -    -  - -       -   - --  -- -       -    - -    -        - -  - -    -
-     -   --  -  -    - -   ------  -    --   --    -     - -   -- --         ---  -- -  -  - - -  -
- ---             --- - -  -   --  -   -   ---     -  - --   -    --   -      -  --- -    -        -
-   - -  -    - -      -      - --   -- -      --- - --   -    ---   --- - -    -  - - -   - ---   -
---      - -                      - -     --     -  - -----  -     --    -     -- ------  -     -  -
-    - - -     ----   -  --- -- - -  - - -  -- -   - - - - -    -      -  ---       -            - -
-- -  -  --- - --       - -  -   --    --  -     - -  -   -       - -   -        - -  - -    - --  -
--             -   -  -    -     -- -   - -  - --   --    - -- - -    -  --         -   -  --    - -
------ - --  -  --    ---    -- - --   -   ----     - -  - ---   -    -     - ---  --   -- -      --
-       -     -   - -- ---               --     -- -   - -    --  -     - --  -                 -- -
- -   - -  -    --   - -  -    --  -   --   -    -             - --  --   -  - -  - -  -  --       -
- -  - -   - -  -  - -  - --  -   --  -         -          -      -   -   -    - -   - -    ---  - -
-   --       - --  - -- -          - -     -    --        -         -    -      - -        - -- -  -
- -     -  -   -                 - --   -- --  --  --   -   - - --   -    --   - -        -        -
-  -  --     - -    - --- - - -    -    --  -   ---     -      -  -    -    - -    -  ---  -   --  -
--- - -   - -- --  -- -     -   --  -     --  -      -- --    -    -- -         - - --- - - - --   -
-    -     --   -     - - - -    --     - - - - -       - - -  - -  -- -     -    -  -  - -  --    -
-- -       - - --      -   -   - -    -  -- -           -- -  --- - -           -  - --  --        -
-  - -     --  -  - -      - - - -     --   --      -               -    - - -   -   -  -  -   -   -
- - - -- - --- --     - - -   --  -      --- - --     -- ---  -  --     --   - --  -   -  - -      -
-    - -- - -  -- -    -  - --  - -       - --- -- -  - -  -  - -  -    - --     -  --  -- - -- -- -
-  -- -   -  -   -   -           -      ---   -     --        --- - -     --       -  -   -   --   -
-  - -     --     -- -      -      --     -  -    -- -      - --    -  -     --  -  -   --- -   - --
-   -    --      -        ---    -- -    - - - -     -- - - --   ---  -         - --      -  ---   -
- -- --  - -- - ---- -   -  -   ---      -       ---        --  -   -      - -  - -- --       -    -
- -   - -       -    --    --  - - -  -    - -  -- ---  - -       -- -  - - - -  - - -     -   --  -
-      --   - ----    -     -  - -  --    -   -    -   -  - -- -     - -    - - - - - --   - -  -- -
-  -   - - -    -   -  -  -  -- --     -  --  -     --  --      - -      -  -       -   -   -- -   -
-      ---    -          -  -  -  ---      - -    -- -- -   -       -- - - -     - --- -      -    -
-       -      -     --    -- --  --  -   - - -  -        -    - -    --        - -   ----- --   - -
-   --    -     - -  - - -      -    -  -   -  - -         - --    --    -    -    -   -    ---  - -
- -   -  -  -  - -    - --    --     --    - --  -  --- ---       - ---         -   ---  -      -  -
--   -  --    -- -- -        -  -          -- -  - -   -   -- -  --      ---    ---    - -   - --  -
-        - -     -   -  - -    -   --   --- -         -      -   --- --     - - -  - --- ----    ---
--     -       -   -   --  --       -  -    -   --      -- - - -    --  -    --- - -   -  -  ----  -
-- -          - -    -         -        -    - -        -- -      -     --- ---- -  --  -    -  - --
--    -   -  --   -     -  -  -   -    -  -    - - - --       -  -   - -         --     -    -  -  -
-       - - -    -   ---        -  -     - -   -  -  --   - - -    ---   --  -      - --           -
- --       - - -  --     -         -     - -    --  - -  -- -  -      -   --        -    -         -
--      -- -              -- - --  - --  -   - -        -     -  --        --   -    -   - ---  -  -
-  -   -        ---  - ---  -- -  --  -- -  --  -        -  -    -   --     -  --       ---   - - --
---- -   -    - -- -  -  -- - -  -      ---  -         --        -            -     -   -  --      -
- -  - --    -    -    ---    -   -       --       -  -  -    - - --        - -  -  --   -      -- -
-          -   -    -    ---     ----   -  - -  -      ----    --  -           -  -   -            -
-  -   - - -   -   - - -- -  --- - -- -   ---- - -- -   - ---   -    -  - -- -    ---   ---        -
--       - - --       -  -     - -  - - -      -     --   -  - - -     -    -- -               -  --
-  -  - -       -          -   -  --     --   -  -- -   --   -     - --       --  -        -  -  - -
-      - -- ----  - --     - --- -   -  -  --  - - -      - --   - --- -  -  -  -   -       -    - -
-    --  - - -  -- -  -     -   -  -- -- -      - -    -  --  - - -              -- - -    -    -  -
- - -- -        --- -    -- -- -     -     - -  --  -- -  -  - -    -- -     -- -  -   -    -- - - -
-    -    -- -  -  -  --     -  --     --  - -   - - -  -    - -    ---     -    -   -  -- --   -  -
---- - - -  - -  --    - - -   -   --     - -- -  - -   -----  - - -       -   --   - -    --      -
-  - - -  -  -- -    --      -- -- - -   ---      --    -- -   - -  -        -   -   -  - --       -
- - - -  --   -    -     ---  -        - -   -    -  -- -  --  - - -   - -   -          -- -    - --
-  -  -  -  -   - -     - -  -   -     ---  -  - -   -              -    -- - - -  - -      --    --
- - --     - --   -- -    - - ---        -    ----   - ---   -   -    -    -- - - -- - -        -  -
--   -    ---       -   - - -    - --- - -   -  -      -    --       -    -  -  --       --- - - - -
-     --      -   --  - -    --- - -- -    --  -- -         - --    ---   -- - - - -   --   - - -  -
-         ---   - -   - - -     -- -     -   - -    -  --    -    -     -        -        -   -   --
-- --  - - --- -  -   -  -- - - -        -      -- -    - -  -    -    -      -     -  --   - -    -
- - - -     --      -- -   -  -   - --    --- -                - -      -- - -  - --   -  -  - - - -
-  - -    --  - -       --  -   --   -    - --  - - --   -  - -  - -     - -   --          -  -  - -
--  - --   --    - - -- -    -          -             - - --      -  -- -       -    --   -- -   - -
- --     --     -       --- -- -  - - -    ---    -   --- -  -         --      - -- - -  -  -     --
--     ---  -   - - - -  -- -       - --     --- -  -     -  ---          -  -       -   -   -  -  -
-    - -    -- - -  -- ---     --    -    ---  - --    - - -  --   -         - - --    --     - -- -
-     - ---    -  --      -  -      -  -     -        -      -  -       -  -        - ---     --   -
----------------------------------------------------------------------------------------------------
