100
100
----------------------------------------------------------------------------------------------------
- -  -        -      -      -   -       -       -   -        - --    -  -  -- --  -      -         -
- -   - ---     - --   --       - - --  -  -   - ---  -          -     -  -     -   -   ---   - -  -
-  ---       ---- -              -- - - -     -      - -  -       -  --     - -      - -    -      -
-     -     -   --- -     -----    -    -  -  -- -    -  -- -         -               -- -         -
-    -- ---   --   -  --  -      - -   --        -     - - - - -       -   -             - -       -
- -  -    -       - --    -      --  -    -   - - -    -  --     -     - -- -  -   -- --   -   -  --
-        -  -  --   -    - -      -   - -  ---    ---   --   - -  -      -  -  -- -     --   -  -- -
-  --     -    - --- -       -      - - -    --     - -   -    -  -  --  - -  -   - - --- -      - -
--    - -  - --  -     --         -  -  - --   - -        ---   -    -  - -     --  --        - -- -
-   -         -   -  --  --   -   -   --   -- --    - -  - - - ---   - --      --      -     -    --
-  --  - - -    -- -  --   -    -    - --      --       -   --     -  --- -   -                  - -
-         -- -   - -          -    --  -  - -  --  -- -  --- ---    --  - - -   -  -  - - - -   -- -
--  -   - -   - - - -  --       --   --   --  -       - - -  -   -     -   -   -  -     --  -    - -
--    - -- -   -- --  -   --      -  -  -       - --- --     - -  -      --   - -   -  --- -   -   -
- - -  -- - - - - --   --        - -     -     -  - -- - --       -  --    --  -        ---  -   - -
-  --- - -  -   - --    -      -  --  --  ---   - -   --  -   -  -  -     -- -  ----   ---- - -    -
--   -       --   - -  - -- --    -      -          --      -      -  -  - -   --        -    --  --
- -     --        --  -   -    -    -                --     -  -           -       - -  -  -       -
- -     - -      -  -- -     -    -- ---  - - --   -  -  - --   - -    -- - --  -   - - -  -  -  - -
-       -- --     -  -- - -     -  ---                  -   - - -  -   -  --          --  --   -   -
- -- -----    -          - --- --   - - -- -    -- -   -  -    - --        -  - -       -  - --    -
--      -- ---   --  ---      -   -   -    -  -- - --          - -  - -           --   -  -        -
- --  ---    -          ---     -   - -  --   -  -  -- -     - -     -      --- -    -       - - - -
-   -  -- ---    -    -- --  -    --   ----    -- -       - - -     - -          ---   --       -  -
-   -         -    --  - -  -  - -           --  -   ---- -    -     - - -   --  - --   - --  - -  -
- --  -    -   -  -         -  -         ----  -  --     - - -   - -       -  -  -  --      --- - --
-     -   -- - -    -  -  ------   - -- -    - - -- - --   -              --       -  -- -    -    -
-  -      -   -  -      -  --  -  ---     -  - -      - --  -  -    -   --  - --   ---  -  -       -
- -- -        - -- -  -  - --- - -  -   - -- -- - --  - - --  --           -- -  -    -       -  - -
- --        -  --- - -- ---    --  -     -  - -              -    -      -       - - --   - - -    -
-- -  - ---   -   -    - - -       -  - - ----  -   ---  --       -   -  --    -  -   -- --   -  - -
-- -  --  -   - -- -  -  -  -- -    --         -               --   - -  -----    -  -  -  -   - - -
- -   -      -  --  -   -   - -    -    --- -   --   -  - -   -    -   -     -        --   -       -
-  -- --  - - - -  -  - - -    -   -  -      --        - -    --   ---    ---         -  -   - --  -
--   -     ---  -      - - -     -  - - ---  --  ----  - ---      --  - -  -    -  --      --      -
-   - -- -        -    ----   - -    -          -    - --  --- -      - --  --   --  -   -  --    --
-- -    -   - ---     - -      -     ---   -   -  -   -    - -   -       -  - -  - -     -- -      -
--    -     -  -  -   -      - -- ---      -    --  ---  -  -   - ------      -      -     - - -   -
- --   --  -       - - - -   -- -        -     -  - -  -    - -  -  - -        - - --       --   - -
--  -  --   -  --    -      -   --    -        ---  ---  -          --    -  -  - -     -- -   - - -
- ---     -      -       - - - - -          - -    - - - --     - ----     -   -        -   -      -
--  -  - -     -  --   -     -  - -  -    -  - --- --- -  -  - ---     -          --       -    -  -
- -- -    -       -       - -  - - -        -      --    -     -  -   -   - -   -   -  --- -     - -
-   - - --   -- - -  -    -- - - - --  -  -- -  -    --      - -- - -- -- -   -  - -       -  - -  -
- --  --   -   - -            ---  -      -  -  --    -  -        --   --    - - -  -  - -     -  --
--- -           -- - - --    - - -  -  -      ---     -  -   ----  - -         -     -  - -    - - -
--     -   -    -    - -- -- - - - --          - - - - -         --- ---     -- -  --  - --   - -  -
-  -        --- --  -  -        --  -  -   -       -          -- ----   -   -   - -     -- -  -   --
-  --              -    --- -    -      -   -  -  -      - --     -      --- ---  - --     -    -- -
--  -     --  -  -  ---      --    -    -    - -   -  -       --- - ----   --        ----   -  -   -
-     ----      - -     ---     --- -           -    - - - -     -  -         - -  -       -    -- -
- - -  -  - -     -   - -    -    - - ---   -   -    - --      -           --         --  - --     -
- -           -- -  --   - -   -    - -  -     -    -    -- -      -         -  -  -  -       -    -
- -   -- - -      -    - --      -    -- -  -  -  -     -  -  --      -  --  - -     - -    -   - --
-    -    -     -  - -      -   --   - -  -     -     -  -        - - --  -  -   ---  -            -
- -  - -   -    ---     -  -- - - -- -  -- -   --  - - - -    --     - -   - ----  - -   -     - - -
--  - - --  -       -  --  -- -     - -- -- - -  - --  --  -   -  --         - -      - - -- - -   -
-  -  - -   -    -    - -     -  - -  -  -  -   -  - -     - - --  - -- -  -    --   - -   -       -
- -     --   - -- -            ---   - - -   -         - --    --     --   - - --  -    -    -     -
-- ---     --       --   - -  -    -  - - -- - --  -     - -   - --    -  -         - ---  - - --- -
- -- --       -  -       -- ---     -   --       - --     - --    -             -    -   -     -   -
- --   -  --  --     - -  ---  -   - -  - ---- -  -   -      - --   - -           --   -     -    --
-   ---   --   -    - -  -   -- - -    -- -  --    -  - - ---    - -   -  -----    -  - - -  --    -
-- --  -  -    - -     -      -  --   -  -  -         -  -  -  -      -      -      -   -    - -- --
-    -    - -- -   -   -   --      --- -  --  - -     - - - -   -   -       - -       -        -  --
-        -    - - -  --  - -          - - - -  --  --    -  -   -  - -- -              - - -       -
--- --   -    -  - --    -- -           - --     -         -- -   -   - -  -     - -    -- -- --   -
-    -     -    -  -     -     --- --  -     ----  ---  - -  - -  ---  - - -   - -  - - - -- - - - -
-  -- -  -       --     -    --    -      --- -   -  - - -  -- - -          -   - - -      - --  - -
-   - --- -- --       - -  -   -    --  --  -     --     --       --  - -    -- - -   --           -
---  -   -  -  -  -     ---  --   -  - - -  - - - - - --       - -           -       -      --     -
-      --  -  - -     -    -     - -  -  - --  -         -   ---                --- -   - --   -   -
- -   -   --    -   -  -   -    --  -  - -         - -- - -       -     ---- -      -          - - -
-              -  -  -   -      -   - -      -  -    -      ---- - -  ---     - -      -   -- -- - -
--- -  -- --  - -    -     --  -  - -     - -      --              --- - -          -   -  ---     -
-     -  --  - -     -  --  - -  -   - -     - -      -   --   -  ---     -  -        - -- -    - --
-     -   --         -         - -    -   -- -      --  - -      -   -- -     -   -- - ---  -- -- --
- -   --  - -- -   -  - -- -- -   -    -    -  - -  -  - -  -    -    -       ---     -   - -      -
-  --      -      - -     -   -      -   - --   -   -       -   -- --  -  -    -   - - - - - - -   -
--- - -  - -  -- -  - -  -  -    -    - -   -     -   -    -- -  -   - --- -   -   -   -  - - -  - -
- -  -- -  --    - - --  - -----  - - -      -  -      - --  -    -      - -       - --    -   -   -
-   -     - -     -      -        -     -  -      --  -    -   --    - -     ---  -  -    - ---    -
- ----  - -  -   -    -     -- -   -   - --  - - -   -  - ---  -   -  -      -  -           --   - -
-  -     --   --   - --   -  -  -- - -   -- -   -- ---   - -  - -- -  -     - -   -    -   -    -  -
- - -       -    - - -   - - --  -  - -      --  -  -  - -- - -   -      - -- --- --      ---      -
-  --    -  - --  - - -   -      - ---  -       - -  -   -  -   - -    -        - - -    -        --
--     -    -        -  --  - - -  -  - -    - - - --     - --     -  -  -      - -  --  -     -- --
-- -       -   - - --  -  -   -  - - --   -    -   --      -     -    --    -  -- --   --    -  -- -
-  -- --      -  -        - --  -     - - -        - -- -    -      -   -               -      -   -
-    -  -   - -    --     - --    -   -       - --- - -     - -      -         -  -  -  - - -- - - -
- - -  -  - -   -- -      - -  ---     --   -     -   -  --   -- - --        --- - --   - -  -     -
-    --  -         - -   - -- -       -        - -   -     - - --    -  - --   --- -- -     -  -  --
---       ---             -   --  - -        -    --    -      -   --- -    -     -     -  -    -  -
--  -   -     -- - - -  - - -   -  -          - -      -    -        -    - --  -----    - -    - --
-   -  -     -- - -   - - -    - ----   -   - -   -  - - --   -- -               -  -   - -   -  ---
- - -  -- -- -  -    - -       -   -        -  -   --   - - - -   -     --   -  -  --           -  -
- - -   - -- -           - --- -   -  - -  --      - -    --  - -    -       -     - -     --    - -
- -   -  -  -   -   -- -            -- -       -                 - -     -     -   -       - -     -
----------------------------------------------------------------------------------------------------
