100
100
----------------------------------------------------------------------------------------------------
-       -  --      -   -      -    - -   --          -    --   - -  -   - -    -           -       -
-   -      - - - -          -- ---  - -       - -   - --    -- -       - -    - --         -- -    -
-         - ---     --  -  -  ---        -       - --    - --          - -- -     -   -  --    -  --
-  -  - -   -         - --   -  ---  --- -     -    -   -    - - -   -  -- --- -  -    -    ---  - -
-     --  --      -  -  -   -      -  - --    - -    -     - -      -        -  -          -   -   -
-  --        -- --- -   -   -  -         -       -  -  ---     - - -  - - -  - -      --  -   -    -
---              -   -        -  -  -- - - - - --  - - - --   -   --  - --    ----   ---  -       --
-  -        --  - -  -  -    - -    - --  -  -       - -        -  -     ---      - -   -   --   - -
- - - -  ---        --       -   - -     -    - -              -     -  - - ---- -     --  - -    --
- - -  --  - ---   -    -           -   ------    -   -      -  -     -             - -  - - - -   -
- -    -   -  - - - -  - ---  -- -      - --   --   -      -         --    -  -    -     --       --
-- -  - --- -- -    -  -   -      - -     -      - -  -----  -   -    -   - -- - -  - -  - -- -  - -
- -    - --   -      -      -  - -     -     - - -  -    -        - -  -   --    --- -      - -  - -
-    -  - - -  --   -     --  -   - -  --  --     ----  -       -  -  -  -  -      - - --     -   --
-   --    -   -  -          -- -         -    -  - -  - -  - --  -   --    ---     -  -- --  --   --
- --   -    -     ---   -- -    - -   -  - -    -  - -- -  -   --  -- -  -  --        - -   -  -   -
--  -  - -       - -  -  -    -  -     -        -     -                    --  -   -    --  --- -  -
-     --- --  - --         -- - -     - - -   -   -- -- - -        - -- -     -   -- -- -    -   ---
-  ---     - - -  -    - -- - --- --  ---  - -    --     --      - - -     --     -      -     --- -
-  -   -             - --   --  -   -    -   ---- -  --  - --  -    -  - -   - - -   --   -   -- - -
- - -- --           -    -    -        --- -     - -  -  -   -- -  - -  -   - -  --  -   -     -   -
-         -   -    -- - -  -- -  -   - -    - -     - -     -    --   - -   -  - -- -      -   -- --
- -            -- -    - -   - - --   - --   -      - - -   - -     - -   -        -  -  - -  --- --
-   - - - - --  -  --  -      ---    --       - - --  -      -   --          - -  --               -
-      -  -   -      ---  --  -     --    -   -  -     -  --     -  - - -       - - -    -    -    -
- -      -  -   - -   - --   -    --    - -  -     -  - - - -  -    --    -- -  -    -  -    - --- -
-- -   -   -  -   -  -    -         ----      --      - -  -   -      - -   - - -   -  -     -     -
-    -      - ----     -      -   -        -    -     - --    -  - --       --  - - -   -   --- -- -
-- -  ---       --- -- --  ---     -- - -           - ---     -- -      -     - --      ---    - - -
-  ---   --   -            - -  - -              - -       -  -   --     -   -       - -   --    - -
- -- -    -  - ---- --             --       -- -   - - -- -    -    ----- -     - --    --    -   --
-     - -- ----  ---       ---       - -    -  -  --   --   -  - -          --      -     -        -
--- ----  --    -   - -   -          -                -         -- - -   ---- --   -  -  --     -  -
-  -   -     -       -      -  -       - -  -  -      -- -- --    -    -   -- -      -- -   - - -  -
----           -- ---    --    -- --  -  - --    -  - -    -       - -  - -  -   - - -    -   -  - -
- - -    -   -          - -   -   - -- -   -    -   --   --- --           -   --  --- - --       - -
-  - -    -   -  -     - -      -       --     -- -  -   -  -     -  - --    -   - -- - ---    -  --
-  --  - -    -    --    -       -  -   - -  -       - -       - - -          -   --  - -  - - - - -
-          - ---  - - -    ---     - - - -  -  --    -  - - --  -   - - - -       -      -    -    -
-   -    --    -  -- -- -   -    -     - -   -          - -   --   - - -    --- -  - - --  - - --  -
-   -   -    -- - --       - --- -             - - -        --      - -  -    --    - -   -- -     -
-  -     - ---  - -  -  - - -           -   -      - -   - -   - --     -   -     - -- -   - --    -
- -  - ---  -    -  -   -   - -  --        -     -  -    -    -   - --       -         -   -    -- -
- --    -  - -       -  - - -- -   -  -     -      -  - --   - - -  -        -  ---  -- -    - --  -
- - -   --  -   -     - ---     - - --- -     -   -  - -    - -  -   -   - -  -     -           -  -
-    -     --  -- -   ---              --    -  - --- - --  -- --  - --   -  -- -     -   - -- -   -
---   -       - -  - -         -- --   -   - -- -   -     -     -  -  - -   --  - --   - - -       -
-    -    -     --     --  -  -   -  -   -- -  -  -   --    - - --     --     --- -          -     -
- -    -     --       -   -   -  -    -    -  --        --- - -   ---  -     -       --    ---     -
- - - - -       --  - -      -   - -         -  -         -   -  -   -         -  ---              -
-  - -  -     -   -   - --  - -   -- --    -       -   - --      -     -  -- --     -         -  - -
-  - - -  - --    -  -- -        -   -     --  - -    --  -   --- -- --     -- -  -      -- -  --  -
-     -  ----    -  -   --   -        -    - - -    -   -  -                  - -    - -       -  --
- --    -  -  --- - -- -   - -    -  -       - -   -   -  -  --  - --      -  --  ---  -      -    -
-     -- -      -  -         -- - -      -  - -  -   -- -               -  --       --     -- -   --
- -  -   - - -  - -     -  --      - -      - - -      -  -- -  -   -  - -     ---      --  - - - --
- -- - -  -  -- -    ---       -- -   - --- - -  --           - ----- - - ---   -   -   - -      - -
-- - -    ---- - ---    - -- -   -       -   -   -        - -         - ---  -    -  ---      -   --
-      -      - -   ---  - -   -           --   -    - -  - - -    -- - -    --   - -  - -- -    - -
- --  -       - -  - -    -      --- -  -   -  - - --     ---     -     -   -   --  - -   -   --   -
-            -   -- -  - -  -     -   --   - -    - -         ----  -  -   -      -- -- - -     -  -
- -- -     -  -     -    -    -  --   -   -    --   -- -  - -         -  -  -- - - -- -  -         -
-  -- -      -  - -   -      -  -   -  -    -- -  -    -  - - -  -          -         - - - -    ---
- --   -        -   --  - - -  -        --                - -  - -     - - -     -   -   - ---     -
--- ---     - - -  - -  - - -- --      -  - - --  --   - -     -   - --     -- -  --   -- - -  - - -
-   -   --  -  --  -         -    -          -  -    -   -  -- --       ----         - --   -  -   -
--    -      -   -- - -      -  - -  -   -     - - -  -   - -   -   - --    -  -     --  -      - --
--   -- - -   --      -    - -    - --- - --  - -      ---- - -      - ---   -  -- - - --   -- - - -
-  --       -       -- -- - -     -                - -   - - - --      -  - -     -   - - - --  - --
-     -        -   --     -- - -  --   --        -    - -   -   -  -  - ---    -- -   -       -   --
-- -  -       -     --     -   -- ----- -   -     -   - --      -  -  -  -  -  -    -  - - ---  -  -
--   -     -      -     -- --    - - -   -              --   -  -   -        -  - -  --    - ---- --
-  - --    - - -  -   - --   - - -  - ----     ---     -- -    -     - ---  - - -- -    -  -   - - -
-      -   - - - -   -    -   -  ----      --- -  -     --   -   --     - - -           -      - - -
-   -       - -  -       -  -  -       ---   ---   - -      -    -   -    -      -   ---    --   - -
- -       -  -    - --   -   - -  - - -    -  -   - -  - --- -  -- -        -  -          -   --   -
-  --      --     -     -  - -  -           -  -  - - - -   --  -   -  - -- - ---    -     -  -- - -
--- - --- --- --  -           - -  -- -    - -- - -      -   -     -     -      -   -  -    -      -
-   -   -     -- -- --  -   - - --  - --   -  -      - ---- -   ---  -  -  -        - -     - -   --
---  - -     -  -  -- - - - -    -   -   - -     -    -    - -- -         -- - -     -        - -- -
-  - --   --- ---       - -   --   --   -  - -   -        - -  - -   ---   --    -  -  -   - ---   -
---     --   -- - - - -            --    - - -    -- -  -        ---   - -   - -   - -- -    -     -
-     -   --     --   - -- -    -  - - - -     - -   - - -- --    -         -         -            -
--    - -   -- - -   --     -  -         -    -    --  ---  -----   - - -             -   - --     -
- ---    -- -   -- -   -      -   --    - ---   -- - -   -        - -- -     - - ---          -    -
--- -    --  ---  -- ---   - -   --    -       ---- -  - -     -   --   ---  -   -        -    - - -
-  - -- -   --   -  - -      - --      - -          --- -   -    --      -----      ----  -        -
--  -    --      --    -  -  -- -  - - -- - -  -    -   -   --  -  - -- - -      -        -       --
--    --       - - -    -  - -  -- - -     -   -  -      -  -      --     -    -    -   --  - -  ---
-   -  -- -   -      -   ---    -     -  -----  -  ---      -    - - ---   -  -        -    -      -
-  ---      - --     -      -    - - -- - -   --  - -  -- --    --       - -   -  - - ---   ---- - -
- --   -  - -    -    - ----     - --       -- -   -     -    --   - - -     -      -  --   - -  - -
-    ---   ----- --- --        -- --  - -        - -    -   -- -   -     - -- -           -      - -
--    -    - -           --     -  -  - -     -  ---  -  -       -- -  -        ---   --  -  - -   -
- -- - - - -- -   ---    --         - -         -- -  --  --    - -     -    -           -- -    - -
--  - - -      -       - -  -  -        --   -    -             - -  -  - -  --    -  -   - -     --
-   -      --- --    - - - - --  -- -    - --  -    --  -  - -      -    -       -   -  - - -  --  -
-                -  -  -       -   -- --     - -    -    - - -- -- -     -   - -- -      - -  -  - -
----------------------------------------------------------------------------------------------------
