100
100
----------------------------------------------------------------------------------------------------
-                 -  -    -       - -  - -         -                      --                -      -
-    ---  -   -  --  -         -     --    --  --    -- -              - -        -  - - -   ----  -
-         - -  -     -          - -     --   --  -  -  -     -  -  -  - ---  -  -    -   -   -     -
-    -- --- -   -   --  -- --    -    -  --                -   --      -    -   - -- - -    -  -  --
-- -    --   -- -   -  -         - -       ---      -        -    - --   ---      -- -      ----   -
- - -  - --  -  --- - -  -  - -- -   --- -  -  - -- -         -  -       - -          -         ----
- - -   -   -       - - -            -   -   -- -- -    --- - - -  -- -         -     --       -   -
-    -   -   ----- -        -- -  -       -    -    --    - -  -   -       - -         -  -  -   - -
- - - -  -  -- - - - -    -      -  -         -   -     -    -     -   -      --   --  -  -     -  -
- -     -- - -  - - - - -  --  -      ---  -   -     ---  ------  - -  -- - --  ----   --   -     --
-    - - -    -        -  --  ----  -      -      -  - -- -    - - - -        --   ----   -- - -   -
---     -    -      -       --     -   - -    - -- --          -  -  -- -   --    --             ---
-   - -- - --  -- - - -  -        -  -  -         -  -         --  -  -  -    -  -- --      -- -   -
- --  -  --   -  -    -- -    -        -    -    -  -    -    --       -  -        -   ----        -
--  -  ---   -     --   -          - -   -   -    - -   -  -   --      -     - - -  -            - -
--   ---           --- ---- -      - -   - -  ---                -  -     -  -    -- - -----  -  - -
----   -  --     -        ---   --      --          - -    --  --     -  --- --      --    --    - -
--- -       -   -     - -       - -- -   --  -        - -  -    -  -  --   -      - -  --    -     -
-      -    - -     - -   --- - -    - - -      --   -   -      -     - - --  - -    --     - --   -
- ---- -  - -      -    - ---      -- --  -   - --   - -    -- -    --        -   -  - -- -        -
-     - - --- --  - -- -     -  --      -      - --       -  ----      - --    -  --     - -       -
-   -   -- -  - - -   - - -- - -    - -  -- - -    -   - -- -        --                  -   - - ---
-  ---     -   ---  -               -    -   -  -   -        ---      -- -- -        -   -     --- -
-   - -   -  -    -   -       - -  -- -- -       -  - --- -- -  --    -    --  -     - -  -- --    -
- -  -          --   - ----  - -      -     - -  -  -  -             - -     -   -  ---  --      - -
-    - -    - -   -  - -   - -   -- --- --- ---   -     -  ---  -   - - -          -    - - -   - --
--    -- -   -----  -         - -  -         - - -               --    -- -  -   - -             - -
-    ---     -         -    - -  -  - --                - - -   -    - - -        - -- -- -     -  -
---    -   --     -   -- ---  --         -   --       --  - ---  -      - -        -  --      - -- -
-     -              - -   -- --    - -  -     -  -  --          -    --  -  -     - - -        -  -
-        --   - ---- - -- -      -     - -   -  -  - -      -       -- -- - -       ---  ---   --- -
-     -  -    --    --       - --     ---   - -   -   -  -  - -        -  - -    - -    -    ---  --
-  -      - -    -      -   -  - -   -   --   - -    - --    -      --  - -     -  -  --  --       -
-    - ---- -        --    -  -  - ---- --     --- - -- - -  ---- --     -      -   -  -   -- - - --
- -    -   -  --  - - - - -  ---    -  -    --    - - -  -    -    -       - -     -  -- - -  -  - -
-   - -            --   -  -     - -      -      --   - -   ---- -- -   -   - ----- -  -         - -
- -     -     -  -- -  - ----      -- -  -  --  -     -  -  -  --          - -       -  - -   -    -
-   -    -  -  - ---     - -    -    --  - -    - -- -       -   -   -   --  - -- --          - -  -
- -       --          -      -    -   -        ---      - ---           --- - -  -  - - --  --  - --
-  --   -  -         - --  - -    - --  -         -   -  --  -   - -      -   - - -   - ---   -- ---
-  -   --   -  -      -  - -- --       -  --     -  -    -   -- -       --   -  -  - - - -  - -    -
- - -      --- -   -      --   - --- -  --   - -- -    -   - --    - --  -   -----        -    --  -
- -    -  -  -         - -   -  -   -  -    - -  - - -    -- -                       --    ----    -
-   -    -    -      - --  -   ---- - --  -   ---  -    -   -    -             --- - -   -- ---    -
-    -   -   -  - -  -         -     -  -  - -      - - --- - -  - ---- --   -      - -   -  -- ----
- --   - -- -  -   -    -  - -  -     - ---- ---   -  - - - -        -     ----  -  - - -  -   -   -
--   --          - - -     -       -    -  - - - -    -       -      -   -        - - - -    --  ---
- - -    - -   -   -   -   --   - - -      -    -      -    -    - -  -  -  - --            -    - -
- - -   -    -    --  -  -- - -   -      - - - --   -    -     --  -     -  -     -  -  - -  -   - -
- - - -    -     -  -  -      -  -       ----     -          - - -- - -     -    -     ---  - --   -
-  - --  - --      - -   -   -  - - --- -          -   - --   ---  --     --      --        -      -
-        -  -  --   -  --  - - -      -    - -    -  --  - --   --   - - --     -    -           - -
- - -        -   --      -     -             - -  -     -  - -    -   -       -- -    - -  - --   --
--  --    -  - -     -  - --   - -          -    -- --       -    --  - -- ---   -        - -      -
- --   - -- -  -  -  -    - --     -    --  --  ---  -  - -  - -    -     -    - -  --- -- -     - -
- -   - - --  -- -     - -- -  -      -            -       -- - ---    -  ---     --               -
- - -    - --- -     -  - -    - --      -- -   - -   -    --    -- - -    --   --   ---     -     -
- --- - - -   - -    ---      - - - - - ----       -      -   -        - -        --    -  -- --   -
-      --     -       - -  - -           - - -   -  --- - - -- -     -      -- -- - -    -         -
---     - -   -  --   -- - --    - - -  -  - -   -    - -    -    -     --  -  -   - -   -    -    -
--  -- -   -    --   -  -  -  - -  -  ---          - -        - -   --       -    -  --- --  ---   -
- --       -           -  -  -    -- -   - --   ---  -   - -  -  -- - - -- -     - -  ---   -    - -
-  -   -     -   -  -    - -       - ---    --   - - -   - -    -- - - -    -     - -    - - - -   -
- -- -        -- -  --   -  -  -- -- -   -    -  ---  - - -     -    -   - -      -    --  ----  - -
--  -   - -   -       -  -         -- --- -      -- --         -- --    -   -     - -   - -   - -  -
- -   - -    --    ---     - ---          --- -     -     - - -   -     -- - --  -  -       -  - ---
-  -       - - --  -- -  -- -   - - - ---  -   -- -      - - -  --  - -  -   -    - -    - --     --
-     -       -   ---  ---  - -   --         -    -  -   - -- --      -     -  --- -- - - --  -  - -
- -     --- -      --- -  -   -  -        -  -         - -- ----        - -  -- --   --  -   - - - -
- ---  -  ---      - -  - --- -      -     -      -- - -  - -------  -   -  - --- - -   -    -     -
-  -- -- ---   - -             -        -- -     -- -  -   -        -  -   -      -    -  - -  - - -
--   - -       --   -    -    --     -   --    -   -- -   -     ---  -           -  -      -   -  --
-      - - --         -        --- -  ---  -    --   - - -  - -  -  -  -   - ----    -- --  -    - -
-  -  -  - - -           --  - - - - -   -  ----- - -    - -- -      -     -     --   -  -   ---  --
- --      -- ---  -     -  -     -   - -- -- -     -  - --  -      --   - -     -   --- --   - - - -
-   --   -  ---  - -  ----  - -        -      - -  -       -   -    - - - -- - -   -   -  - -      -
-  --  -- -     --        - -  -   -- -- -   --  -   --       -   - - -    - -- -   --  -- ---  -- -
- -   -  -   - -  - -- - -    -   -      -         -     --    -    -- -       --      -- -   -- - -
-    --      - --  -          - - --  - - -      -         -- -  -    --        -- -  - - -   -    -
- -  -- --     - -- -     ---    -  -  -     - -     -   --  - -    - -  -           --  - ---  -  -
--     -   - -- ---   - -   -  -  -   - -   - -  -- - ----- -     -            -   - - - - --      -
- -    --- --- -   --    -   -    -  -  -  - -  - --       -     -  - -    --    --    - -     --  -
--   - - - -  -- -    - ---       -    - --  -  - - -  --  - - -  -   --   - -      --        -   --
--  - -    - - -  - -     -  -   -- -- - - --            --       - --      -           -     -    -
-     -         -     -  -  -- - --   --        - --   -     - - - - - ---    --         -      -  -
--  - ---  -- -   - -    -      --  --   - - -  -  -  -      ---  - -    ---  -   -   --- -   - -  -
-- ---  -  -  - - --     -  --    ---  -  -   -  - -- -  -    -    --- --     -  -  -   -  -  -  - -
- - - -    -     -  --      -   - -    -    --        -     -- --    --         -   -  -  -   -  - -
--- --  -- -   -        -   --     ---- -  -    -  ----  - - -    --  -    ---     -  --   -    - --
--       -   -      - -    --  -        --  -   -    - -           ----   -   - -      -  -  -     -
-  - ---  --  - -   -  - -    -   -    -  --   -      --     --    - - -    - - -  -  -  - -   -   -
-  -    -   -  -  --       --       -- -    -   - - - -     -  -  - --  -- --   -  -    -   - --   -
-    -    --    -- --   - - ----      -    -  - -           - - --             -- -- -     -       -
-      - -  --       --        -     -   - -   -  -       - - -      --    -       -  - - -    --  -
- --        --- -           -    -      -        -  -- --    -               - -     -- - -   -   --
-      - --  ---    -  - -  -    -  - -         -    --   -  -  - - -   -     ---- --      --- -- --
-    -            -  -  -      -  - -  --     - - - -   -  -   - - -   -         - - -  - -     - --
- ----  -        -         ---    -   -                         -        - - -----   -           - -
----------------------------------------------------------------------------------------------------
