100
100
----------------------------------------------------------------------------------------------------
- -   --    - -         -- - -  -  -     --     -    -   -   - ---      -           - - - --    -- -
- -  -  -   -  --   -  - -- -- - --    -    -  - - -      --         --    -   - --    - -- - ---  -
-      - --   ---    --    -    -     - -   -    -  -- --   - -- -   - - - ---   -      -         --
-- --  --  -     - -      -       -- --   -  -        -    --     -      - -  -    - -   - -   - - -
-     - - -    -- - -----    -- -   -   -   -     -- -     -  -- -    --           -     -    -   --
- -    - -   -      --  -   -    -       -                 -    -       - --- --  -  -     -       -
-    - - -            -   --   -    -   -- -  - -       - -   -   -- -       --   -- - -      -    -
-  - -      -       -    -  -- --   ----     --   -  - -  -  --  - - - - -  -        -  -- --      -
-  -          -  -   -  -   ---      --         -  --    -  -    -- - - -    --  - -- -   -    - - -
----  - -  -     -  -- -  -        - - -  - -    -             - -        -     - -- -  -       ----
-     -  -        -  - -  -      - --  - - -   -  -- --- -   -    -       -- - ---    -   -    -   -
--  ---   - -  -      -      - - -   -  -  -  -  ---      -    - -    -   -     - -      -- --     -
-      --    - -- -     -- -  --    -  - -     -          ----    -        -  -       - --         -
---   - --  -  -   - - -- -       -  --    -       - -     -     -  -     -  -- -   -       --  - --
-     -      - -  --- -     -    -         --  -    -- -    - -     -  --  --   ---    -  -  - -   -
- -        -     --   --  -    -   --      -  -   -   --      ---- -- -   -  ---  -        -     - -
-       --     -  - -       --  -       -    -     ---      -- -- -     -      - -    -  -- - - -  -
--  - - -  --   --       -  -   -    --  --       -  -- - -  -    - --     -  -  --       -- -  -  -
--     -  -    - --  -   -  -- -    --     --    -- -  -  -   --- -     -  --  -          - -  - - -
-- -   ----  -      -   ---     -         --   -         -   -  -   - - -       - --  -  -      ----
--   -  ----  -     -  - -  -     -  - -   --- - - -     - - - -  -            -  - -      -   -- --
- -  - -  - --   --  -    -   ---       ---  - - --    - -   - -    -- -   - - --  -    --    - - --
-   - -  - -   --   - --           -- --       -  - - -     - -  -- -     - -  -- --        ----   -
-- -- ---  -    --   -       -  --    -- -  -  -   --   - ----     - -    -   -- -  -          - - -
- -  - - - -   -- -   ---         -      -   - - -   --- -    ---  - - -- - -   -      -  --    -  -
-  --    --  --  -    --  -   - -     - -- -   -  - -    --   -    - -  - -   - -       -- -- - -  -
-      ---  -   -    - - -    --       -  -  ----   --    - -   -- -     -- --   - -  -  - -- -    -
-- - -    -            -   -             -          -  -   -    --   - -       -    -    -  - -- - -
- -   -   - -  --- -       -  - -- -     --      -     -   - -- - --     -   -            -  -     -
---   - - -             -  -       -     - -    - --     -   -  - -   -  -      - -  - -         - -
-  -  -   -    ---   - -  -  -   ---  --- - -  -    --  --  - - -           - - - - -  -   -  -    -
------   -- -    -- -   -    -  --       --  -   ---   -          -       -    - - --    - - -     -
-  --- - - -- -       -  -        --- -  - - -- --  ---- --   -  -      -------    --     - -- - - -
- -        -    --    -  -   ---  --       -- --   -         -            - -  -- --     -     -   -
-  --         - ---- --  -   - -   -     -   -  -  - - ---  - --      -     - -           -   -    -
- -       -    -       -   - - --   -  -  ----  -  --                    - -  -   - -  --   -- --  -
-                -- - -  ---   -      - --   - -       -  - - -  -     --  - --    -     -     -   -
-    -    -       -  --   -     -            --  -- ----    - - --  -  -  -- - --  - -     -  --   -
---      --    -    - - - -  --   -    -- -   -   -   - -- -      --  -    -- - - - - -   -    -   -
-   -   -  -         -  -- ---- --          - -   --      -  --    --  -    -    --    - - -  --   -
-- -   -    --   -   -         -    --  -    --  -   -- -  -   - -  - -      ---   --   --     - - -
--       - --   - -    --  - -   --   - -   - -   -    - -    -  -    --   - -  -  -  -  - - -  -  -
-    - - - - - -    --  --  -       -  -   -     -   - --   -  ----     - -   --     ---  -      - -
-        - -- -- - -  - -   -      -  -- -  -  - - -      -  -    -   - -   - - -  -    -  --     --
- - - -   --  - -  - ---- --        -        - -    ----- --    --- --   -  -    -    -  --  -  -  -
- - -  - -    -        - -  --  -   ---   -   -          -      -     - -   --  - -    -   -  -    -
-           ---     --- - -    -   ---   -   --  -  --- - -    - - -  -    - - - - ---     ---   ---
--    - -  -  -   -        -  --    -            - --- - -  - --   - -     - - - -  - --  -  - -   -
--         - - --   -   ---            -- -    -   --  --        --  - - - - ---        -    -     -
-    -   -- -           -   --   - --       --  -   -  ---- -  -  --     -   -   -- - -        -- --
-- - - -  -  --   -- - -- --   ----      -       -  -- -   -  - -  -      -   - - -   - --        --
-   -    - -            --  -      -  -   - - ---    - -- -- - --   -   - -    -              -    -
-        - - -- -    -  -  -- -  - -    - - --   --   -   -  -  -      -    - -      -- ----       -
--- -----           -         -   - -     - -- --         -       ---- -       --  -       - - -   -
- -     -  -  -  --- ---       ---     -  -      - -    - -   -- -  -   -  -      --   -        -- -
-  -            --    - -- -        -      -     - -   --- --        - - --    --    - -  --   -   -
-   --- -  - -     -     -   -- - -- - - -     - - -- -    - - - --     --     -     -    -    --  -
-    -- - -    ---    -    -   -- -  -      --  -  - - --  --       -       - -   -           -    -
- -             -             -- -  --  - -   -               -   -    -     -   -    -- - - - --- -
-     -   --        --     --          --      --   - -- - - - -    - - --  -  -    --     -  -    -
-   -   -   -     - -  - --     -- - -      -- -   -  -    - - -  - -           - -  -     - - --  -
- -    - -    -    -- -     -   -- -  -         -  -    --   - -      ---  - --    -  -   --     - -
-  - --    - ---      -  --    - --         -   --  --      - -- - -   -     - -  - -- -   -- -    -
-        - -  -        -         - --          -     --   -  -   -  --- - -     - -   -    -- --   -
--      -  - -       - - -    -     -  --- -  - - -    -   ---- - - - ----- - -   -    - - -  - -  -
-   -     -    - --  -       - -  -  - --     -   - - - -         --   -   -  - -- --     -   --   -
-     --   --   -  --- -- -- -       -     - -  --    -  -     ----  -    -   -    ---  - --    -- -
-  --   - -  - --      -    ---- -           -- ---  --     - --- -  --     -- --  --   - --    -  -
-     - - - -   -- - --  - - - --     -     -         - -  -  -  --     -- -         ---        -- -
- -- - -    - -   -  - -    - --  -  --        -  --   -  - -   -       --    -     ---      -  -- -
--  -- -        - --  -  --     -    - -  -- -   -   - - -     -    -  -   -- --  -  -  - -    - - -
- - - -    - - - -      -     -       -  -  - - -  -    - -  - -  - --   - ---     -   -   --    - -
- - - - --  --  -  -      --    --       - -  - -            -      -    - - ----      - -- -      -
-  ---  -        -- -   - -  -     -   -  -- - --  ---     -        - --   - -   - -- -       -- - -
-      -  -     -    -     -  - -- --     - --    -    --  ---- -   - ---     - -    -   - -   --  -
-    -- - -     - --      -         -     - -   -  -  - - - -       - -   -    -   -          --   -
-       - - -  -     -  -   - - --  -       -        -      -               --  -    --      --   --
-   --   ---     - --       -       -- - -  -- - - -  --     --   - -    -   - -  --   -  -    -  --
-  -   - -   --      --- - -  -  -                      - - -          -    -    -- -  --  -       -
-         - -  -- ---  -   -   -    -   -- -    -- -        -        -  -      - -  -       -    - -
-       -            -  -- - -    -    -- - -  -           -- - - -     -  -   --    --- -   - -- --
-  -        -   - -    -      -   - --  -    -    -          - -  - -  -        - --  - -  -   -   -
- -   -   -  - - --   -- -   --  - -   ----   -   -- - - --    - -- -  -     - -  --   - - --     --
--     --  -   -  -   - -           - -   -- ---               --        -    -  -     --  --   -  -
-    -- - -     -  ---- --- -  -     - - -   -  -    - -  -- --        -    - -  --       -  ---  --
- - - -  -- --   - -   -  -    --- -    --  -  --  ---      -      -         -       ---  -  -  -- -
-       --     -- -          -  --  -   -    -  -       -    -        -   -    -    -      -- - -  -
--   -     -     -   -  - -- --   -     -  -    - - -     -  -   - - -       -   -  -- -  --- -  - -
--    -  -  - - - -- -  -   - - --- --  -  -       - --  -      -   -    -  ---  -    - --  -  -- --
- ---       --        -   -  -    --   --- -     - -      -     --    -   --    -   -  - -    --   -
- -      -- --        - ---   --   - -- - -   -   -  -   -         -   -      -    - -            --
- ---  - ---- ---   --     -    -      -  -         -        -     -     ---   ---   -  -  -   -  --
-    - ---     - --  -- --  - -            - --- -   -      -  -   - --     -     -           -    -
--- --        -  -           --  -    ---- -  -     -- ---- --   -    --    --  - -    - - -- - -  -
-       - ---  -  --  -- -  -  - -   -   - - --     -    --          --    -- -  -            -  - -
- ---         --         -    - -  - - -    -           -  --    -  -        -    -  --  ---    - --
-      - -- -   - - --   -    -  --   --       -  --   ---        --  -     - -        -    -   - --
-   -  -        - -    -      -    - -  -         -        -  -  -      -  - -  -- - - - --      - -
----------------------------------------------------------------------------------------------------
