100
100
----------------------------------------------------------------------------------------------------
-   -   -   --         - --- -    -- -   --            -- -  --   -    - -- - - -  - -       -  -- -
- -  -  -       -        -            --   -  -- -  -   - - -  -    ---             - -  ---       -
-      -   -       -     --   -  -   -     - ----    -       -   --   - -  -  -     -    ----  -  --
---      - -   -   -  -     -     -   - -  --    - --      -   -    -   -      -     -  ----    -  -
-     - -        - -      -   ----  - ---     -- -  -    -  - - ---     ---    -  - -       --  -  -
--    -      -- - -  -   -     -   -           -    - --    - --        -        --      -    -  - -
---          - -- -     -  -     --   - -  --  - - -  -        --  -  - ---  -       -      -      -
-  -   - - -    -  - -   -  ---        -     --     -  -  -      -  -----   -         - - -- -- -- -
----      - ----          --   -     - -    --       - -      -- - -    - - ----- -   -  -   ---   -
--- -  -   -    ---    -   -    - -    - -  - --           -  -       -   -  -  -  -  -    - - -----
-      --      -      ----     -      -       ---      --   -- --  - -- - -      -    - -      -   -
-- - -       -- -   - -   -       - - - -   -   -- - -   -     -   - -      -        --  -    -    -
-   -  ---     - ---    -      - -    --   - --- -  - -   -      -   -- -  - -   - --  -   --  -  --
--- -- -  -       -  --   -     -    -- - -   -  -  -  - -  -    ----  - -             --   - ---  -
-  -    -    - - -  -- - - -- -   - -     --- -  --   -    - -     - -- -           -- -    -    - -
--          -   --     -  -  -  -   - - - - - -   -    -  -- -    -     -    --      -    -   --   -
-- - -- - - - -     -     -    --- --   -     - - -   - -  -      -- - -   -  -     -   - -- --   --
-     - - - -  ----    -    --    --   -   -- --          -        --   -    --- - -- - -       - --
- -         -       - -   -- -  -    - -  -  -    -  -    -- - ---   -    - -  -  -  - -   -  - -  -
-     -         - -  - -  - -    --        -  -  --   --     --    ---  -   --      -          --  -
----- --     --    -    - -     -  - --   -         -    -     -- ----   --    --- --   -  -       -
-   - -   --   -        -   --   -     - -  -     -   ----- -  -      -    - --  -    -      -  -- -
- -  - -        -        -- -    -- -    - - --  --     - -  -      - - -   -     ---   -- - -  -  -
-  ---  -  -   -    -    -  -   -        -    -   --    -  -   -- -    -   --  --   - -     -   -  -
--    -  -    ----     -    -    -- - --      - --       -  -   -    -    - -    --    -  -        -
- - - - -       - - -      --  - --   ---    -   -     --  -  - -   --       -  -  -- - - -- - - - -
--     - ---   --     -  -     -    - --  ----     - -         -       -  -  --     - -  - - -------
-  --    - --   - -     -        -  --  -  -    - -  -  -    - ---  -- -  -   --- -     -          -
--  - -     - -   -  -- - -    - -        - --  --  - -    -  --   -  -           -  - - -  --  -  -
-      -- ---      -- -    -  -    - -   -- -  - -       -   -  -- - -  -     - -    -  -    -   - -
--    -    - - -      - - -- -  -      -    -- -      --   --  -      -   ---  - -  -  - - -    -- -
-   -      -- - -      -   - - -    -       -    -- -- -    - -      ---     --   -- - - -        --
- -   - ---    -    -  ---  ---     -        -   -  - -   -   --  -  -  -- --    -   - -    - -    -
- -  -      --    -        -    - -       --  -    -  - -        -    -- -     ---     - - -      --
-  -  -  -   -  -  -  - - - -   -  -   - --   - ---  -  - --   - - --  -    -  -  -    -   -    -  -
--   - -  -  -    --    -  - ----   --    -  -   -   - -  -- -     ---    ----      -  - - -  -    -
-    - - - - ----    - - -   -  -  -    -   -       - - -      -  -     -    - ---        ---    - -
----   --    - - - - -  -          - -- -  -   - -    -       -     - -       -   --    -  - --  - -
-     -   -  - - -  -    -        ---- - -   - - -    --   - - - -  --      -- --  -       -     - -
- -     --      - - - - -    - ----        - -  -      -  - -  -  -  -   -  - ---- - -        -   --
-  - -   -  - --       - -        - - -  --  -        -   --     -    --   -     - - --- - - - -   -
-  -    - - -  -  - - --  -      -   -     --  -      -  -   - -       --      - -- -- -      -- - -
-   - -  -             - ---       -     --   --   ---     --- ---   -    -         - --   -       -
- -       --    -  ---  -   ---   -  -  -     - - -- -        - - -  --          --      -  - -  - -
- - - -  -     -  -  - --- -               ----        -  -  - - ---  -       -            -    -- -
-- - -  -  -- -        -- -     -     -- -  - -   --  -   -- -    -      - --    -  - -   --    - --
--   -  - --- -        - - -  -   - --      - -  -  - -       - --  -          - -    -  -         -
-   - -  - -----  -  -    - -  - - -   -  -  --         -  - - -  --     --  - -- -       -    --  -
- - -   -  -     - -       --       - - --      - -     -- --    -     -   - - - -   -      - -  - -
-     -- -   -- -   -  -     -        -   -- -  -          --      - -   -- -     - -   - -       --
- -   - --    -              -       --  - --  -- -   -     --  -    --   - --   ---- -     ---  - -
- - -          -    - -   -  - - -   -   -       -     -  --  -        --     -                 - --
--- -    -  -  -  - --  - - -   -  --  - - -    -   - -  - -   -  -  -      ---      -----    - -- -
-- -    - -   -     -- -  - --  - -      -  -- -  --   -    - -  - -   -          ---    ---     ---
-  -     --  - ---     -  - -     --  -    -    - --   - --       -- -      --  -      --    ---   -
--  -             -- -  -         -  -        ---      -  -     -   - --  -     - -     -          -
--      -          --   -- -   - -  -     - -   -  -       --   -   ---- -  -      --         -- - -
-         - -- -   -  -    -   --  -   --   - -  -  -    -    -             --   -   --  -         -
- --       -    --  - -- - - - -   ---      -  -  -   -    --   - - -    --   --  --   --  -  - -  -
-  -    --  -   -   -  ----     -  -  -    --      --      --  -  -   -     --   -- --             -
-  -   -      -             - -  -        - -     -  -   - -   -  --  --     --    -- --         - -
- -     -    - -    - - -  -    -      -  -   -  -   -    - -       -      -      - --- - -- -   - -
-  -  -- -   -       -- - -  -   --    -  -    - - -  - -    - -            - --  - -       -     --
- -   -   --  - -- -    - -      -       -   -   -     - -   - - -   -  -    -   -    -   -   -- - -
-    -    -  -   - - ---   ---   -- --  --  - - -       ------ -- -   -   --  -      --    -   -   -
-    -   --  -   - -        -   -  -  - -  - -- -- --         -    - -- --      - - -   -  - -   - -
- -        - -  --   - -   - -   - -     ---  --      -    ---  - - - - --   ---    -  ---         -
-         -       - -          -  -               -                       -     - --       -- -    -
- -   -          -   - -  ----      -        -   -  --  -  -  -  - - -  -- -     -  -      --  - - -
- - --  -    -  - -- -  ----  ---  --   --   - - -       - - -  ---          -  -  -       --   -- -
--   -   --     -  -- -            -    -  -    - - -- - -  -         -    -     --    - - - --  - -
--  -- -     --- -   -   -  - -----  - -- --    -       -           -       -  -      - -      -   -
-     --- -      --- --  -  --   -  -    - -        -  - - -- -  -- -    - - - -  -   -       -   --
--       - -  -     -    -    -  -  ---   - -  -  -    -      -- -  -   -            --   --       -
-  -   --- -  - -   ---  - - --- - -       -    -  -   -         - --              - --   --  -  - -
- -   -          ---- -  - -       - ----  - - - - ---    -- -   --   -- -    - ---   -- - --   -  -
-              - -  --   -- -      -         --   - - - -           -  --       -   - - - -   -  ---
-- - -  -       - ---   -  -  -   --  -  ---- -- ---    -        -   --      ---                   -
- -        -    - -  -   - -  -  -   -    - - -   -      ---    --- -  ---  - - -  -   -  --    -- -
- -    -   -     - -----   - -- - --   - - - -    -  --    -  --     -   -       - -    -    --   --
-    -- --   -     -   -   -  -- -  --   - -  -      -   -    -  -   - - - ---  -  -   - - -  -  - -
- -     -    - - -   --     -     - - -        - -- -  - --- -   --  -    -     -- - -          - --
-      -  -  -  -  -   - - - - -  --     ---      --     -    - -     -     - -    -     -- - --   -
-  - -       -  - - -      - - --- -  --     -   - --  --   - - --    ----  -  -    - --           -
-     -  - - - - - -  -       --   -    -   -   -        - -  -    --     ---   - -   ----  ----   -
-   ---  -  - --   -     -   -  --           - - -- ---   - --   --       - - --       -- - -   -  -
-               -      --      --    -   -----  -       --   -      -      - -  - -      -  -      -
-    - -  --   -    ----    -   -    -- -  -  - - -- - - -     --    -         -  -   -   -   ---  -
-  -        -  -        - - -  - --    -  -   -   -    -- - -   --  -   -  - -   -       -  ---    -
- --   ----               - - ---  - - -      - -  -   - - - ---     -      -   -     -    -- - -  -
-  ---     -   -- - --  -  -     -      - -     - --     -       - -  - -    -- --  -     - - -    -
-  --    --         -  --- -        -  -- -   -  - -  - -  -     - -- --         -              -- -
-  - -- - - --     -     -        -       --    -        -  -  - - -  -           --   -     -    --
-  - --- --    -    -   -  -    --    -     -     -   - -    --         ---       - --   --      - -
-   -       --   -       -   -       - - - -  - - -  -  -  --      - -    -  -   - -  -  - -     ---
--   -   ---- --   --   -     -       -  - - - - - -    -    -  -  -      -         -   - --   --  -
- - - -     - ---  -- - - -  -- -       - -   - --    - -  --  -  - -   -- -     -- -- --          -
-   -   -   - --  -           -        - -  -     --   --  -  --       - - -   -  -                -
----------------------------------------------------------------------------------------------------
