100
100
----------------------------------------------------------------------------------------------------
-     -    -   -  -   -     -           - --   -      -  -    - -       -  -      -  - -    - -    -
-    -   -- -  -     -         -    - -   -   -   - -  -  -  -- - -  - -   - ---- ---             --
- --  -  - - - -  - -- -   -      - -      ---  -       -  -   --  -   ---      --    -   -  -    --
-    -  - -            -   ---  ---   --       -  - -   -   -      ---      --       -    -   ---- -
-   --  -     -    --    -  - - --       - -  -       -- -     - -   -  -  -  -- - -   -  -   --   -
- -  -     -  - --    -     -     -   -- - -      ---      --        - ---  -  - -               ---
- -   -      - -     - --   -  -    --  - -       -         -   --  -             - - --    ---  - -
- -     -  -       -     -    -  -       ---   - - -- - -   -         -  -   -            -        -
- -  -    -  -   -   --        ---  -     -     --  - - --       - --     --   ---   -             -
-  - - -   -- -           --      -  -  -   -   -  -   - -  -  -      --   --              - -    --
-     -  - -   - - --   -  -          - - -- --  -   ---    -    -- --  - -       - -     -  -- -  -
-  -- -  -    -    ---  -    - - - - -  --    -          --   -     --  - -        -            -- -
-       -   - - -    --               -- - --- -  - --      -   -  - - -     - --- -      -- -- - --
- - -  -    -   ----   - -  -  -       -   -  -   -       ---- -  -   -- - - --------  -  --- -    -
- -    ---  -       -  -    -- -    --    -  -      -         -    -    --          -   -    - -  --
-    --        --- --     -      - --       - -      -  - ----   --    -    ---      ---- -  -- -  -
--  --     -       -    - --  - --   -           -  - - -- - -    ---   --   - --- --   ---- -     -
-  -    - - -     -     - -     -          -  -  -  - - - --  - -   ----   - --        -    - - -  -
-- - - -   --      -  - -- - -- - --          --   -  -    - -- -  -    -  - ----  -       -- -   --
-   -  - -   - -- -  -      -       -    -- -    - - -      - -   -    -   -       -  -    - -  -  -
-  --      --    -    -  -       ---  -    -    - -        --   -    -- -  - ---    --       -  -  -
------  -   - -  -  -       -- -   - --- ---         -  -----     -    - -   -       --- -  -      -
-      - - --         --   -      - --  -                    -- ---   -  -  - --- -    -   - -  -  -
--- - -       - -- ---  -   -  -   -    -- -  - - -   -- - -       -  - -   --    -   -  - --- -- --
-  --       -----       - -      -  -           -  --- -  ---    -- - -   -- - --      -  -       --
- -        - -    --- - -   - -           --  --        -              - -        - - - -     - -  -
-- --    --   --       -  -  -  --       - -- - -----        -   - -   -- -     ---     - -     -  -
- - -  ---         - -  --     --    -         ---    --  ----      -      ---     -  -  - -    - --
-    -     - -      -  -      - - -- - - - ----     -    -     - --     - - -  -  -          -  -  -
-      -   -       -    --     -  -   -  -     - -      -      -- -      - -   --- --   -   - -  - -
- -- -                - -  --- - -   - -         -   -  -- - -    - - - -   -      --      - -    --
-           - --- --- --         ---  - - - -      -  -   -  --- -       --       -     -  - ----  -
-  --  -- - -   - -     -   -        -  -  --   --  -    -  -          -  -     --   -   -        --
- -    - - -  -    ---  -    -     - --     ---   --    - --  - -            -  - -  -             -
--     -   -  - --  - - ---           -  --             - -  ---     -  -- -   -  ---  - - -  -   --
-   -   - -     --   -  - --   -- -   -- - --  --    -   --      --   -       -  --- -    - -- --  -
---    -          --- --           - --          ---   --  -   -  -- --       -   - --  --      - --
- - -- - -     -- - -- - -  -           - -    --         -  -- -   -   -  -   -- -   -  - -    -  -
- - -  - - - -      -  -        -   --  -- - -  -    -- -  - -          --        -       --   -   -
- -     -     - --  -   -   - -- -         - -  -  -  -   ---  ---- --  - ---   --  -  -- -- -   - -
- -    - - -- -        ---          -   -- -  ---  --   --     -         --   ---     - - -- - -   -
-  -  - --  - -- ---- -   -    -- - -          - --   - - -       -  -- -      - -- -   - --  -    -
-- -    - -   - -       -- -   -  - -        -      -- -- ---  -  -- - -          -   -     -  -----
-   - - -  -   - --      --       - -     -    - -  -            -  -      --     - --- -          -
-  - -            - -- --   - - - -    - -- -      - -       -     ---   - - -  ---    --      - - -
--   - - --  - -   - - --   --    -- -   -    -     -       - --  -  -   -        -     --         -
-   -       -  -   --   - -  --  -  -      -      -  -    - -      -   -- ---  -- - - --  -- -     -
-- - ---  -  -  -- - ---   -- -  -  -   --       -         - -- -    -  - -      --    - --   -  - -
---  -    -   --  --  -- -- -   -    -   -          ---  - -      --     -    -   -  - - -  -  -   -
---   - - - - -   - -    -- -     -   - - --          -  -  --    -  - -      -    - - -  --       -
----      -  - - ---- -- -  -          -    --- - -   - --   -  -  -             -      -     - -  -
- --   --           -  - -- -  -  ----- -       --    -- - - --  -- -  -   -     -         --  - - -
-  -  -    -  --  -  - - - -  --         -----  - --    --     -         --  -  -- -    --   -     -
---  - --       -  - - -  -  -       -    -  - -   -- --   - - -      -  - -     -   --    -    -  -
- - - -  -   - -- - -  - -   -   - -    -       -     -- -  -  -        -     --     -    ----   - -
-      - -    -   -  -    -    - -   -    - -  - -- -  - -   - -          --       - -  --  - - ----
-    -  - - --  -- -    ---     --    - --  ----   ---- - --      - -  - -   --     - -  --  -  -  -
-          ---- --- -    -  - - -        -  -   --    - - -- - -        -- -        - -- - - --   --
- -   -     --  -    -- -  ---    - -----      -    -  - -    --            -   -- -   -  --  -    -
-   - -   - --          - --  --   - -    -               - - -  -     --   -       -       --     -
-       -       -    -  --  -  -     -  -       -  -   -      - -      - -    -- - -   - -   -  - --
-   -    - - - - -   -    --   - -  -- -- -      -              -   --    -- --      - -  --    -  -
-    - -     -     -  ---  --  -      -- - -  --  -- - - -- - -  -         -       -         --- - -
- --   -              - - -   - - - - -       -  -    -    --     -    -    -- -        --        --
--    - -   - -   - - -  - -       -  - -      - - -   -  -    - - - -        -        -     -  -  -
-  - - - --    ---  -      - -  -- - -   -  -  -            ---      -- --   -  -- -  - -----      -
-- -  -  - -   -  - -      - -  ---   --  -     -   -  - - - -  - -- -    - ----        -   - -- ---
--   -     -       -  - - - ---     ---  --      -     - --  -    --    --    -  -  ---    -   --  -
-- - - -    -  -  -      -     ---        -   --  -    - -- -        - -  --     -   -  -        - -
-   -  --- - -  -    --       - -  --  -    -- - - - -    -- --  -  --  -    -         --    ----- -
-   - -   - -  ----    -          -       -  -- -        -  -          -    -     - -              -
-    --  -   -  -- ---  -    -    -  -     --     - -- - -- -    -  --- --   - -  - - -- -   -   - -
--             -        - -    -  --   ---    - -            --    -     -    -    -  -     -  -   -
-             - -  ---   -    --   - -    --  -  -  - ----     -   -    - -   - --         -       -
- - ---     - -  --        - -  -   ----    -  -         - ---- -       ---  -     -- -  --     - --
- - - - - --   -     - -       --       -  -  -    - ---       - ---  -   -    - -- -- -   -   -- --
--  --  - -   -  --      --- -      - -  -       -    -  --             --  --   -    -  ---- -   --
-  -  - -   -   -      -- -          - -- -    ---  -  - - --   -  - -- - - -  - -  -   -     -   --
- ---        - -    -- -  -    -   -       -   - --          -  - --     -    - - --- -- -   --    -
-  ---  - -   -         - - -    -   --   -   --           - - --     -    ---  -- -  -     - -    -
-     ---   -  ---     - -  -  --     --           -     -  --       - --     -  -       -  - -- - -
-       --  ----  -   -      -       -       -       --    - - --         - -    - --    -         -
-----    -      -  -- - --     --   -     -    -  ---    ---   -   - -  -    -      -  -    -  -   -
-          - --  -    -     --   -   - - --       -- -    -   -          - --      -    ---       --
- --    - -   - -   --   -     -  --- -  -  -          -   --  ----   -- - - - - --      -   -     -
--    -    - -  -       -  -   -     - - - -- - - ---   --  --   -    -       - -   -- -  - -   ----
-  --      -     --      -  -          - -    -   -  --           -       ---      -- --   -   -   -
- -      -   - - -      --- -  --  --         --- --- --  --- -    -  -   -    - -     -   - -     -
-   --   ---    - -      -   --      -    ----    --      -  -   -  -   -  -- -- -          -  -- --
-  - --      -  - - - --    -   - - - --   -- -    -   -           -       -  --  -    - -  --  - --
--       -  -    - -    -     - -  -  -               -    -   --    - - -- - -     - -     -      -
-     --   ---     - -   --    - - -  --  ----   -   - -     -     --  -   -- - --  -   --     -- --
- - -  - -       - - -  -           --         - --  --  ---   --      -  -   -  --- -  - -      - -
-   -      - -      -       - - -   --- ---     - - -     -  -- -- - -        -   -    -       - - -
-    -  - -    -     - -   -- --  --   -   -   -     -  --       - -    --    --  -    - - -   -  --
-  -   - - --- - -   --   -   -    ---- -      --- -  - --    -  -    -   - -     --          -    -
-  -     - --- -- -       - -- --   -   -     - -- -- --  - -- - - -           - -   - - - ---     -
- -     -        ---  - -  - - --- -      -    -- - -          -  - -   -  - -   -      -     - -  -
----------------------------------------------------------------------------------------------------
