100
100
----------------------------------------------------------------------------------------------------
- -   -       - -  -   -  - ---    -    - -  -     -  -        -  - -- -     -        --         - -
- -  - - - - -               -   -       -- -  - -- -- --  --   -  --    -  -  -  -      -   -     -
-  -- -    -   - - -- - - --  -  --       -  -            - -- - -      - - -- -                -  -
-       --      -    -     - - -       -       -  -  - --     -   -      -    --         -  -    - -
-      --    -   -  -     --    --- --- - --  --  -    -   -- - - -- -   -   -     -     --        -
- -    -  -   - ----  -  -          - - --  --- -  - --   --      -    --    - - -    --- -  -  -  -
- --       -    -    - ---  -  -  -       --   - - - - -     -      ---  --    - -  --    --  -- - -
-- -    -  - -   - -  -  -   --       -- -  - --    -- -  --  -       -   - --   -   -- -     - -  -
-  - --  -  - --    -  --      -  - -   - -         -  - -         -   -  --            - -- - --- -
-   - - -  - -    -  -      --    -- -       - - --  - - -  -  -     --    ----   -         --   - -
- - -- -  - - - -- --    ---  -  -     -   -  -   - - --    -  --- -   - -    --  -   -   --     ---
-    - -- -        - - -  -          - - -  -  -- -      -       --  -       --        - -     -   -
- --  -    -  -   - --   ---   - --- -  - -  -  -  -- - - -- - --      -    -  -          - -  --  -
--   -   -- ---     - -  -      - - -   --    -  -      -- -- -  -  - -  -            ----  -      -
- - - -     -   --         -  --    -   -   --   -    - - --  - ---   -- - --  -    - -    -  -    -
-   -    -   -     ----          -             - -  - -     - -   - -  ----   -- - --   -  -     - -
-  -   -   -   -  -     - - --  -         -   - - -  --- -  -  - --- ---             ---  -   --   -
-  - -   --  -     - --- -     ---- -       ---           - - - --  --   --  -  ----     -    -    -
-  -     -    - - -      --   -   -  - -    -      -- --   -       -  --   -- -        -  -- -  -- -
- -    - -         -- --           -   -       - -  ---  -  - -   -     -    -    - -    - - - --- -
-   --   - -       --  - - - --- - -  -- --  -    - -   - -- -  -     ----- -  - -   --    -    -  -
-          -   -         -  -  - -  -      -      -   --   -    - ---   - - -               -      -
-     -  --   -      ---        -        - -   -  -- - - -  -- -     -   - - -   -   -- -  - -  -  -
--- -   -   -     --          -      -  -  -  - -   -     -- -   --    --   -  - -  -  -     -    --
-- ----  --         - --       - ---     -  -  --     - --  - -          --      - -    --    - -- -
- -  - - -     -  -  -  -  -             ---  -  -    -   -   --        -      - -   -             -
-     -   - - -  -   --    -----       --           -  -   --    - -       -   -      -      -     -
---    -    - - -  -  - - -     -   -  -   --  - -          -   -     - -  -   - -      - - -----  -
-  -   --     - -  --- -   -   - -- - -  -  - -     -   -         -- - - -   -  -      ----   -   --
----      --                  -   --      -      -  - -      - -  --   -    -    - - -     -   - - -
- - -   -  - -   -       --    -     -  - --  -      -   -     - -        --     -- -    -- -      -
-       --   - -      -    -    --   -  - -   -      ---     - --     -        -  -       - -   -- -
--  --          -    - -   - -     -  - - - - -   --    -    - -          --  -  --  -----    --   -
-- - -  - -   -- ---    -   - -      -     -    -          -   --        -  -- -     -          - --
- --         -     -   --  -       --  -- -         --- - -     - -      - --- --  -   ---    -    -
- ---          - -     - -    -       -   -  - ---   - -  - -  -    - -   -   -         -      -   -
- -         --   - - -  -     - -     - -          -   --- --- - -      - - -    --  -    -  -  -  -
-    -   -  -- -     -             -  -       ----  --    -   --       - --  -- -    --- - -- -   --
-  -      --   -    - -- -   ----   -        -     ---    ---  - -  ---   -         -  -    -  - - -
-     - - -  - - -- - --         --  -  -   -    - --   --       --  -  -  -  -   - ---  -- - -- - -
-   -- -   -  --      -- -    - -  --   -  --     -          -  -           -  - -           -    --
- - - - -   -  -    --  - - -    -  -    -  -              - - -   -- - -     -        - --        -
- - - -  -  -       -  - -- -- -          --   - -- ---- --- -- - - - -     --     - -- -    --    -
- -  -- -   -     -    - - -  - --   -  - --   - -- -       -      -     -     -             -   - -
-   -   -  -  -   - -  - -  --   -    -      - -   -  -   -  - - - - -   - --       -   ---       --
--     - -    -- --  ---        - - - --   -  -  - -     - ---  -     -  - -  ----    -    --   -  -
-     -  - --  -   -           -       --  - - -     - - - -     - -        - -    - -- -- -- ------
-   --  -    - --- -----   -  -- - -  -    ---  - -  - -- -     -    - -- -   - --    - -     -   --
-  --      -     -       --- -  --  - -   - - -  --      --- -   - --     - -   - - -   -        - -
- -       --  -- -   --- -  - --              - -  - - -- -   -    --   -- -      -   -            -
- -            --        --        -   --   - -  - -  - -     -   - - -     -          --        - -
-   --  -   --       --- -      -  - --    -  ----  -     --     -  -   - --  -   -     -      - - -
-   -  -        ---  - --     --          - -    ---   -     - -      -   --  - --  --    -  - -   -
- -       -  --   --   - ---  -   - --      --       - -   -     -  - ---       - -   - -   -      -
-  -- - - -     --   -     -   - -    -    -     - -      -       - -         - --  --- -  -       -
-       -   --        --  -- -- -  --  - ---     -          - - - -   -    - -   -    -   -   ---  -
-   -  -   -    -   -  -- -     -  -  -    --   -     --- -  - -   - - - ---    - ----  - -      ---
-- -- -      -     -     - -  - -  - - - - --     -    - - - - -             - -     -- -     - - --
- -    -    - -   -   --- -    -- -   -   -      - --  - -  ---        - ---   -   -        -      -
-  - -      - -    --  ---- -- -    - - -- -  ---    -  - -   -   -- --      -  -   -- - -       - -
-   -  ---  --   - -        --        -  -  -      -     - - -      -  - -        - --- -          -
- -        -    -    -- --      -  - -     --   --     - -    --  -  -- -    -     -  -- -       - -
-    ------- -  --  - - -  - - --- -   ---- -    - -   ---     - - - --  - -  -  - -   -  -   - - --
- - -         -      -     -    -  -   -   -  -- -       -    --         -    --   -    -   -   -- -
- -  -  -  --  -  --  ---   -  - -  -- -    --  -       -    -    - -        -      -       -  --- -
-     -    - --- -     -     -   -   - -         -    - --   -      -  -          -     -   - -   --
-    - -  --    - --    -     - -       - --   - --   -    -  --  -   - - -                       --
- -      -- - -   - - - - ---     - -  - -       - -   - -  -  -    - -    - -     --     -  -  -  -
-        - --       -   -      -  -    -     --      -- - -  --- --      ---- -   -  --    - -- ----
--  - - - -   -       -     --   --    --     --          -- - --  ---     - ---   --     --   -   -
-  -    - -  -  - - -      -- -  -   -  - - --  -   --    -      - -   - -  -     --- - -        - -
- -  -    -   - --              -    - -        -      - -       -- -        -         - -   -     -
-    - -    - --   - - - - --          --            - -   -    -   - -    -        ---    -       -
---- -   -  -     - -    -        - --    --  -  --      -  -   -  -      --  --    ----    -  -- --
- - -           - -   -   -      -  --   -   - - - -    --   -    -    ---  - -       -      --    -
- - -       --   - -     --    -   -    -  -      -  - -  - -    -  -    - - -- -- -   - -   -    --
-  -    -   -    --  ---     -  - - -      ---  -----   - ------   --  --   -   ---   --  --     - -
-    -  -  -   - - -- -    -    -   -      - -     -    --   -  -   - -    -  -- -  - - - -    -   -
- - - --    -  - - -     -    --   -  - - --   - - - -   --  --  -  -  -  -  --  - -   -- --    -- -
- -     -   - --     - --    - -     --- -  -- - -   - - -  -  --    --   -     -- -   -  -     - --
-  - --    --  -   --      -  -   -- -  - -- -- -- -  - -   -- - -       - - -       -        -  - -
- -  -  ----  -    -- - -   -    -  ---  - - -      -     -- - -  -        - -- -   - -  -    --   -
-    --           -  -    -  ---          -        - -- - -     - -       --    -  -   -  -   -    -
-       -- -     -  ---    -  - - -    - - -    -      -           - --    -   -      - - ---  -   -
-- --     --   -  --   - -    -     -   -  -  -   -      -  - - --    --  -      -  -     -  -     -
-     -        -      -     -   -    -   -- -  ---   -   -          -  - -  --    --  - - -      - -
-    --- - -          - -   -  -  -            - - -   --   -   --  -    - -   - -  -   ----       -
-  -   - -   - -   --  -         --  - -  -  -   -- -    -       -  - -   - - -   -  -    -- -- -  -
----- --- -        - --    --  --  --  -  -         -     -  --- -  - ---     -  - --  -      - -  -
-  -    - --  -  -   -    -       -  - --  -  -      - -   -   - - - --  -     -         --        -
--        -     ----- --- --     - -     - --   - -  -   -  ----- -    ----  - -     - -    -   -- -
-             -  -           -  -    -- -   - ---      -  -    - -- ---     -   - -  -          ----
--  -  -   --          -          - -   - -          - -      --  --    -       - - -- -- -        -
-       - -  --  -  - -          -- -   - -   -  -  - - -- -   -  -- --   --  -    - --   - -   ----
-  -- -  -- -     -  - - -   --   -         -  ---  - - -   -   -- -   -- -  -- -       -    ----  -
-    -    --    --   - -  - -    -   - -  -  --     - - -  - ---   - --    -   --  -  - -  -   --- -
-        -- --    --    -  -   --  -   -  - - - --       -       --          --   -   -      -- - --
-   --  -   - -   - -     - --         -       -    -    - - --     -  -      -     - - -  --  - - -
----------------------------------------------------------------------------------------------------
