100
100
----------------------------------------------------------------------------------------------------
- - -   - - --     -  -   -     -         --    --       -   -  - -           --      -            -
-     -   -   --        -   ---      - ---  - - -  ---- -  -    -                       --- -- -  --
--  - -    --  -  - -         - --    -   -      --  -- - -       - -  - -------- -        -       -
-        -    -  -    -  - --     - - - - -    - -     - -  -   -        --    --      -  -   --   -
-  -    -- - -- -    -    -  -     - -     - -  -        -     --   --  -  -  -- - -   -  --      --
-  -   -       - --              - -- - -  -  ---              -   -- -  --  -  --- -- --      --  -
- -     - -   -   -  ---  -  --       -   -  -      -  --- - -   -      - -    -      - - ---- - ---
-  -   --    - -- - --   -     -----  - -          - -          --   -    -    --    - -     -     -
-    - - ---     -     --   -   -         -- - -  -      -----     -  -   -  -  -        --- - -  --
--  - -       -  ---    -    - -   ---- -   - -     - -   --      -    --    -          -     -    -
- - --- -   -- --      -  --   - -   - - - --- ---  -    -  - ---  --   -        -   - --   --   ---
--  --            - - -         - - -     --     ---   - --    - - -  - -  -     -    -  - -   - - -
- - -- - -   --- - -- -     - -  -       - --   -       -    -   -  ---   - -  -   - ---- - - --   -
-  -    -       -  -   - -    - - -    - --    - -  --   - --   -        -  -   -- - --         -- -
-  -  - --    --      --  -   -     --   -     -       -   -   --     --   -       -   -   -   -  --
-   -  -          - -   -  - -   --        -     --        -   - -  -        ---   -- -       - -  -
---  -  ---   --- -- -      -    - - -  -- - -       --    ----- -   -                       -   - -
-  --    ---     - -    -- -  - -  -  -       -     --      -- - -  - --  -    - -- -  ---     - - -
--   -  -  -   --   -  -     -    -  - --    ---- -   -   - - - --      --  -    --       -     - --
-  -                -- -- --  --- -    - -       -  --    -- -   - --    -    --   --  --  -    -  -
-       --  - -  - -- - -   -   -   -   -  -   -  - -    -  -   -       -- -      -   -- -  -     --
- -  -        -   -   -  -- - -  - -  --           -     ---   -   -      - -        -   - --     --
- -      -     - -   - -  -   - --         -    -   -    - ---  - - -    -  -  --     - -- -       -
-- --     -- - -   --- --  -       -    - -  - --    -- - -   --- -  -     - -  - -   -   - -   -- -
- -      -   -     --       --  -      -    - -   - -   -  -      -  --  - - --  -  -           -- -
-  -             -  -     - -        -- --       -  --   --- -- --  -  - - --  - - ----    -   - - -
-    --  -    -            - -- -     -  -           -  - -  - -  -      -  -   -          - - -  --
- --  -   -- ---  -- --  -  - --  --   -  - - --  - -      - --   --   - - -  -- --        -       -
-     - -- - --  - -    - --    - - -       - -    -   -  -      -        -              -   -- -- -
-   --- --      -       -    - - - --            -      - -  --       -    - - -         -  -   -  -
--   --   -- --   ---   -        --     -  -       - -- -       -      - -            - - -        -
-- -   --  -   -        -      - -      -   -- -- - - - -   ---      - - -  - - -            ---- --
-   ---  -- -  - -  -- --- -    --   --  -  - - -       - -      -       -    --   - -    ---   -  -
-  -   -  -  --  -  -    --- -  --  -      - -     -               -    --         -    -     -- - -
- --  -     -  -  -         -   - -    --- --- -   -    - - - ---     - -    --       - - --     - -
--     -       - - --                -     - -     -    -     -  -- --   -  -    - -  - ------   - -
- ---   ---         -   -- -   - --    --          -    - -  --   - -  -            -  --       - --
-  - -       -     -     -   - - -    - -    -  --   -    -         -   -----  --    -   ---      --
-    -- - -   -      -   - -  - - -  -- ---  -  -     --- -  --  -      -- - -     -   -  -- -    --
- --   - --      - -  --   --  - - -  - --   -   -   -  --     --  -       - -     -    -    -- -  -
-   - -  - --      - --- --  -    -- -- - --  -   -    - -  -          --  -- -- -      -   -    - -
-  -     -  -      --  ---  -  ---   -  -    - --    -         ---   -       ---  -           --   -
-     -   -       -    -       -  --  -  -   -     - --     -   -        - -      - --  --       - -
- -       -       -   -    --     - --    - - - -          - -   -     --    -  -  -  -    ---   - -
-   -  -  - -- - -  - - -    -- - -   --   -  --   - - --     --  -- -    -  --  - --- -    -  -   -
- -  --  - -       - --  -  - - - -   -      -     - -- -- -      -  - -        -  -   -   -    -  -
- -      -   -            - -   -  -    -       - - -   -   -   -   --  --- -   --  - --     --    -
-  -    - - -   - --      -    - -- --  - -- -- - -  -    - - -       - -  -       - -     --      -
---     - ---  - - - -      - -- --- - -        --  -   - --        --  - -- - - --  -        -  - -
-      -      -  -  --        ---  - --   --- -  -  - -       -   -          - - ----  --- -  -  - -
-   - --    -  ----       -  -    --   - --          -  - -- -      --- -          --  --      -   -
-   --  -     --      -   --  -   -  -- -         --- -  - - - -  - -   - - -    --   - --    -- - -
-    - - -   ---          -  --- -- -  - -      -     - -- -     --  -- - --     - -  -    - -  - --
-    - -            -   -  -- -   ----    -     - - -     -   --    - -      -    ---   - -- -    --
-    -   - -    -   --   --  -  --- -   -   -   --  - -          -   -    --  --         -    - -  -
--    ----    --   -   --   -    --  --  -       -  -- -    - - -- -  -- -   -  -       -    - - - -
-  - -     -  - --- -   -  -   --  -    -   --  --        -   - -     --- -         - -  -     - - -
- -- -       - -  - -   -         - -   -  - -- ---   - - - -   - --  -   -  -         -  --   - ---
-  - -     --  -   - --   -  -     --      -   -   --    -- - -- -     -    -  -     --- -  --     -
-       --       -       ---   -          - -- - --    - -  --    -  -      -   --       -   -- -- -
--    -  - -   -  - -               --- - -  --      --     - -  -   -    -- -    - - -  -  - -    -
-- -    -   --     - ---  --    - -   -      -   -  -   ---    - -      -      - --         - -   --
--    - -  --  -  -   --- --          - ---  - ---         -  -  -  --       -   -   - -  -  -  -  -
--            -   - -      -    --  - ---    - - - -     -      -  -  --    -    --        -    -  -
- --     - -- --     -  -- --      -       -           -    -- - --- -  -      --  ---       -     -
- --   --       - --   -- - - ----       -    - -  - -- -  -   ---        -- -   -  -  --   - - -  -
- -          -       -     -- --  - -   -     -  - -    -    --         -   -        -     -  --- --
- -     --      ---- -  -   -   -    ---  - -      - --  --      -  - -         -- -    --   -     -
--  -     -  --  - - -  -     -  -        --   --  --  -- -  -  -  --     --   -----    -  ----  - -
-      -    -     -  -  - -        --  --     -            -- - - - -   -- - -      - -    -       -
-- - -   -    - -      - -   -- -   -         - -   -       - -   -   - - -      - -  --   --  -  --
-    -  -- -  -  --  -- -    -     - - ----      - -- - -   -        -    -       --   - ----   -  -
-- -      -  - --  -       -    -   - -   -- -  -    -   -        -   -      -   - - --  - -- --  --
-- - ----    -- --     -  - --  -   -  -     --   --   -- -   --  - -           - - -         - -- -
- -       - - -        -- - - ---   --    -        --  -    -    -     ---- --    -     - --  -    -
-      --        -  - - -  - --  -     - -  --       -  ---  - -     -    -    ---  -  - --    - - -
- -             -- --   -  --   -  --    -  ---- -      -   - -   -  --- -    -    -  - -  -- -    -
-   - -   - -  --     - - -   -         -  -   - - - -    --   - -  - -   -      -   --       -   --
-     --  -     -      -   -  -        -     --     -        -     - - --   - - -   - -  - - - -   -
-       -     - - --        -      - -      - -- - -  -  -   -   -- ---   -  -  - --    -         --
-   --         - -  -   -          -   - -       -       --        - -    --   - - -  ---   --  -  -
-  -      --  -    - --   - - -     - - -          -     --  - -    --  - -  - -- -      -  --  -  -
-  -  -  -        -- - -     -  - -       - -     - -- --   - -            -- -  -           -  -- -
-- - --   -  -     --   ---   - -   -   -- - -   -- -  - -  - -   -      -     -  -        --  - - -
-           - - - -   - -  -     -  -   --  -  -   ---      - - -   -    --    -  --  --    -      -
- -     --   - --         -  - - - -       -  -     -   -  -      -- -   -  -  --    --    ---    --
-         -  - -   ---  -  -      --         -   -    -   -- - -    -  -- -       -   - --  - -    -
- ----   ----              - --           -  ---     --  -   ---   --     --   -- - ---- -  -   - --
-  -- --  - - -    -- - --  -  --   ---   -        -      - ---         -   - - --       ----   -  -
-      - ---    --    -     -   -- -  -       - --  -         -   - - - -  -   - -   -  -  -       -
- - --  - -   --- --  - ---   ---            -    -   - - - -   -  -    -     -   - - ---  -  -    -
-  ----    -    - - -       -    ---   -   -  ---     -    -       -  - -           --    --  -- - -
-      --  --      -    -  --  -  -       --   - -- -    -- - -- -   -    - --    -- -- -   -      -
-   -    - -- -           - - -  -     - --    -   - -  - - -    --      - -  - - -   -  -     --- -
--- -- - -     - --  --  -          -  - -- -           - -        -     -  ---        - -    -   --
- --  --- -  - --      --      -        -     -   -        --  - -- - -- -         - -   - -     - -
-    - -         --  -   -  -    --  -  ----  -   --        - ---       --     - - -    -  -   -   -
-               --  -     --- -  - - - -   -   - -  -  -  - -      - -   -   -  -- - -- --   - -   -
----------------------------------------------------------------------------------------------------
