100
100
----------------------------------------------------------------------------------------------------
-   -    - -     --            -   -  -- -   -       -     -  -  -                   -        - -- -
---   -        -    -    -  - - - -     --   -   -  -    --    ---         -- -- -- -       -- - - -
-    ---- -  -   - - -                 - -- -  -  -   --    -  -  -- - --  -  - -  --    --        -
----       - - -   -    -  -  - --   - -  -    --      -     --  -   - -         --  --   - - -    -
- - -  --   - -   -   - -      -     -  -- -     - -   -    -     -   - -  ---  -   -    - -    - --
-  --   --  - -   -    - - - ----- - --   -    -  -      -      -         - -          ----   -- - -
-  - - -   -  -      -      --   -  -  -  --  --- -- -     -  -              -    - -  -   --   -  -
-    -  -- -- - -    --   --  -  - - -                -- -    - -        -  -   -  --  ---     --  -
-  -- - - -  -   -   -  -   -  - -  -       -   --       -   -  -   ----  --   -- -    -   -     ---
-   --- - --   -     --    - - --  - -   -  - -   - - -- - -   -          -   - - - -   -          -
- -          -   -  -   - -  -   --   - --  -     --    -  -    -- - -   --  -    -      -     -   -
-       -  -   - -    -  - -     -  -     -- ----    - - - -     -  - -   -      -  ---  - - ----  -
-          --    -  -- -   -   -- -- - - -       ---- -- -     -      -  -  - --    -   --   -- -- -
--  -   -  - - - -- -    --    -    - -        -   -   --          -   --        -   -    -    -  --
-  - -  - - -  --     -  - -         --      -   -     -  - - -    - -- - -  - -  - -   -      -   -
-  - -      --  - - -- -        -    -    -   -  -   -  -   -      -    -- --  -       -     - -   -
- - -   - -  --   -      -   - --  -  ----   -     -   -  -    -   -  --      ---      -   -    -- -
-- -- --   -    -  - -    -- -   -     -  - -    -   -----   - -         --  -   -     - - - - -   -
-    -- --  -      -   -- -- -  - -        --         -  - -     -       -   -  -  - - - -  -  --- -
- -   -     -        -  -    - -     --  -- - ---    - -    - -     - -    -   -  -   -   --   -   -
-- - - -  -  --  --    -  --    - --  -  -   -      - - --- -   -- -- -      -    - --- -   -      -
----    -          ----     -   --- -      --     --- - --  - --  -  - --- -   - -           -   - -
-   -     -- - -- -     - --   -     -              -  -  -   -- -    -   --- -   - - -    --    - -
-- -- -      -  -  -   -       -- -       - ----   -       --         -    - - -              -   --
- -  -     --      - -  ----        --      -     -   - --    --    - --   - -- -- -        -  --- -
-  -   ---     - -   -        - -        --  --       - -  - --     - -- -   - -   - -  -    --    -
-- -- -           - -      -      -  - - -  -   - --- --- -  - -         - -     - -   -        -  -
-    -          --     --                         -     - - -        -   -     --   - -         ----
- -  - - -   -     -      --- -     - - -------- - -  -   - - -  -  -   -  - -    -- - --      -   -
-         -    - -        - ----  -   -       -  -   -- -- --- -   -  -       -  -     - -     --- -
-    -  -  -  -      -          -- -   - - -  -     -       -   - --        --    - -- -  --   -   -
-   - - - -               -      -         - -     - - ---   --- -   - -  ---  -   -  -  - -  -   --
- - -   -  -        - -       --        --             -    -       -  -  -   -    - -  -          -
-                -  -            -- -  - -  --  --    -- -   -  -    -       -  -          -       -
-    -- - - -- --           -  - - - -  -  -  -   -      --  -- -     -- -          --   -     - ---
--- -  -   - -    --- --     -   ---  --    - ---- ---     -  --   -     -  -    --    -- -- -   - -
-     -   -  ----   - -    --  - -  - -  -      -  -    - --  -  --     -    - - -  -- -       - - -
---    -     -   -  -   ---            - -   --  ---- --    - -   -   - ----- -         - ----     -
-     -- - - ---  - -- -  -     --      -     - -       - - ----        -- -   -   -  -- -    - - --
-  ------ --   -   -  -    - -- --    - -   -     --  -  -       -    -   --    - - -      ---- -  -
- -      -  -  -    -    - - - -  ---  - -  ----    -    - -  - -  --      - --    - -   -     -   -
-   -  - - -     -   --     -        - ---     -  -   -  -      ---      -- --- --   - -   --- --- -
-     - - ---- -- --- -  ----  - -- -- - -       -     -   -    -  - -    -   -      -   -- --    --
-   ---   -     -    -     - -        -     -   -    - -    - -            --      -  - -  - -  -- -
- --  -   -   -    - - -   - -         -- - -             -  - - - -- - -   -  - -- - - -- -  - -  -
-   --          -  - -       -     -    - --       ---  -   -    -       ---    -   --         - - -
-           -   - -  -- - -   - - - -  -         -- - -- -  -    - - -   -   --   -- ---  --- -  - -
- - - -   --        - -    --           ----   - -  -      -  -    -    --  -       -            - -
--  --- -   -      - --    - --   -    - -   -   -     -   -  - - - ---   -  - -       -   - -     -
-  - --- - -      -  -   - -        -  --  - -  -   - -  - -   - --  -  -  -        -  - -         -
-   --  -        -  -       ---- -  - -- ---             - --- -    - -  -   -   -  - -   --  -- - -
---        -- -  -  -   -  -       -    - - -       --  -   ---  -      -  -    -   - --  -        -
-       -      --- - -   - ---    -      -   ----   - --  -   -   --    -   -- - -      -  --   -- -
-  -  -   - - -    -    - - - -         -   -    -  --    -     --     -   -    -     -       -    -
-  - -   -          - -        -   - -          -- -   -  ---  -     --  -    -  -  -- -  -- -     -
- -        ----     --      - -        -   - --   -     -        ---- - -       --      -  - - -   -
-     - ---       - -  -  --- --  -        - - -    ---  -                ---   ----  -   -    -   -
-   - -    --  -  -    -- - - - - -   --  - --     -        - -  -  -    - -- --       -  --       -
- -- -  --- -  -  -   -     -     - -       -   ----- --   --                --  -  -   -  --  -   -
---    --   -   ---  ----    --       -- --   -     --  -   --    -    - -- - -        - --    - - -
- -   -  -  - -     --  -           -  -   - -     -    -  --  -    --   -    -     - - -  - - -- --
-   - - -  --  -         - --      -- - -  - - -      -- - -  - - -    -    -   - -- -        -  - -
-    --     -     --    -   --  --     -----   -  -- -- -   -     -- -   -    -    -     ----  -   -
-  --   -  -  - -    - ----    - -- -- - -   - -- -- -               - -- -  -    -- -           ---
-       --  -    -  -    - -  - - -    - -  --- -  -  -   -  ---    -   -   - --    --  - -   --   -
-  -- -   - --          -  -    -- -   - - - -- --   -        ----  -  - -- -   --    -      - --- -
- -         -     --  -     ---- -      - -         --  -   - -      - - -     -         ---       -
-  --- -   -   -  -     - -   -   --    --    -   -    -  -- -  -     --   - - --         -      - -
-            -      - --  -         -- --         -       - - -     -    -    -  -   - -          --
-  --     -   - ---  - -     - --       - ---    -  -  -   -  -  -  -  -   ---   -  -        - - ---
-- -    -            -    -  -      -   -     - -    -- --      -   -  -      -  - -      ---- --  -
-        -    - - --  - -       -  -   - -  -   - --   -       -  ----         -      - -    -     -
- -  - ---          -  - ---- --     ----     ---     -   - -    -     ---   - -     -    --- --   -
-  - - -  -     -   -   - --   - -        -    -   -   -   -   -- -- -  -        -          --  -  -
-  - - --           - -   -- --          -   -   ------   --   - -   --      -            -  -- -  -
-   - - -    --            -    --- - -     -     -  - -     -- -  --  -- -   - --  --- - -     -- -
---     -     - -      - - - - -                 - - -   - -   -        -   -- -  - -      -- - -  -
-  -   -  -  -  -           -     -   -- -        -    -           -    -     - -    ---      - - --
-    -   - -  -   - -      --  - - - --- -   - -  - --    -- -   -   - -  -             -    - --  -
-   -  -         -   - -     -     -     - -    -             --  -  -   - -- - -     --- - -   - --
-- - --    -     -     - --   -     -- ---   ---   -  -- -         --   -  - -    -   - ---- --   --
- -     -        - -    - ----  - -         -          -      -- -    - - --  -- - - - --   --  -  -
-   - --  -     -  --            --    --  -   - -- --    - -  -       --   -  - -       -      -  -
-   ---- --            -   - -  -   -         - -  --  --       -  -- - - - -  -   --     --  -  - -
-   -      - -----       -    -   -  - --     -  -- - --    -        ---    --   -  --- -  --    - -
-  - --            -   -  -    --   - - -  - ---   - - -   -     -   -  --   --   -- --   - - --   -
-   -  -     --        - -  - -    ---  -  - -  -   -  - - -  --    --    -      -   ------  -- - --
-   - -  -         ---  -   -   - -  - -- --     --  -  ---- -  - --       ---  -         ---    - -
--      -  -  -- -     -  --  -           -        ---      - -   -         - -    ---    - -    - -
-   - -- -   -   -- -    - - - -   -  -- - -  -  -  -   -    -  -   --       -  -      -   - - --  -
- -  -    -  -    -     --  --   -- -      --  - -  - -  -  -    -          --  -   ---  -        --
- -- -               - -   --   -     --  -- --   -  -   ----   - -   - -  -  --       -    -   -  -
-     ---         - -     -     --- --  --   - ---     -  -  -    ---  - -       -  - --   -      --
-- -        - --- -  - - -  - -    -    - -   -- -   -  ---         -- -- -         -   -     ---  -
- --  --            -    -  - -  -  -  --          -  - -- ----    -   -  ----- - -  --    -      --
- - -   - --  -- --            -  -   --  - --- -   - --  -           -  -     -   --    -     --- -
-- -   -       -- --- -   ---    - -         -        - ----  -        -- -  - - -  -    -         -
-      --  --      - --              - - - - - -     --        -    --                - -   -      -
----------------------------------------------------------------------------------------------------
