100
100
----------------------------------------------------------------------------------------------------
- -         -  -  --       -      -  - -     --  - - -               -    - -    -      -          -
-  - -          -   --    -  ---     -   - -       -    -    --   ---  - -   -- -   -     --  -   --
- -     - -   -  -    - --  -- - - --- -   -- --- -   --  -   -       ---  - - -    - -  -  -      -
- -  -  -         - -  -   - --      - -       --- --- - -  -      - - --- -   -     -- -    - -----
-   - -     --- -    -         -   -   -   -  -         - -- -          -  -  - -      -   -  ---  -
-   -   -      - -    --      -- -  -     --   -  - -  -    - - -       - -  --   -              - -
- -       -  - -   - -       --    -- - - -  -       -   -    - - --- -     --  --- -       -  --- -
-- -   -    ---- --  -   ----     -      --       ---   -   - - --                  -      -    -- -
-      --  -     -      -- --       -   -    - -    -     -   -     - -   -- -        -- --  -     -
--   -   -                   -   -- - -       ---        --   --  -  - -    - --        --   - --  -
-   -- -  -      -- --    - -  -   --   - - - -    --  - ---       -    -  - - -    -  -    -   - --
-   -   -  -  - -         -           -   --      -  - -    --  -         --     --   ----  -- --  -
- -         -- - -     - -    -   -      -  ---- -   -      -  -  -- - - -   ---    - -   -   ---  -
-- -      --   --  -     -             - -   -    --    ---  -      - -        -- - -  -         - -
-  -   --   -- -  -         --  -  ---- -     --  -  --    - -         -- - --    - --   - -    -- -
-  - --   -  --  - -  ---  --- -- -     -  --  -       -       -  -                 - -- -    - - --
-  -   - -- - - - ---- -      -      -   -     -   --- - -  -   --     - -        -  -  -  - -  - --
-- --       -  -            -      - --   -  --  - - --   - --  --   -   -  -  --    --- -  -- - - -
- -  --  -    -   -      --     - - -- - -  --   --    --  -   ---   --  --     - -       ----   - -
- -        -   -  - -     -        -               -   -    - -     -  -   ----   -- -  --   -- -  -
---          - -     -   -  -  -    -- --- - -   -   -- -        --      --    - -       -  - -    -
-   -     -    ---  --- -   --    -         -  - -     -- ---       - --   -  --   --  --      -   -
-   -- -    -     -     - -      -  - -     -   -     -- --   -    - -- -     -   -  -    -  -   - -
-  -          -  -    --  - -    ---              - -    -  - -   ---    -  --   -   -      -  -   -
-   - ---  --  -   ---     --      -  -  ---   -    -   -     -- - ---                 -      --  --
-        -  --    --  -  -   -        -  - -     - -  -   -  -    - -    -   --- --- - ---  -      -
-     -   -    - - --              -   --   - -    -   - - -   --        -      -             -  - -
-      -     - - -      -    -   -  -  -- -  - -     -   -  -    -  ----       -    -  -    -      -
--           -  -- - -    -- -  - --   - -- - -- -- - -  -     -- -         - -- - - - -   - -     -
- --   - - -   - -     - - --    -     -   --    - -- --  -  -    -  - -      -   - -  - ---     - -
- - -     --- -       -   -    -    --   - - -- - --   - -      --  -- --     -    -- -     --  - --
- -     -   - ---   - -- --          - ----  -  -   -- ---    --    -    -- -- --  -  - -  -  -    -
- -   --       -   - -        - ---       ---     -       -  -- --- -     --   -- -     - - --     -
-     -      -  -    -- - -   - - --   - -       -   --       -  --  -  -    - -         --   --   -
- -- -    -    -   -- -       -  --   - - -    ---  -   - - -   - --   - ---- --   --  --     -   --
---- - -              -  -     - - --- -   - -    ---                - --    -   - -   ---    -    -
- -  - -      -   --  ------   -  -     -         -   -    -       --    -   -- -        - -- -  - -
-    -- -  --  -                - ---   - -       -  - -  -  -  -    --  -   -         -     - -  --
-   --   -    -     -    - - -       -  -  -- -    -   - -     -            --    - - -   --   --- -
-   -     --    -      - - -       -- -      -   -  -       - -- - -      - - -     --     --   -  -
-   - - -  -  -   -     -       --- -          - --   --   - -           -    -  -        - -  - - -
-  -  -   - -   - -      -     --  -  -      -    --    -  - -    -  -   - - --   - --   -   -  - --
- -  -           -   - -   -  -    --  -     -       - --   -   -  ---   -  -       -  -   -  -  - -
- -- -- -- -  -  - - -    - --  - - -  ----  -   -   - -     ---  -     -  - -  --      -  -    ----
-    -  -   -    - --      -           -- -   -   -  -- --      --   -  - - -    - - -        -  - -
-  -   - --   -      - -- - -   -      -   - -  -  -   -       -     -  -    - -        -     - -- -
-    -    -  - ---- - -    -  -     --         - - - --      -  - - -- - - -   --   -       -      -
--      - -  --   -     -- --    -     -- - -  -    -   -   --            -     --     -   -  - - --
-    -  - - -  - - ---  -      --- -   - -  -      --- -         -  --   -   -    -         - -    -
--  -      -    -     -  ---  - - -  -      ---     -       - - -   -  -- -  - -     ---        -- -
-     -    ---  -   -- -           - --     -         ---- - -  - -   -  -   ----  -- --    --- - --
-  -   - -   --        -- - -    -    -    ----- -  -- - -  -  -  - --  - --      -  - ---  - - -- -
-  -    -- -     --   - - -- -    --     - -   -      -  ---   --     -     -- --  ---      - -- - -
--         -     -- ---  -    -     -    -- -    -  -  -  -      ----   -      -      -- - - -- -  -
-     -     - -     -- -  --         -     -  -  - -- -      - -       -    -  - - - -   -         -
--  - --- -           -  - -- - -- --  --   - - -       ----- -  -  --    -      - -          -    -
-     -     -    -  --      -       -          - ------      --  -  -- -  --- -- -      --  --  -  -
-- -  -- - -      - -  --          -     - - -       - - -      - -   - - -  -  -- -     --- - -   -
- -   -  -- --  -   -  -    ----   -- - -  -       --     -  -- - - -  -  - -- - --       - --     -
-  - - - - - -  -   -    -    - -- - - -     -   -   -   -    - --   -    -       -       - -    - -
--   -     - - -   -  - -  - --- -   -   --  -  -    --  - -   - - -   -- -- --    -    - --       -
-    -  --  -      - -- ---- -   - -   - -  -    -  -      - -   --   - - -     -       -   -      -
- -  --       - --  -  -    - --  -- -  - -    - - -- - -  --   - --       -      --- -   --  -    -
-  --    - - -         - -     - -     ----    --   -   -   - -       --  --  - --   -         -  --
-  - - - - -   -      -   - -    -- --     -    -        -  --      -  --      -      -     -- -  --
--- -  -    -  -      -  -      -  -      -  - -  -   -- - -          - - -  - - -   -  - -     - --
-   --   -- -  - - -   -    --    -   -   -     --  -  -     --        -   -    -  --- - - ---  -- -
- -  -     - -  - --  - --         --  -- --    -        -  -   -  -  -        --      -- - -  -   -
- ---         -  - - - -  --  -- --    -  -           --- -    -- - - -   -   -   --               -
--- -  -  -       -    - -      -  - -   -- -   -  - --      - -  --  -   - - --  -   --  --    ----
-  -   --    ---     - -   --    -  -    -   -- -  - -   -       -      - --- - -  -           -   -
-     -  --  -      - - -    --   -- - - -     --  - -  -  - -- - - -   -  -  - -           - - -  -
- -     -     -- ----    -  -  - -  -  ---    - -  -     -  - -- --  -      ----- -  - -        -- -
-   - - -    -  --  --   -     -   - -- - -  -     -      - -  -      -  ---   -         -  - -   --
-  -    -        -    - -  --  --  --     -  - --     -      -  -  - -  - -           -   - -      -
-  - - -    -  -- - -  -        --      -  -  --    -    --      - -  -      -      --      -      -
-  -     --       - - -  -  --    --  - -  -    - -- -- -  -   -         ---          -       --   -
--   --          -  - --   -  -   -    -   -   -      - ---    -  - -  -   - -       - --  - -  -- -
-      -             --   - --  -            ---   -  --  - -- - - -       - -  -   - - -  - -     -
-  -  -      - -       --- --- -   -       --        -   -- -        - - -    -  -      -- --  --- -
-   -        - -   - - -      -  --- - - -   --       -   - - -  ----- -        -  ---      --  -- -
- - -      - -  -   --  -  - - -      -  --     ---  -  -- -  - -     -         -    -      --  -  -
--- - ---       - - - -   - - -  --    - -         -  -  -  -      -  -  - - --  -  --   - - -     -
-- --  --- -     -    -  - --   -   - -         - -- -      -- --         --    -      --     -   --
-- -        -   -       -  -   --  --- -   --  -    --  -    -     - -  -  -    -   -- -  -    - - -
- -     - -- -  -- -  -- - -  -   - - -  -     -    --  --    -   - -- -    --            -- --  - -
---  -  -   - -         ----- -- --   - -  - -          - -  -  ---  --  -       -    --  - -  - - -
-  - -  - --   -  - - -       --    ---- - -        --    -   ---- - -  - - --     -      -- -   - -
-  -  -    -    - -          -- -  -                - - -- --  ---   -   -         -- -   -   - ----
-   - - -       - - --  -   -   - --  -    - - -  --   -  -     -    -- -   - -      -- - -  -     -
-     - - - ---   -   -  -  -   - - -- - - -- -  - -     - -  -   -     -     -- --     --       ---
--  --        -     -          - -        - - --         - - - -     -  --      -  -    - --  - - --
-      ----- -  -     --  -   -         --- -   - -   --     -   ---   -- -  -- - -  -   -   -     -
-  - -  --            -         --     --- - ---     -    - --- --    --   -  -              - -   -
-   -     - -      --  -  - -- ----   -  -   -       -         - - - - - - --   - -      -  - ---  -
-    - --     --  -   -    -       -   -      - -- - - - - -   -- --             -- -    - --      -
-   - -   -- -- - --      -  - -   - ----        --   -        - -        - -     -    -     - --  -
-     - - -     -       - -      -         -  -       - -     - -    - - -    - -- -    -      - - -
----------------------------------------------------------------------------------------------------
