100
100
----------------------------------------------------------------------------------------------------
-     -  -- -    --  -       -       -            --           - -    --  -    - -    -   - -   -  -
-    --    -    -- -  - -       -- - -  - -   -    ---- - --   -   --   -   -   - ----  -   -      -
-      ----  --   -----   --  --  --  --     -    --   --- --   -    -    - -    -      -    - -   -
-       -   -          --   -   --     - --   - -   - -   - -       - -       -    - ---      --  --
-   ----       - - - - -   - -   - ---  -         -        -   -    -- -   --    ----  -   --      -
-   ---     - ---        --- - - - -          -----   -    -    --   -     --   -      -  -      - -
-- ----   -    -     -- -  - - -   -    - -      -   -       --   - -   - ----  -   - -   -     -- -
-  ---  -  - -     -  --    - - -     - -   -- -    -- --   - -  -   - - -  - -     -- -   -   - ---
-  - --- -   --        ---          -- -  - - - - --        - -  -  --- -    - - --- ---  -    --  -
-       -   - -     - -- -               -- - --  - - ---    - -      -    -    -    -    -  - -  --
-   -         -  --- -         -  --  -    -    - -    - -  -   -----  --    -   -  -   -  - - -   -
-    -  -    -       -- -        - -       -- --     --  - -        -- - ---  -   -    ------    - -
--  --    --- -      --  -    -   - ---  - -  -  -   - - -     - ---  -  --     -    --    --     --
-           -    --   --   -    --  -  ---   -    --    - -   -- -  -    -    - --  -- - -  -   -- -
-  -      -   --  -     -    -    - -   --       -  - -   - -  - -    - -       - -   -     ---   --
-  --     -- -   -- - -    -- - -- ----    - - -- -  --         -       - --  -   -     --- -  --- -
-      -   - -     -         - -   --  -- -     - - -     -  - -  -          -    - - ---     -  ---
-  -    - -  - -  ---- --            -  --  -- --    -   -- -  - -  -  -   -      -    --         --
--            - --      -  -  --   - - - - -  -  -    -   - - --  -        - - -  -       -    -   -
-   -- -  -        - - -- -  -    -   ---   --   - - -  - --   --  -   -  -- -   -  - -   - - - -  -
- - -- -   -   -     -   --   --    -   - -   - - -          - - -   -    - --      -           -  -
-          - --   -  -  -   -    --      - - -  - -   -      -  ----    - -    ---  - ---  - -     -
- - --   -       -     -  -   -    --  -  -    - - ---  -   -- -      - -   -     -  -  - ---    - -
-      - -- - --- - --    -     --  --   -      --       --        --   --  -      - ----          -
---        -       -   -        - - --- -   - --- -- -    - --   ---- -   -     --        --       -
-   -  ---   -  -       -  ---   -   - -    -     -    -     -     - ---   - --- -    -- -   - -  --
- - -        --  - -  -- - -   - -- --  -   --  -        -   --- - -       -    -       - --   - - -
-- -     -    -- - - -  --                   -  - -        -  - -   -  -          -   - --   -   - -
-  - --     -- -     -- -  -    -       ---    --  -------  -       --     --- --  - -            --
- ---    -   -    -  --  --- -           -     -         -- - -----    - --   - -   --   -  -  -   -
- -    --  -  -        -      - -  ---      --     --   -  --    -   -  - -                - -  -  -
--  -     - -   -- --    -    - -  -                  --  -   - - - - - ---        - - -   - -  ----
-  -  --      - -    - -  -          - - --     -  --- -      -  --   --  - --     -    - - -    - -
-   -   -  ---- ---    ---- --  ----        -            - --  -- -     -  -   -     -    - -      -
- - -  - - -    -   -      -  - - - ---  -    ---     - --         -    --          -   -    - -   -
-  - -- - - --   --       - --- - --      --     - - - -   -- -    -   -   - --   --- - -    -     -
---   -  --- -- -  -       -  - - - -  -- -     -- - - -        -    -   -                - --   - -
-  - -  -   -  --------            -     - - - -               -       - - - ---     --       --   -
-   --  - --              --  -  -- - ---     --  --  --  --  -     - -  --  -    -    -      -  - -
-- ---     -  -  ---- ---   -  -- -         - -   -  - -     - -      -     --- -     -    --- -   -
--     -  ---   - --    -  --    -      -    -    -       -      -        -     --    - -    - - - -
-    -- -      -- -     -      -           ---      - --    -      ---   -       -    -     -- --  -
-  ---  -     -    -  --   -   -     - --           --  -- -  ----    - - ---  -      - ---  --- - -
-  - --- -   -    -    -   -    - -     - -  -  ----- -     -  --    -    -- -     -   -     -  -  -
--        -     - -- -              - - ---  -  -  -                 - --   -  -   -    -     --  --
-   - -        -   - -    -- - - - - -        --         - - -   --- -- - -- -  - - ---  - -  -- - -
--      - -  - - --    --    -   -  -       -       -    - -      -   --  -  -     -    --  -   -  -
--  -   -  -  -     -- -   -     --       -  - -- -       ---    - -      -   - -       --   -     -
-     -   -- -  - - --    -  ---    - - - - - - -  ---       - -- -     -  - - -  -  -  - -     -  -
-   -          -       -  --     -   -  --   -     --  - -          - -    -  - -  -    --       - -
- -  ---    - - -   -  -  - -  ----  -      -              ---            -- - -  -   -   ---   -  -
-   -       --  --  -- --  -        - --   -   -   - -        - -  - -  -    -- - --  -  --   --   -
- -  ---   -       -     - -   -  --     -    -  - -  -       - -   - -    -    - -          --  - -
-         - - -   -    -    -    --- -    - - --     -   -  - - - -  -- -   - -  -   -      -   -  -
--  -- --           -    --  - -  -    -  -      - -  -  - -- -    - - ---   -  -  -   -   -    ----
-  -  -   ---- -      - -   - - -      -   -  -    ---   -                  - -  --     - - -     --
----- ---   -       --   -     -- --  - -        -  ---  -- -   -  --     -- -    - -     -    --  -
-   -  -      - -- -     - - -- --   -  --         -   - -- -  - -           ----   -       -- - - -
- - ---  --     -  - -- -  --          -  - --  -     - - -      -  --     -- ----   - - -    -  - -
-- - ---     --- -  - ----      --   - ---    -    -- --   -    - - -       -           -    ---   -
--   -       - --           --   -  -        -  -       -  - ---- -       -    -    -      -      --
-   -      -             - -  -         -  - -  -   - -   --               -- ----    -   -  ----- -
- -        - -       -       -   -- - -   -   ---    --  -  - -   -   -  -  -           -       -- -
- --        -  -   - - -- - -  -    -   -      - -    - -      -  -     --     -    -   - - -  -  --
-  -      -  --   --    -    --     - -  -  -     --      -- -     ---   --- -  - --- -   -- -  -- -
- - - -    - - -        -- -  - - -- - -      -    --            --  -     -   -   -  - - -   --   -
-        -   - --        -        -        --    - - -     --- -            - -  -- - - --  -      -
-  -     --      ---- --     -  - --   - -     - -   --   -         - -   -    -- ----    --- - -  -
--  -  -     --      --  -  -      --    -  -- --   -- -   - -- - -     -      - -     - -   -  - --
-  --       --  -  -        --- -    -    --  ----     -- -   - - -   -  -  -- - -     --          -
---    - -     - -   - -     - --           -  - - -- --- -   -- ---   - -      --  - -   -  -     -
-   - -- - --   -      -   ---       --   -- -- --   -       --        -     --        --  -     - -
- --   -      -   -      -    - --    -     -    -   -- -       - --    -  -  - - -  -  ---     -  -
-   - --  -    - --   -   --  --      -    -  -    - -  --  -   -    - -  --  - -    - - -   -   - -
-     - - - - --     -  -   - -     -  - -   --- --     --    -  - -  - -     -   -    -  --   --  -
- -  - -  --   --     ---    -- -    -   -     -- -        - -  ---   -   ---              -  --  --
---  --  --  -  -  -   -  - -        ---    -      -- -   ---   -            --   --- - -   --  -- -
-- --    -              --   --       -  - - --- -  -    -   -     -     - -      -- --  ---  -   --
- -    -  --        -- -   - --  -       -    - ----   -  --    -      --  -                -- - - -
- -  -- --  -- -  - --   - -   -----  -     -  -  -  - --       -----   - -  -- -  -  - - -     -  -
-   -        -      -  -  -- -- -  -  --  - -  --   - - -          --- -- -- -  -    -       - -   -
-          -   -     -- - -  - ---   - - - -    -      -  -  - - -         - -    -    - --     - --
-    -  -- - - -         -     -         - -   -   -              ---     --     -  -        -    --
-     -  -      --    - --   -  --   -  -  ----    -   -      -  -      -  - - -   ---    --  - -  -
--         - - - - --         - -   -       -   - -     -    ---  - --  - -  - -  -  - - -  -  --  -
- - -- -          -   -              - - -  --    - -          - -             ---  --    -      - -
- -   -  -  - -  -  --      - -       -  -  - - - -   -   -- -     - - -----  -       -- ---  -  - -
- -  --   --     - -     - -     -   - -    - - --  -    -        --        -   - - - - -   -      -
- --   -     -- -   -- -              -    -         - - -- --  -     -        -----      ---- - - -
-     ---  -         -   -   -  - -   -    -   -         -- -   --   - - -   -- -  -   -         - -
-       -- -     -- - -  - -   -         --     - -     -  -   -      -     - -   -   - -- - -  - --
- ---     --    -           --   -  - -    -  - -  --  -- -   -         -         -   - -   -      -
- --    -       -   ----- -  - --    -  ---     --         -   - --        --     -  -   --- -   - -
-      -- --    --         -   - -   - --   -      -   -          -     -          -   -- ---      -
- -   -           -  --- -     --   - -     -  ---     -    -   - - -   -- --            -   -  -- -
-  - -     -     -      - - -- -      - --    --   -  - - -   -   -- - -       ---     -  -   - -- -
--  - -       - -    - -       - - - - --  --   --   - - -   --   -     --  -    -- -       - -   --
- -  -      -           ----     -    -      - -     -      -   -                  -   --       -  -
----------------------------------------------------------------------------------------------------
