100
100
----------------------------------------------------------------------------------------------------
-   - -- -  -  --     - - -   -   -- -  -  - - -      -  - - -   -          -   --    ----         -
-     -    - --  -  -  - - -   -    -  -- -      ---         --       ---   - -        -   ---     -
-     - --  --  --   -- -- ---   ----         -          -  -  -  - -     -       -  -   - -   -  --
- --     --  -   - -     - - - -   - -  --   -  -  -  -     - -  ---  -- --  --     -- ---   --  - -
-    - --   -- -- -  -      --       -       -- -- -   --     -        -   -   -- -    -  -    - - -
-   -  - -- - -     --   --              ---  -    - -    - -    --- -      -- -         -  - -    -
-   --  -  -  - ---        - - -        -   - -  - --- -  - --  -          -      - -    ---- - -  -
--   - -  -    -- --- --  -    -     -     --      - -      -- - --     -   -   -  -               -
- --  -- -  - ---   --  --         -   -       -    - --- -   -      - -  -      - --    -  --     -
--- --   -    -  - -      - -   -     --   - -    - --  --     -     -            -   - ---     -- -
--       - --- ----   --    --- -- ---   -     ---    -   - -   -   -   -      - --       - -    - -
- -       --   -          -  -  -   -  -  -       -- - -  -     -  -     -     --    -- ---    -- --
- -- -  -       -  -- -    --     --  -   -  -  -    --- - -   --    -     - -      -         -- - -
- --      - - -     --   - -     - -   -       -         -   - -- -     -- -   -   --    - -    -- -
-   -   -   -          -        - -  - -    - --   --  -- - -                 - -     -  --        -
-- -    -     - -- - -- -     - -  --    -        -     -     --  -  -  -  -   - -- --- --    - -- -
- -   -    ---   - -      -   -   - --      --  --- -   -   -  - -         -    --        - -  -  --
-      -       -    -    - -     --  - - -     -   -        -- - -       -   - -    --    -       --
- -  -  -  -  -            - -   -        -- --  --      --  -   - -    - - - - - ---  -         - -
---      -         --- ---      -      -    ----    - -- - -  -   -   ----        ---  -      -    -
-   - --- ---- - - --          --   --  -- -     -- -  - ---- - - --- -  --   -     - -   - -      -
- --          --  -    -  -   -   -  --       -    -  -  - - ---    --  -  -     - -    -- ---   ---
-  -    --       -   -       -- -- -  -  - --   - - ---    -   -  -  --  -         - -   -    --   -
-- - --   - -     -- -   -  -- -- -   -     --      -   -- - -   --  - --            --   - --- - --
-   - -       -  ---    ---  -         -- -     - - -        -  -      -  -    -       -    - --   -
-    -   -  -      - ---  -             -   ----      -  - -    -     -     - - ---- - -      - -  -
-  -      - -           --  -    -  - -- --      -  --  -  --     ---     -      - -     - --      -
-   --     --  -  -     -     -  -  - -- - -      -      -  - ----  -  -      --- -  -       --  - -
- -        -    -    -- - --   - --   -   --    --   ----  ---    --  -  -- -      -  -    --    ---
- -- --- -   - -- -       -   -      - -    --     -  -  - - ---     --   - - -     - - -          -
-   - - --   -  -- -- - - -   --   -   -- -   - -   -    -      ---   -        -  ----             -
- - -     - ---  - -     -- - -   - - -  -   -     -   -   -      -     -- -- -           - -      -
-   -   - -           --   -- --  - --     -- ---- -     -    -   -  ---   - -  -  - - -          --
-   --   -   -  - -      -        -   - --- -      ---    ---      --  -   -     -          -      -
--    -   --- -   --  -     - - -          -  - -  -  ----   - -        ---    - -   --      - - - -
-    -   --  - -     -        -   -  -- ----       -            -  -    - - ---         --       - -
- - -  --      --      -  --- --     - -   -  - -  - --- - - -   -              -      -   -  -  - -
- -   -   ---     -      -    -  -    - -   -    -- -   -   -- --  - -     ---- - - -     -  -  - --
--  -  ---        -  - --     ---     -       -   -  -   -  --   -           -   -  -    -   --   --
-  -      - -      -   -     -    -  - -    - - -- -   - - -- - - - - --   -  -       - --      -  -
-    -    - -  --  ---- --- - - ---      --    -    -   -  - -  -        -  - - -   --  -  -- ---  -
- -      --     ----   --  -   --      -    -- - -       -    - -   -     -  -     -     --   -    -
-- --     -  - - -  -- - -   -  - -  - - -  - - -    -- -      - -- - --  --- --       -       -  --
-   - --   -   -       -  - - -        --   - -     -  - - --      - --      --    - ----- - - - - -
--   -           -    -     -   - --- -  -   --       -  -    -  -  - --      -  -   -         --  -
-  -   - -  --   -         -          -    - -       -- - --  -  --   -      --     -  ---       - -
-    -    -    -- -- --      -       -    --  --   -  -   - -    --   -  -      -      -   - ---   -
-          -- - - -  - -  -         --    - -- -    -        -          -   -- -           --  -  --
-  ---   - --       -  -    - -       -   -     -        --    -- - - -               -       -    -
- --   -- -  -     --  - -  - -- -  -  - -    --   - - -   - -   --    ---    --    - -   --      --
-     --  - - --          - -  - --   -- -  -  -     -   -   -  -    - - -- -   --     --- --      -
- -    -   - -    --   --  --   -           --   - -  - - -  -   --     - --  --    - -     -  --  -
-    - ---     - -     -  -   -   --   --  -   -  - -         -       - -       --   ---   -- -- ---
- - --  - -  - - -  ---- --- - -   -       -    -  - --          -   -     -   - - -               -
--       -    ---    - -  --  - - -         -- -    -   -- - - -- -  -     - -   -        -  --- ---
-      -- ---- --  -     -   -    -     -      --- -   -                  - - -  --    -    ---   --
--  -   - - -   --  -    - -          -    --- -  -   -   -  -  --- - --   -          -     -      -
-  -  -     - -    -  -  -------- -     -- - -   - -   -- -     -  -     -  - --      - -  - -- -  -
- -        -      --  -  ---    ---      -    -      -   -   --  -  -  -    - -- - -- -      -     -
- - -      - - -  -   --     -  - -- - -  -  -     ---        - --  -   -  - -   -     --      - - -
-     -  - - -        -- -   --        -     ---   - --   ----       -- -    --  -- ---  --        -
-     -    -   -   ---  -       ----  -    -        -    --    - -    -- -                --       -
- - -       --  - -   - - -- - --     -   -      - -   -    -           -- ---- -    - -    -      -
--      -- -   - - -    -     -  -  -   -  - -    -      --         ---- -- - -   - -    ---    ----
-       -- -   ---- --  -  --  -  -  - - --     -   -        - - - -- - -  - --     - -            -
-       -- - - -- -  -   -    -   -   - -    --        -     -  --   -  - --   -  -- -   - --   -  -
-  --     - - --      --  -  ----      -    -     -- - --   - -  - -    -   -  -           - -    --
-   -              -  - ---        -      - ---- -    -     --    - -  -   --     - -    -     --  -
- - --  -  -   --- - - -   - -  -  ---      -   ----    -  -     -- -- - ---- --       -          --
--    ---    - -   - - -   -    -     --     -    -    ---   - --    --     -    - - -  -  ---   - -
-  --    - - -  --     - --    -  - -   -   -  -          - -- -   --  - -- -    -  -   - -       --
--   -  - --      ---  -- -   -- -      -  -     -  -  -  -           -  -      -  ---  -   --  -  -
- ---- -            -  - -- --    -      -- -   - - -  - --- --           -   -   -   -     ---  - -
- --      -    -- --       -      -        -   -     -- --      - -    -      -- - - -    -   -- - -
--       -         --  -  -- -    -   -  -     --- --    - -     -     - -           -    - - -- - -
--  -      -     --    -   - -    -- -  -  -- -       -  -       - -   - - -- - -  -      -  -    --
- -       --     --  -  --    -  -  -     -      --         -     - -   -       - -     -   -      -
-  -- -- -  -  -      -  -- -  ---  -     - -      -     - - - - -    - - -  -         --  - -  - --
-  -    -       ----   -    ----   -  -     -       - - - --   ---  -- -  - -  -  -   -    -  - -  -
-  - --   - --   -    -  - - - ---  - - -  --  - -  -  - -   -    --  -- -      -      -           -
- - --    - -- -         - - - -          -   -   ---  - -- - -     -  -       -        - - -----  -
- -   - -   -  - -        -       -- -  ---- - - --     - --  - --          -  - --   -      - - - -
-   --       - -- - -   -      - -       -   --    ---  -         -   -- -  -       --  -  -       -
-- -     - --    -    -  - -    - -     --   -- ----       ------- -  -   ---  -     -- ---  - -  --
-- -           - - -     -   ---      - -   -- -        --       - --  -         ---  -- --   -    -
-  - -       --   -- -   - -   -      -   -- -  --    -      --- -  --- --    -  --         -   -  -
-    -        - -  -- -    - -        -         -  -  - -   -    -     - -   - -      - --  -- -  --
-- -   -    --  -  --- - -  - -        -  - - --  --      -    ---  -  - -    -      - -  -   ---- -
--   - -        -    ---    -- - - - -        -            -  -  - -           --       --  -- -  --
- -          -   -  - - ---   ---    - - ---   - - -    -     -   -  ------ - ---  - -   --        -
-   -    -   -   --   -     --- -          -   -  -      --  -  -  -      - - -   -           -  - -
-    -    --  -    -    -  -      -  --- -- -  ----   - -      -  --    - -  ---  - -  ----  -     -
-      - -  -     - -        -  -       - --       - - - -            --  -               -        -
--    -           -   - -       -   - -  -  ---  -   -  -    ---  -- --        -    -  -   --- -  --
-- -  -           -       -   -      --   -- -              - -  -- -             -    -       --  -
-   -   -  --- - --  - -    -    -- - - --     -     -------  -- - -      -  -  -- ---  ---    -  --
- - - -  --   -  -- --    - - --  - -       --        -        --    ----   ---       - - -   - -  -
-             --                   --    -    --  - -     -      -    -       - -      -   --  -   -
----------------------------------------------------------------------------------------------------
