100
100
----------------------------------------------------------------------------------------------------
-    -  --- - -       --    --     - -  -   --    -   -   -    -   - -         -    - -   --     - -
-   - --  -    - -   -  - -- -    -  ---  - -   --   -     - -    -  -      -  - -    -     -   -- -
-- -    -   -     -  -- -  - ---   --           - - -  ---    - -    -    -  --   -  - --   - -    -
-    -        -     -- -     - -       -    -  -- - - -  -     - -     -   -     -    - -    --- - -
- -    -  ---     -- - -    - - -  -      -     --           -     -----  -   ---   -  -  --   - - -
- -    - -     -    -   -  -  -     - -   -  -    -   -    --   --      -   --       --  -   --    -
- - --  ---     - --  -    --    -       -  -- - -  -       - --          -    - -   -     -       -
-      -  - -  -   -  -   -   --- -        -     -    -  - -  -    -   - -   --    - -   --- --   --
- - - -    -     -       -    -  --     - -  - --     - -     --- - ---      - -   -   -      -    -
-- - -   --   -   -- -     -   -----             -  -    - -   -    -   -- --  - - -  -   - -- -   -
-- -   -- - ---  -- -     - -  -  - -    - - - --   --  --        - --   -     -    --      - --  --
- - - - - - -- -- - - -  - -    -       - -     -- - --- - -        ---   - - -  - - -- - - ---  - -
-- --      -     -  - - - - -    -  -    ---   -- -- --      --   -       - -  -   - --          - -
-  -  -   -  -  -   -       -   -      -    - - -     -        - -    - -  - -  --  -  -    --- -  -
- --- -  -       -   -   -  ---     --   -  - - -         ---     --   -  - -       ---  -    - -- -
-- - -     --  -    -      -    -   --     -  --      - - --     -        -   --        -- - -     -
-         -      - -  -  --    --  -      -    -    - -  -     -  - - ----    -   -        - -- -- -
-  - -      -        -    --  - - -  -  -   -  -  --      -            -  - - - -      -- -  -   - -
--    -   - -      --    - - -  - -     -    - --   -   -     - -    -  -    - --- - --    - -   - -
-  - - --      -  --   --- --- -  -- -  -- -          -             -  - - -      -  -  ---     -- -
- -       -   -        -  -      --   -     - ---- -- - - -     -   ----  -  - -- - -  - --   - -  -
--  -   - - -      -  - -  - -  ---   ---   - -   --- - -    - - - -- - --   - -  - - --- -  -- - --
-         -  - --        - --- - -    - - - --  --     -     -   --   - - - -  -       --   -  - - -
- - - -      -    -- ---    -- -- - -- -      - -  - --  --   ---       -    -- - - --   --   -  - -
--  -   -       -  -  -  -   -   --- - -  -  -  -  --  --  - -   -   - -            - -   -    --- -
- -  ---  -     -           - -  -  -    -         -      --- - - ----- -   ----     - - -- - - - --
-     -  -    - -- -- - -  --   - - --   - - --  - -  - -   - -       - - -     -- -   - - -   -  --
--      -  - -- - - --       - --         --        -    -  -  -       -  - -  - -      -         --
-- - -       -         - -    - -      --       -     -     - -  -   -  - ---    ---    --   - --  -
-    - --  -           -  ---  - ---           -     -   -  -- ----   -  -   ---      -    - -- -- -
-- - --   -    -         - - - -     - --         -   - ----- -- --  ---           -    - -    -   -
-  - - --      -  --  -       -    -     -- --  -  - - -  -  --   -      -- -- --     -  -- --     -
- -   - -            -  -  ---        -   -             - -       ---  -   -      --  -   --  -- ---
-   - ---   -   --            - -- -        -   -- - -   -  -    - -        - -  --      --     -- -
-  - -  -          - -  - -  -        -   ---- -   -   --- --  -    -  --   --- - -            -   -
- -          ---   -    -- -  -     -  --       -- -- --  -  --  -       --   --    -   -  -  - -- -
-   -   -      -   -    -   --- ---  -  -                --    --    - -  -  - -  - - -   ---  - - -
-     -  -  - ---    - -        - -   ---     --    - - -  ---   -- -        - -    - - - -- -     -
-  -         -- -    -    -   -  -      --- - - - ---    --   --     -    -     - - - --     - --- -
-  -  -- -  -    --   - -       - --          -   -      -             -   - - --  -    - - - -    -
-   -   -    -   -  -       -     - -     - --  -   - --    -    -- - -  -- -         --   -  -- - -
-  -- --    - - - - -  -   -    -    ---  -     -       -     -- -   -     -    -- - -       --    -
--     - -  --  - -  -   -   --- - -    -   - ---  - -       -   --     -- --  -   --  --   - --  --
--  - -   -    -   -  -   - -     -- --  -  -      -   - -   -   -    -   -  - - --  - - - - -  -- -
- --  -          -       - - --  -   -     -    -      -   -      --    -  -  -   -     -        - -
-        - - --  -  -  -  -     -  -    --  - -     - - -    - -     - --   -  --    - -   ----- - -
--      --       -    - - --- --      -  - - - ----  -        - -  -  - -  - -  - --  -    -   -   -
-    -  -  - --  -        -         -   -   -- -       -       - - - -- -     - -   -    -    ---  -
- --  - -          - -       - - - -    -   -    - - - -  -- - -      -  - - -- -  - -  -   - - -  -
-     - --  --          -               - -   - -        - - --  -   -  -   -- - ----    --     -- -
-  - -  -   - - - --   -  --  - - -  -- -  -    - -  - - - -   -   -   - - --  -            -   - --
--   -  -  - -- -  -   ---   -    --  -      --    -   - - --   --  --   --    -       --    -  -  -
- --- -    - -    --   -        --            -- ----      - -      - - -  ----  - --    -    -    -
- -  --   ---  -  --    - -   --  ---  - -   -  -      -  --- -  -  - -          - - --- -  --- -  -
- -                     - -     -  -  ---  - -    -         - --   ---  -  - ----           --  - --
-      -    -  - --    -   --   -- -  -   --    --  - ---         -    - -   - --    --  ---       -
- - -   -    --      -      - - -       -   -    -- --    -      - -  - -      -   --- -    --  ----
- -     -        --  -- -  - - -     -      -     -   -  -  -     -  -   --  -    - - - --     --  -
--  -  -  - - -  -     -    -       -          --  -      --   - -        -  -- -         -    -   -
-    -   -     -      - ---  -   - -      - ---    ---- - - --   -    -  --    -  -   - --    -  ---
--   -     ---  ----  -        - -  - ---  -   ---         - - - -  - -      -       --   -        -
-    -         ---    -     -- - -          - -   - -   - - -  --  -      -    - -  -         -- - -
- --   -    --    -     -   -   -            -       -             -     -- --  - -     -      - - -
-       - -  - -              -   ----     --     -  --   - - -   -  -  -    - -       -  --   --  -
-- -         -  -      -  - - --        -  - -  -  - -  -- ----   -  --    -  -            -       -
--- -- -- --    -   - -     - - - ---  - --- --- --  -    --- -  --  - -          -  -       --    -
-   -  -   --- -    -     -  - -              -       -  -   --       -  ---         - --   -     --
- -   -  - ----  - - -    --       --  - -  -  -   --      - -    -- - -   --      --- --  - ---   -
-     - -       -   - -- -       - - -  --- -   -    -   -    - --    -  -                  - - -  -
-   -     - -     -   - -  -      -    -  - -- -  - -     -   -    - -         --    - - - -- - -  -
-- --   -   - --        -   -   -- - - -- - -   - - -   -   --   --  -     -     --  -   -     -   -
-  -  -  -    --    -   - -        -       --  -    - --  --    - -- --   - --    -- - - -   - -   -
- -  -- - - --   --  ---  -  - -  - -    -    - --  -   --   - -- -  -  -   -          -    -  -   -
-      --     --    -   -- -   -    -     -    -    -       -   -   -  - -  -   -  ----  -  -      -
- -   -   - --    -- -  -     -    -- -        - -       --  - --  -             - - -     - -    --
-        --           -            -        -        -                -   - - -  -        - -- -   -
- -  - -  - -   - -   -   -   - -  -   -   -- -  -        -  -  ---      -- -   -     -- -   - - - -
--- -   --   --- -    ----- -  - -- -     - -     --       ---        -       -     -            ---
-     - - --  -     -        - -       -  --   -   -  -   --    -      -     -  -    -             -
-    --    --    -   -    - -- -- -- -  - -  - - -  --     ---   ---- -  - - -          -   - - -  -
-- -      -  -- -   -        -      -   -   - -  -   -    -   -     -- -  ---   --  - -            -
-           -- -        --- -          -- - - -       - -   -   -   -      - ----  ---     -      --
-  -   -      - -    --- --           -     -    - --      - -      --   --   --- -    - -   - -   -
-   -    ---    - --    -       - -- --  --    -- --       -   -----  --  --         -    - -   -  -
-   - -  - -  -      -  - -  -         -         -  - --- ---        --      -        - -  ----  - -
- - --  - ----    --   - -       - -   - --  -     -  -   --  -     -     --   --- -- -          - -
--   -  --       - -  -   - - -     -  -    -- - -- -- -       -     -      -             --    - --
- - - --        -        - -   - -    -- -   --  -     -- -  -  ---     - -     - - - - -  ------  -
-    -     -   -     -           - -  - -    - -     --  -    -  -   -   - - - - -  ---    -    - --
-  - -  -- -                    --  ---  -  --  -    -- -   ---- - -                      -        -
- -- - -  -    -  -  -    -        -  -  - -    -  --  - --     -- -  ---   ---     -- --        ---
- - - -   -  -   -  -  -   -  -   -    -  - -- -   - -       - --    -  -          - -     -   -   -
-   -   - -       ------ --   - -      -    -   --   - --            -  - -- -  - - -          -  --
- - --  - -- -  -  -      - - -     -       -- - - --    -         -      -   -      -   ---  -  - -
--  -    -  -  -  -  - - - --   -  ---     -   -  -    - -   - --   - - -   -    -   - -  - -  -  --
- --     -         - -   - -     -     -    - -        -     --  -  - --  -      - --              -
--- - - -    -      - -             - -  -      -- -  -  -   - --  ---         -      - - -        -
-   -   -       -   - - -      - -      -     -   -          -  -  --- -   ---   -         -       -
----------------------------------------------------------------------------------------------------
