100
100
----------------------------------------------------------------------------------------------------
-        -   -      --   -   - -    ---- -   -   - - -         -              - -    --       -    -
- -    -       -  -    - - -     ---       -- ---  -                -      -   -- -    --          -
- -        -        -   --  -     - -      -- -- - - -  -  --   --   -               -----    ------
-   -    -   -    ----   --          -  -    - -     -   -  -     -          -   ---         -  -  -
--  - -       -- -    -     - --  -  - ----  - --    -  - - - - - - ---  -  -       - -- -   --  - -
- --      -    - -  - -       -               -         -- -           - -   --- - -- -  -         -
-   - - -      ---  --  --  -- ---   -   - - -    ---- -    --  - - -     -  --   --     -   --  - -
-  ---    -- -    -  -         - - -  - -     -- -    -       -  --  -   ---      -  -- --    - -- -
-        - --    -    - -  - -   -   -   -    -   --   -      -            - -  --     --- -  -    -
-  -      ---       - -- --       - - -     --    --      -      -- ---- --  -     -  -    - -  -- -
-  -   -  -  --   -   -  -     -   ---   --      -   -  -     --   -    -  -   -    - -  --   -- - -
-          -       --    --- -     -   -          -   -    - - - -- -   ----  -       -- -  -   - --
-    - - -   -      - -- --  ---      -    - -  - -      ---         -      -- -  -  -       -     -
-  -    -  -- -  -    --        -        - --     - - -     -     ---- -  -   --    --  -   --   - -
-  --  - --- -  --      - -    -     ---  -  - -  -      -       -  ---   -  - -  -    - --  - - - -
-    --            - --    -       -  - - - -- -   -   -          -      - -     ---  ---  -  -    -
-    - --------- -  -        --- -            -   -   -   -- -  -   ---      - --   ---  -   -  -  -
-   - - -  -    --       -        - -  -      --  --    -    -   -               ---       - - -  --
-  -  -   - -  -   -  - -      - -  --       -         ----     --    --  - - -  - -      ---  - - -
-  -  - ---  -    --  - -     - -    --       -  --- -    - -         - - -       -   - -   --     -
-    - --   - -- - -- --   -   ---    - -    --   -   -  -  --  - -  --   -   -- -- -     --   --  -
--   -    - -    --  -    - --   --  -- -   -  -   - -   - -     - ---  -  --  --  - -  - ---      -
--   - -  --   --  -  -   - -  -- -   --      - - -- - -  -  - -       -    -         -    - - -   -
-      --  - - -    - - -    -    ---  --          -       -   -        --   - - --   --         ---
- -  -    - - - -        ---   - -   -     - -  --   --            --  - - - - -    - --- - -   -  -
-    --   -   ----   ---- --    -    - -  - - -     -   -      -  -  --   -      - - -  - --- --   -
-    -      - -- -      -     -    --        - -      -     -   -  -      - - ---      --   - - -- -
--      ---  -         --     - -   -        - --   -     - - - --   ----  ----  -  --- -  -  -    -
- -- -     -     --     -               ---  - -  - --  -  -  -      -   -       -     -  -     - --
- -  - -             - -        - - - --      -- --       -      -       --     -  - --- -  --  - --
-   -    -----  -   -     -  --   -  --  -  -    -   - - - -  -   --           -   -   -  -  -     -
-                   -  --  -    -            -     -  - -     -       -  -   -   -  --  -  -  -   --
-           -- --- - -  -----       - --   --   -               -    -          -        ---   --  -
-   --       -  -   -   - -  -   --      --      -  - -  - -  --      ---  - --   -  --      - --  -
-     --  - - --    ---       -     --  --    -  - ---- -  -   -  -    -   -    - -  --    --  -- --
-    -  -     -        -  -       -             -    -    -    -- -  -  -  - - -- - -  - - -     - -
-----  - -      -    --  --  --  -  -    -    -    -  - -     -- -  --     - --  -   - - - - -   ---
- -   --   -   -- -     ---           - ----      -    -           --- - --     --  -  -  -     -- -
--   -              -    ---- -- ----  -     -       -  - - -  -    -  -     -      - - -      -  --
--   -- - -  -        -     - -   -      -- -------   -     ---       -  --            --  -   --  -
-   -  - --  - ---  -    --     -          -    -        -- -  -  -- --  --- --  - ---      --  -- -
-    --   -  -    ---  - - - - -    -   ---  - -   -    -- -  - - --  - -      -  - -   -  -      --
--     -    - -     -   -  - --  -- -   -  -- -  -- -  -         -     - - -    -   ---         -  -
- -  -    -     - - --- -   -  --   -        -         - - - -    -   -  -   -    -  -   -    -- - -
-- -          -  -       - ---  --    -      -      -   --  ----     --    -   - -   - -     - -  --
- - -        - ------  -      -   --- --   -   -  -   --   -   - --    -   - -   -  -   -       -  -
- - -   -    -         --   -   -    -     - -  -- -    -    ---   - -- -  -- --      -  -      - --
-    -     -         -   -     -  -  --    - -   -  - -     -    --  --      --  -       - --     --
-    - --    -  -    -  ---  - -  -     - - - --   -- --   - - -- -      - - - -  --   -      -    -
--   - -    -    -        -   -- -- -- -  -- - - -   --     -     -  -  -       - -- -   -  --  -  -
-  -   - -  - --        - --     --   - -  -    -           ---- -     -     --    --  -- -  -- -- -
-  -     -   -    -  - -- -  -- -   --     -       - --          --- -      - --              -   --
- -    --  -  -- - -    - - - -- -  -  --        -      - - -   -   -  -    - --  -   -   -  - --- -
-       -              - -    -    - -     - ---    --            -- -   - -- -      - -     --    -
-   -   - -  -  - - - -   -  - -     -      -      -      - -   -     -  --  - -  --     -- -  --  -
-  --- --  - -   --  - -       - - --    - - - -  --   -  - --   ---  -    -     -     ---    -  - -
-     -   -- - --        -  -- - -    -                            - -  -   - -    ---    -   -  ---
-  - - -      -  --  --  ---    - - - -     -  - --  -   - -    -  - -- -    - --  -     - --      -
--   -   ----- - -  - --  - - -          -              -  --- - -    --      --    - - -- --  - - -
--     --          -- -- -- -  --     -  -        -  --   --   -       -  ---  --      -       -   -
-        ----    ------  -- -   -- --  ----   -  - --      -  - -     -    -    -   -- - -- --   ---
-- -   -              - --   --  -- - --   -   - -  - - -  - -  --    --  -   -   -  -    - - -    -
- -   -  ---- - -   --  -- --  -  --        - -  -      -    -  - -        -- -  --  -    -   -  - -
- -  -     -                -     -     - -- - -  --       -    --   --   - -    - -   -    -     --
- --  --     - - -    - -          - --       -  -  -    - - -  - -- -  -        -      - - -     --
-         --  - -- ---           -      -   -        -        -           --             --   --  --
---   -     -    -   -- --  --  - --    -      -        -         -    - --  - - -- -    -  -    - -
-   -- -  ---  - -- -          -     -   -      - -- -  -      - --   --  --- -   - - - - -     -  -
---  -    -   -- - --   - -   -- -   -      - - -   -  -  -  -  --   -     - --   - - - -- -  -   --
---  - - - -      -      -   -    - - - --    -  -  - --     -   - -- -   - -         -  -      - --
---  -    --- - -  ---     -  -----   ---  --     -     ----  -- -  - --  - ---   --         ----- -
--   - -     --   -  -                -  -  - -    -- --      -- - - -   -   --                   --
-        ---         -  -   - -   -        -  -- -  -   ---- -       -  -   --  - - -- --    - --  -
-  -  --       -  -       -    -  - - -            - -       -    -      - - - -      - -          -
-       -  -  - -      - -- - -   -- - -   - -   --     -       -   ----          ----            --
- -     --  -   -  -  - - -       - --  --     --    -        ----  -   - - -    -        -     -- -
- --     -  - -   - - - -      --- -  -   --    - --  ----      -  -    -- -       -   -    --    --
- -- -         ---  - -  - - - --- -    -  -   - --  - -   - - - -    -     -    -    -       - -  -
--  - --  -  -    - -  -  -  --  - -  -    -    - - -     --   -      -  ---    - - - - -- -      --
-    - -      - - -  - ------    -  -  - -  -   - -          - --       --  --- - - -     - --     -
-- --  -       -   -    -   -  --         --   -  - - - - - --          -  - -  -    -  -  -       -
-       -   - -  -    -      -- - --- -  -   - --- -   -    -    -  -      -  - --  -  --      -   -
---    -    - -  - - - - - --   --  -   -     -   -  - --         -----        -          -  -  -  -
-- -      - -     -    - --  -       -   -  -   -  -----     -    -   -         - - - -    --  --  -
- -----         -    - - -  -- -     - -    -    -  --  --   -    -- -  -   - -   - -   -     - -  -
--     ---   - - -  -  -  -  --       --  --  --     -   --    - -   - -       --     -     -   - --
- --     -       -- -   -  --  -- -- - --    - -     -         -  --   -     - -  -     -   -   -- -
- --   - -           --     -- - - - -    - -          -  -  - -   -- - -  -   --  - - - - --    - -
-            --   ---   -     -          -    -      -- --        -   -  -   --   -       --    - --
-    - -             -    --   - - - --  -  --  -  - - -  - ---    --    --  ---  --  -    - -     -
-           -      -   -- - -  -     -  - -  -     - -- -      - -- -  - -       --   -   - -  - - -
-  -  - -- -          -- - -  - ---- -  -    --  --   -- -- - -  -    - -    --  -  --  - --   -- --
- -  -  -  - -    -         -  -      -  -- - -  - -  --  - -      -  - -    ---   -        --  -  -
--       -     - - -- - - -   - - -  -  - --   - -        - -     -       -   -     ----  -        -
-   --   --   - -    -          -- -    -     -  - -     -  --  - -  ---   ---   -       - - - - - -
-- -         -  --  -    - -     -    - -   - --  - -- --             -  -   -      -            - -
-- - -   - - - --   - - --   -   --   -   ---- -   - -- --   -  --     -        -    -       - - - -
-  --  -    -    - -         - -            - - -   - --            -- -                         - -
----------------------------------------------------------------------------------------------------
