100
100
----------------------------------------------------------------------------------------------------
- -      - -       -    -          --------  -    -   - -    -          -    -            --   -   -
- -- -  - ---  -  -  ---       - -  ------   --    -  --  ------   - -  -  --       -   - -  --  - -
- -  -- -  -                     -  -------  --  - -  -        - - -- -- -   -       -    ---- --  -
-       - - - - -    - -       - -    -     - --    - -      - -  -  -      -- --   - -  -         -
- ---  -  -  -    -  -  - -- - -    -       -    - -       -    -    -  -      - -   ---    - - -- -
--  -   -          - --     --   - -   -- -  --   --     -     -  --  - ----   -   -       -    -  -
-  --    --      -  -    ---  --   -   -    -- -       -  - - - -- - -  - -   - -    - -    -    ---
--       -   - - - - ----  --   --   -   -   - -- -   ---  ---       - -   - -- -     -       -  ---
- ---          ----- --    -     - - ---    -       -   - - -  -  --   -   -   -- --   - -  -  -  --
-- --             -    --     ----     -  -   --  -  - -   -- - - -- - ---- -                 -  ---
--    ---      -  - -             - - - - - --   ---   - --    -     -- -  --     -  -  - - --    --
-   ---     - -  - -  -  -  - -    - - --  -  -      -     - -   -  -    -       -    -    -- - -  -
--   -   - - -    --   -       -        -  -  --   - - -   -     - - - -       -     --- -         -
-- - -----    - -  - -  --- - - -     -      -  -     - - - ----    -    -     --   --  - -  -- -- -
-   -     ---     -   -  - -    - - -   - - -   -     -    -     -- -      -    -    -     - -  -  -
-- -- -  - - -- - - --  -  -           -   - - -   - - -  --   -   -    -     -   ---- -   -      --
- -  --- ---  -       - -  -    -  -             - --  ---      ----  --   -  - --       -      -- -
-             -- -  - -      -- -   -  - - -  -       -     -   -         -  -    ---   -         --
- -  ---  --  - --     --   -  - -  -                  -  -  - -- -    -- --  - - -- -      -      -
-    ---   -- -  -      - -     -  -  -  --        -- --   - -   -   -      --    -  - -  -      - -
--    - -    --         -      -    - -    --- ---   -  --    ---     ------ -        - -- -   -   -
-- -   - -          ----        - - -- - -     -    ---- - ---  --    -    -     -    --      -  ---
--   -- -     -           - -  -    - --  -  -    - -   - -  - -- - -- -    -   -         --  --   -
-    -         -- ---   - -- -  - - - -   - ---  -     -        -     - -   - -  -  -   - -  -   ---
-   - -  -  -  -  -- - - -    --  -     -  -  --    --  - -- - -  --    - --    -  -       ---- -  -
- -  -           - -    -  -   --  -         -    -      -   -  --  -  -    -   --  - -  - -      --
--        -  --  -  --  - - -    -   -    - --   - -   - -       -  - - ----  -          -   - -  --
- -- --          -  -     -   - - -     -  -  -   -       ---  -- -  - -          -     -    -  - --
-  --   -- - --- -        -  - -   - --    --    --    --   -         - - ---   --  --   --  -- -  -
- -  -   -  -   - -           --    -  -      ---    --    -   - -     ---   -         -     -  -  -
-  --    -     --           -  -   -              -- -  --  -  -  --      --    - ---  ---- - -    -
-         --   -   --  - - -- -  -  - - --  -  -     -   - --   - -    - --   --   -   -    - -    -
-  - ----  - --  -   --     -  -  - -      -    -- -             -   -  -  - -    -   -   --  -    -
-      - - -  --  -- -  --   - --    --     - -  -    ----   -   -   - - -  -- - - --- --- --   -  -
-  -        --     -- -   - - - ---      - --  -  -   -       --  -   -   --    -         -      - -
- - -       ------       -    -  - --  - --    -         - -        -    -- - -  -  -       --- -- -
-   ---- - -  -   -   -        -  -  -       --       -  -   - - -  - -     -     -        -    - --
- -                 -    --      -   - -- ----  - -            - - -  ---  -   --   -  --   -      -
-  -  --     ----    --  -  -     - - - --        -   -  -    -- - --    -    - -  - -    --    -- -
-       -           -  - - -   -  -      --        -   - - -     - -   -  -  -           -    ---  -
- -    -- - - -  -    -     --   --       -    - -     - - -  -      -  -  -   -   - --     -  - - -
-   --        -  --- -   --   --      ---             - -  - -    - - -- -  -- --  - -        - -  -
--     --   - --         -           -     -     -- - -   -         ---   - - -- --       - -- -   -
- - ---- - --   - -- -    -   -   - - -     --     -  - - -    -         --- -  - -  - -           -
-- -       -            -           -      -  -  --  -    - ---  -- - - -   ---  - -          - - --
-    -   --  - --- --          -  -   - -   -  -        -      - -     --- --  -     - - - --      -
- -    -- --     -  -      -  -   - -   -  -     -   ---  -     - --   --  -  --   ---     -    -  -
- -  ---      - -- - --  --    -   -      --   -  - - -     -   --  --      -  - -  -   -    - --  -
-  --            --    - - -        - -     --  -  -           -  - -  -   - -   -   - - -   - --  -
--    -  - - -  -         -     - - -       -   -   -   -  - -   -   -              ---         - --
-           -  -  -- -    -  --   -           -  -- -   -   -     -  -          ---   ---       -  -
-  - ---   -  -     -  -         -  - -- --- -  -     -    -          -  -   -- -  -      -        -
---  - -   -  - -      -- -  - -      --   - -   --  --            --     -  -  -- -  -    - - --- -
-  -    --          -      -  -    --   --       - -   --   --- -    -   -       -  -       --     -
-   -   --    -   -  --  - - -    --  - -   -  - --    -     - ---     -  --- - - -  -  ---- - -- --
-   - --      --    -  -  -   -  -   --             -   --    -     --    -   -    -  -  -    - - --
- --- - --  -    - -  -         -    ----     - -   - - -    --      - - -        --    -  -  - - --
- -    - -    -- - -        -   -  -     --    - -     -- ---       -    -   - --   -      - -    --
--              - -    - - - -- --    --   -- -      -   -    - -  --  -     -    -      - --- -  --
- --- -   -         -   - -   -    -   ---- -   -               --   -     -    -- -       -   -  --
-    -    -      - -  -  -   --    -   -      - --  - -  --  -   -- - -      -  -  --  -    ---  - -
- -----     -  --               - --  - --  -   - -   -- -   --  -- --   - - -     --   - --  - -- -
- -     -   -     -  -     -   - -  - - -   -    - - -- -   -      ---- - --  -  -  - -  --- -   - -
-  - --  -  -       -    - -       -    -   -          -        - -  - - -   - -   -            -  -
- --   -  -       - -        -   -   -   -   -     - --          - - -- - - -             -      ---
---- --- -    - -     -   - -  --- - -   -                   --- --   -  -         -    --         -
-    -     ---  - -  -   ---  -  - - -     - -   --    -   -   -   - - -      -   -    -    -- - ---
--  -           - - -  - -       - - - -  -     -   -    - - -- -  -    -       ---         -      -
-  -  -----  -   -  -  -             - - - --         -  -  -   - -            - -   --  ---     - -
-  - -    - --    --     - -                 -   -  -- --- - --   - - - -    - -   -- -  ---       -
-       -     -  --   -    - -  -  -       -- - -          - -      --    -- -  -- --    -      -  -
-  -     - -     ---   -  -   - -    - -      --- --        - - -   --   -         -    - -- - -----
- -   -  -- -  -  -   -       -   - --  -     --   -     -             - - - --- - -  - --  -- -----
-   -    -            -- - - - -    - -   -        -    -   -     -  --   -   - ---   -   - - - ----
-  -   --        - - -  -   - - - - -    -   --  --    -           -     - -  --  - ----   - - -----
- -- -   -  -- -       -- -   - - --  ----- -       - -  --  -    ---  -  -     --   - - - -- -    -
- - -      -   -- - -     -  --        -        -  -  -    -     -   -- --   -    -   -     -  - - -
-  -- -  -             --     -    -    -        -- --  -     - -   - -  --    -   -   -   -       -
-       --    --- -    - --   --- -   - -- --   --- - -     -       -- --    --  -    -      - --  -
--  - --        --    -- - ---   --  - --           -   -  - - - -       -   -   - --   --  -  -   -
- - -    --  --       - --- -  --  -      -  -  --    --    - -    -  --- - -   - ------  -        -
-    -  - -    -- -   - -  -      -  -      -    -         -    - -          -           ---  -    -
-   -            -   --         -   -    -- -    - -    -        - -- -- --- ---- -- -             -
-        - -- -- -        -    -         -   -  -   --  -     - --    -- --          --         -  -
---   -    -  --    -    -   - -  -   -        -  - -  -        -   -      - - -    -   -          -
-  - -  ---- - - -   - -    -  -   -  -    - -        --  -       -        -  -   -  -- -          -
- -  -      -       -     - -       -- --- -       - -  -   -    --  -  - - -      ---   -       - -
-   -   - -    -      --     -   -           -  - - -- -   -  - --    - -      -- --    -   - -- - -
-  - -   --- - -            -  -  -  - -- --  -         -    --   -  -         - --  --    ---  -  -
- - -  - -  -    - ---  -    -    - - ---  - -        - --  -        --- - -        -   - - - - -- -
-   -   - -   -- -   --  - -  -    --   - ---  -- -        - - -   --  - -  - -            - -     -
-      -   -      - - - --   -   - -  ---     - - - -      -  -   -  --      ---   -  - -   -   -  -
- -   -      - -  - -   -  -    -   -   -   -  - -  -           --  -  -- ----  -- - -  - --    -  -
- -- - -    -     -  - --    --    --     -   -- --      -  -   -    - --     -    -     -     -   -
-      - -     --  - -    --   --- - -      --    - ---   -   --  --   -   ----- -  -     --  -    -
-   -  --     -- --      - -    -- - --  -      - -   - -      - --   -  -   -  -  - -  -  -     - -
-   - - - - -    - ---- -  ----     -   -    -     - - - -          -- --- -       --  -    ---  - -
-   -  -  -- - -- -   -   - -  -- - -    - --    -    -   -   -       -     -    - - -  -  -       -
----------------------------------------------------------------------------------------------------
