100
100
----------------------------------------------------------------------------------------------------
- -   --  --                -                        --       -   -   -           -    -  -        -
- ---   --- ---    -  -    - --  -    -     -         -    - -            -  - --  -   ---   -     -
- -  ---  - -- -          -  -        - -     -     -- -  -    -  -  -    -  -    -  -     -   - - -
-- -   -- -     - -  ---  -   --       -   - --  - -  -  --  --    -  - -    -        -  -  -   -- -
-   -  --   -   -    -    --   -  -  -         -  - -      -   -  -  -       -- -   -  - -    -  - -
---  -    -  - -- -   -            --  --    --    - - --  -              -    -       -   - - -  --
-- --- -   -        -   -  ----- ---       - -  --  --      - -       -        - - -  --  -     -  -
- -   -         -   - -  - - -  -        -  - -   -       -  -   -  -   -    --             -   -  -
-  ---      --     - -       -  ---  - -   --      --         -     -  --       -    -     - - - - -
--   -     -    -   -       -    -  -    -- -    -  - - --  --    ---    -       - -   - -   -  -  -
-- -       - -    -    ----  -  -  ----   -  - ----    - -- -- -        -- -  -  - - - -       -----
-          -           -      -  - -   --     -   - --  -        -- - -     - - - --  -   - -      -
-- -   - -    --  -   -   ---    -  -      - -- ---   --   - -- -      - - - --- - - -      -  --  -
- -   -- - -   -        -    --    -   ----          - -      - --   --- -        -    -           -
- - - -   -      -- -  ----      -    -         - - -    - -      -  - - -- -     -   -   --  -    -
-- -   -    - - - --      -    -- -   -   -    - -     -- -    -   --  --       --  ------     --  -
-    -     -    --  -  --        -- --- - -- ---  -    - -   -- -    - ---- ---              -   - -
---    -     -  -  - -    -    -- -   -   -     -       -   -       - ---     ---     - -   -   - --
-  -     - -   -  - -    -- - - --   - -   - -  --  - -     -   -  --     - --    -   --     -- -  -
--  --  -        - --          -- --      -- -   ----   --  -  - - -   ---   -      -  - -----     -
-     --- --- --- --     -   -        - -  --    --   -      -   -    -   --  --        -    -   - -
- - --- - - -    -    -     - -  -  -   --  -     - -    -   -  ---  -  -          -  -    --   -  -
-   -      -  -    --       --      --    --   --   - ---    -      -   -  - - -     --- -   -    --
-       -  - -  --   ---- --           - -        --       - -- - -    -    - - -       - -  -   - -
-          -----  - -      -- --   -    - -  - -- -  -- -    - -  -     - ----           -     -   -
-- - --     -         ----    -  -- --  -      -   -     -     -     -  -  -    -      -  -  - -   -
--  -   -   - -  -  -    - -   -- -             ----      - --   -    -- -  -  - - - - - ---  -    -
- -- -    -   - - -   -  -   -   -      -     ---     -   - -      -- - ---     --  -    -     --  -
- -  -  - -  -    -   - -   - - -             ---   - - - - ---  -              -   -- -       -   -
-   --  -    - --   -   - --    ---- -  --      - ---- - --    - - -  --    -        -  - -      - -
- -  - -          -  -  -  - -           - ---   -    -      -        --        -   - --     --    -
-- ---        - - - -   - -  -  --  --- --       - ---    - -  -    -    ---    -   --  -   -   -- -
-   -     -- ---     - -  -  -             - -- - -     -      -  -    -  - -     -    -    - -  - -
-  --  -  - -   --      -  - -  -   ---     - -  -  -        - --   -  -       --   -  ---   - --- -
- -   -- - --    -      - -  -      - -  - -    - --    - -   -    --    -    - - -  - -       -- --
-  -  -    -   --     ---  -          -      --      --- -      --  - -   - --      --  --  -   -  -
-   -      - -  - - -    - -  -- - - -- -    -     - - - ----  - --       - -    - -          -    -
-     -  --   -     -   - --      -    -  -  - --          - --    - -       --  -  -    -        --
-   --   -        --     -      -  -   -- -   -         - -    --   -     -- -  -     --     ---  --
- -      -    -- - -       - - --  ----    -   --   - --     --   -   -   ---  ---- -  -  -  -     -
-- ----  - -  - - - --  -  - -   --  -       -- - -      --    ---  --- -  -  - -   --    -  --  - -
-  -     --       -  --     -  --       -  - - -- --    --     -   -  - -- -  - ---   -  -        --
- -     -    - -    -  -   -  -    -   -     - - --     - -  -       --  --   - -   -  - - ----    -
---   - -   --     -- -  -      - --     -   -       -         -   -   - -  ---- --     -    -  -  -
-      --    ---  ---  -  - --  - -          -- -            -  -          -   - -- - -    -       -
---  -- - -  -        - -    -       -  --  --  -  - -  --    -      --    -        -  -   --   -- -
-   --     -       -        -   -- -- -     --         -  -   -   -  -  - - --     -   - -   -   ---
-        -           --    -- -  --   -   -  -  -    -- -  -   -  -     ---    ---  -     -   -    -
--- - -  - -    - -   - - -    -        -   - -   -          ---   -     - --  - - -    -      - - -
-  -     - - -    -              -    -   -   --  - - --- -   -  - - - --   --      --   -   - -  --
--- - - -    -  --    -       -  --- -  -  -     -    - -    -  -   -  - -   -   -  -   -   - -    -
-  -     - -     --  -   --      - -     --    -- -    -    -   ---- -         -      --    -  - ---
---- - -  --   -- -          -          -          -  - -    - -   - -   - - -- ---      --  --    -
- -  - -  --   --        -  - ---   -  - --  -        --     -    -     -      --        ----     --
-  --         -  - -  --     -       -        --- - -   --   --- -  -   - ----    --         -     -
--- - -   --   -  -     - - -   -      - - -  - - -----  -    -   - -   -     -   -      -     -  --
- - - -    - - - --  ---  -   -   --- -  - - - -  -- -   - -   --  - --   - --   -     -   -  - -  -
- -  - -   - -   -  -    -- -  -  -  - - -   ---      - --    --          -   -  -     --     -  - -
-   ---  ---     -  -  -  --   --       - --    -     - - -  -  -- -   -     -     -            -  -
-  --   -    --    - -    - -- -  --   ---- -  -   ---  --  - - -   -- --       -  -    -  -     ---
- -- ---  -    -       --- - -  -   - - -  --  -  -      - -  ----   -  - -- -   -  - -  - - ---   -
- - --     --- - -     - - -       -      --- -   - -      ---        - --   - -- -   ----  - -  - -
-   - -     -       -      -  --    -- --       -  -   -   -  ----  --       -  -  -         -  -  -
--      - -- -  -    - -   -     -      --- --   -            -            --      --  ---         -
-    - -   -   - --   --- -   -  -   -- ---     - -   -  -- -   -      -  - - -       --   -   -  --
- -- - -       - -   --    - -    --           -- - -     - -   -    --  --  -  -  -   --    - --  -
- -  - -   -   --   -         ---    -- - -       -   -- --- --  ---       -      --  -     -      -
-   -       -     --  --          -     -- -  -     - -- - -  --  -  - - --     - - -    ---- -  - -
-        - -        -  - --   ---             ----  - -  - --    -  - -    - -  -     ---       -  -
-    -  -   -- - ---      -     - -- -  -   -  - - - -       -- -    - --         -  - -  --   -   -
-  -  -         - -  -        -   -   -      -    -   - - -- --     -    -  - -     -     - - -    -
-     - -  -       --    -   --  -  --   --    -      -  -     - --  - - - --  - ---    --         -
--  -    -    - -  -   - -    --- -   -     --      -      -     --  -   -    -    - -  -    ---   -
-   - - - - -     - -        -      -   -     -  - -   -       -   -   -      -       --   - - - - -
- -     -- --       -      -     -   -          - - -    -   -       --  -          -  -  - -  -   -
--      -     -     -        - -    --  - -    - - -     - --     --   -          - -     - - -    -
-  -     -    --    - --  -     - --  --  - -     -    -  -       -      -         --   - --  -    -
-    - - -  -  ---   -    -   --  - --       -   -    --  - --- -   - ---- -     --  --    - -  -- -
-- -    -     -    ---   - - -   -      - --    -- - -          -- - -          -  -            - --
- --     ---  -- -     -   -  - - -   - -- -     - -- - -   --  -    -    --   -- -  -      --     -
-   - ---    -  -  -  -  -  -- -  -        -  --   -  -   -    -         -     --   -  -  -   --  --
- ---    --  -- --  -   -    -  -  - - - -   -   -  -     - -  --         --- -   --      ---      -
---  -       -    --  -   - --- -  -  --   - ----    -   -         - - --   -      --    ----   -  -
-     --  -  -    -  -   ---   -  ---     -  -  - -   -      -  --- -  -  ---  -    - - --     -   -
-  - - --   -    - ---    - -  --     --      - -     -- -        -    --   -   --           -     -
- -- -      -          --  -  - -   -     -  -  --    -           --   -   - -   -   - - -   -  - --
- --      - - - - ---      - -    - - -  -       --- -  -    -- --  -    -- - -    -- ---- - - -- --
-  - -   -     -  -    --     -         ---  --- ---     -     - - -  -  --   - -    -     -   -  --
-    -   - -      -  - -   -- -  -  - -    -             -  -      - - -   -   -    -     -- - -   -
---   - -       --     -    -- -         - ---  -  --       -    -  -  -- ---   -  -   -           -
- -           -      -  -  --   - -    -       -        -- -  -- - -   -    - ----     -  --     - -
- - -- - - --- -      ---   - - -      - - -   -- -   -    -  --    - --  - - - - - -- --   -      -
-       -   -  -   --- - --      - -      - -    - -  -  -     -  - -     --  -     - -- --     - --
--      -     --    - - -   - --- -      --   - -        -   -     - -   - -  -- -  -     - --     -
-- -    -  --  -- -   - - - --        -   -  -     -   - -   - -        - -  ----- --- ---     -  --
-  - -  - - -  -- -  - -   -  -  - - -  -    -  --  -   -    -   - -  -  -     -- -        -   -   -
- -        - - - -   --  - -  -- --          -   -- -      - -  --      ----     --- - -     --    -
- - --     - - - -  - --         -  -  -  --          - -    -        -        -   -- --    -  -   -
----------------------------------------------------------------------------------------------------
