100
100
----------------------------------------------------------------------------------------------------
- - - ---    - --  - -  - -      -    - -    - - --- - -         -  -  - - --   - -              - -
- -   -  - -  -     -   - --- - -  -   -      --         -    ----    - --        - --      --     -
-- --- --   ---    - -    -      -  - -    -  - -  -   - -- ----    -      -   --  -- --   ---   ---
---        -        --    - --  -   -  - --  - ---    -  -     - --    -    - - - -     --  -   -  -
- -   -- -  - -   --  ---  -    ---- -   - -  -  -        - -        -  ----  -   -    -        - --
- -    -  -    -         -     -     -  -      --    - ----- - - - - -   -   - -     -   -  -  -   -
-    -     -        - - - -    -  -    - -  - ---       - - -       -     --    -  - - -   -    -- -
-   - -  - - -  -   - -    - -  --   - -- -   --  -   -    --                  - -- -      - -  - --
-    -       - -   ---- - - -     - -   -- - -                -    -    --     -    - -- -- -  -  --
-- - - -       --- -     - - -   -   --      -         --        --- -  - --      --               -
-  ------  - -      -- - -            - -   --  -   -    -  -     -    -      -    -- -   - -- -   -
-        -  - --- --    ---  - -- -  -            --- -- - -  -   -   - -- - -    - - ---      -  --
-   -- -- -  -     -    -   --   -  --    - - - -- - -  -         --- --  -   -      - -   - -   - -
- -      -   - - -       --    -            --  -  - -     - --    -    -  -        -  -   -  -    -
-  -       -     - ---      -  - --    ---   -   -  --        -      --   --    -     --    -   -  -
-  -   - -   -   --    - ---      --         --      - - --   -     -   -- - - - -        --       -
--     -     -  - - -      -  - -     - -      - -  -     -  - -   --         --   -       -- -   --
- --    --      - --  - - -   - -    - --   -- -   --      - -  -     --            - -- -   --    -
-    -     -     - - -  - -    -        - -- -   -- -     -    - -    - --   --   -  -     -   -   -
-   - - -     - --  -     -  - -- - --- -    -  -      -  --   - - -       -- - -- -  ---    -  -  -
-- -- -    -       -  -  -     --- -  - -   --    -----    -     -  -  --  - - -   -    - -  - --  -
-   -- -    -- -- -  - ---- -- --- -      -   -  --    - -     -     -  -   --    - -  -- -- -     -
---        -    - -  -      -        --   -   --  -  - -   - --   --    - -           -    --  -   -
-    -   -   -       -     -  ----  -  -    - -- -- -    -      -      --       - -   --   -    -  -
--     -  -  -  -  -  --   -   --         -   - - -       -    --  ---             -        - -- - -
-       -   -   -        -        -     - - --    -  -   - - -  - - - -  - -      -    - -   - -- --
-   -  ---  - - -   --  -      --    -  - --  - - -     - - -- ---     -- -  -  --                 -
- --  -   - -- - -  - -           - -      - - - -   -     -    -       -- - -    --    - -  -   - -
- -  - - -- -  - --        -        -  -     - ---- - - -          -    -  ----- -     ---    -    -
-- -   -  - --  -       - - -    -      --  --     -- -      --           -    - -- --   -  ------ -
- -     - -     ---   -  - --          -  -     -         - ---- -    --   ---  -  --  -      - -  -
-  -      -    -   - -        -   - -  - --   --     -   - ---       - - -   - -      -   -     -  -
-    -- -     - -         --    -      -    -          -   -  - ---   -         -  -   -    -     --
--     -- - - -     --- -     -    -- -  -  - --                  - -  --       - -   ---      - ---
-  - -- --        - - -  --- -- -  - -- - - - -   - ----    - -      -    -        -  -  ---  --   -
-   -   - -     ---   --  -       -   -    - - --- - -  ---     -   -  --- ---   - -    - - -  - ---
-    -- - - -  -       - --     -    - --      -     -      - -   - -    -    -       -  --  --    -
-   -   -- - - -- -   - - -- - -      -    - -   -  - - -    - --   - --  --  -    -      --       -
- - -        --- -   - -  -  -- -------         -  -  --   -  -  --      -      -         -   - - --
- - - -    --   -   -  - -  -    - -    -       -   -            -      -   -  ---- -   -   -  - - -
- --  - --  - - - -       -  - -   -   - -         -  - -    -    ----   -        - -      -   - - -
-- -- -   -       --  - --     -     -      ---      -- -  -    - - -     --   -   - - --   -  - - -
-       -   -  - -          ---   --  - -  -    -   -     - -  -    -   -- -     - -- -     -  --- -
- -- -    -  - -    --         -     - -    -       - ---     -  - ---    -     -   -  ----- -  - --
- -         --    -   -        --  -    - --  - -  -                 - -   --  --- -----    -  -   -
-  -- -  -    --  -      -    - --    -  -  -       -- -   - -    -   - ---  --     -        -    --
---   -   - -   -       - -      -- -   -  -   -- -  -   -  -               - -    - -     -     - -
-    -     - --   -  -           - --   -- -  -    -    -- --         -    -   -   -   - --  -  -  -
--      - --   - -  -   -  - -     - -   --   --  ---     -- -    - --- - --        -        -    --
- - -  --      - - --         ----- -  --- - -          -    ----       - - -    -    -  - -       -
---       - - ---   -- -  - --- -           - ---      -- --- -  - -- -      --- - -- - ---   -    -
-  - --- -                --  --   -   - -- -- -    -         --  -    - - --   -  -            -  -
--  -     -- -      -- - -  --  -         --  -  -  -      -  -   --   -- -   -  --  -----   -  -  -
--  -- -         -         --   - -  -     -       - --     -   -   -    --   --    - -  -   --  - -
-        -  - -- -   -   --      --- -   --  - --- -       -      -  -   -   -  - --   -  -    -   -
-    - ---   -     --  -   -- -       --        -   -- -   -  --- - -- - -     -       ---         -
-   -  - -     -    -       -     --    --- -   -      - - - -  -       -   --  -      - ---- --   -
--   -       - - - --  --      ---    ----  --   -      ---       -  -    --      --  -  -  -- --  -
-   -   -       -    -    ----   -   -           - -        -- -  - --- -  ---   - --- --        ---
--  -      -  - - --    -   - - ---   -     -    --    -  --   --  -           --  ----    -     - -
- --   -     - - -- -    - -      ---      --   --  --  -  ---   --    - -  -          ---- -      -
- -    -     -  -  - - -- - -- - - -      -    - - -    --    -----   -   -    -- -       - -   -- -
-   -    -        - -          --       -    -- -   - - -- - -   -   -   -   -  -  --  - -         -
--  -    - - -       -- -  --    -   ---   --    -    ---     --         -    --    - -    - -  -  -
-  - -- -   - - -  -   --    -- -        -   -     -- -   - -       ---  ---          - -  -     - -
-   - -     - -   -  -    -     --   -   -      ---  -      --   --  --  -   -      - -        -   -
--             ---        -      -     - --- ---- -- -  - --    -  -           - -  - - --  -  - - -
-   -         -    -   - -   - - -    -  -  - -   --   --  -   -     ----     -    - - ---   - -- --
--   -   -   - - -  -  -   -       --  -  -  - --  -- -  -      -   -   -        -  - -   -  ---  --
- -   -- - -  --  --   - -            - -      - -        --  - -   -  -  --  -    -- -   -      - -
- --  -    -       -     --   --   --        --    - --    -         -    -  -   -    -    -   -  --
-- - -   -  -----     -- -         -    - -    --     -       -     -        -      --   -- -    - -
-  --  - ---    -       -   - -         -   - - -     - --      -   --     -    -   - -      -  - --
-    -      - -   -  --        -  - - --  -   -   -  -  -   -   - --- - -  --  -    -     -     - --
-- ---    -  -      -  --   -     - --     -    - - -      - --      -- - -   - --   -       - --  -
-    -  -      -- --    -   -      -   - - -    - -   -   - -     --- --    -   -        - -  -  - -
- - --       - -    -  -   - - - --     -- ---- --  - -   - ----  -  -  -  -- -  - -    -      -   -
- -         - -       -  -   -  -  -  -- -      -       -        - - -   -  -   -   --             -
-      --   -         - --   --  -- -    -       -  -       -- --       -  -- -   -  -- --   - -   -
-  ---- -    -  --   - -   -  -   - - - -          -      --     --- ---      --    -  -  -        -
-- -   -    -- -  - -  - --     - -   --  - --    -   - -   -          --   - -   -   -  -  - -- - -
- - - - -    --       -- -  - - -   -- - -   -        -   --         -  -- -     -  -- -----  - -  -
-  --  - -   - -  --    - -     - -  --    -  -    - -   -  --   -  - - -   - - -   -- -- -  -  -  -
-  --      --       --      - -  -  -      -  - -  -      -    --- - --    -  - -  --- -   -      --
- -  -  -      --   -       -- - -   --  -     -   - --    - - - -          -    -           -     -
-  -           - -     -  - --  --  -       -       -    -- -  - -       - - --   --- - -  -  ---- -
- -      -   --- - - - -    -      - -- - -      -    - -      - -               --    -   -  -  - -
-  -----  -     --  -  --  ---  --  -    -  --- -     - -  -  --    -      - -  -   --     - ---   -
-  -  -     -  - --       - -  -   --  - -         -  --   -  -          - -       - -         -   -
--  --   - --  --    -  ---    -  -         --             - ---- ---   - -  -   -   -  -   --- -  -
-  -  - -         --       -         -   - - -   - --    -- - -   -   --     -     -  --- -   -   --
--          --    - --   - ---    -  -   -   -  -     - - - -           - -      -- --   - -- -    -
-   --     -  --- - --   --        -  -     -    - ---       -    --   -  --- --    -     -    - - -
-  - - -    -        -  -     -    ---  --   - - -      -  -    -- -   -   --  - -  - - --  - -- - -
-- -  -     -   ----        -         -      - --   -        --    -    --   - - -     -           -
- -   -      --  -    -     - ---       -        --- - - -   -     -   - -      -- --  - - -- - -  -
---    -   -- -   --   - -- -- - ----     -    -  - -   - - - -  ---     - - -  -    - --    - -   -
-  ---       -         -      - -        --     - -                   ---    - -    - -       -    -
----------------------------------------------------------------------------------------------------
