100
100
----------------------------------------------------------------------------------------------------
-   --   -   --  -   - -  -       -   -  -  --       --               --    - - -             -    -
- - ---   ---  -   -      -      -  -   --  - -  -  -   -    - - --  -  -   -   -  -  -   - --   - -
- -  --             - --     - --    - --  --   - - --    --        -     -      -      -     - -  -
-  ---  -  -- -   -      - -  - -- -  -    --  -        -   --      -  - -- - --       ----        -
- -  -- --    - -     ----   - -   -  -- - -  -  --  --  --    --     - -    -   - -       -       -
- -   --     -  -   -    --   - --               -    - -   -  --- - -   - -         --      -   - -
- -     -        -     - -  -      - - -    -      -                 -  -  - -- -  -      -   -  - -
- -  --     --       -- -  -  -- - - -  -  -  -    - --  -   --  --     --  --  --- -   -     -    -
-   -  -   - -- -- -    - - - - ----  --   - -     -- -  -             - -- --     ---- - - - -    -
--      -    - -- -   ---      - -  -          - --     -   -   -      - --     - - -  -        -- -
-  --  -   -     - -     -  --  - --   --        - -    -         - -- --   ------ --        -     -
- --   -  -   - -  -   --      - -- -    ----  -   -    -     -  -- -  -          -   ---   - -    -
- -   -   - -   -  -   -   ---     --  --   -   - --   -   -       -    - -- --  ---- -   --       -
-- --   -    --        -   -  --          -     - - -  -  -   -- -      --      -     -      --  - -
- - -    - --  -  -- -  --   -    -  --   -         - - -    -  -  - -- - -  -----  - - - --- - -  -
--  -  -      -      --            -  -      -  -- ---- -  --   -         -  -      - - -   -   - --
-        ---   -    -   -  - -       -  -- - --  --   --      -      -   - - - -    - - - --       -
-     -     -   --    - --- --  -  ---         --  -       - -       --- -    -    -     -  -     --
- -  - - --- -  -- -           -  --- - --        -   -      - -----    - -  --  -  -  -   -   -   -
--   -       --  - -  -   --         --  --  --   - -- - --- -      --  -- -    - -    - - - -   ---
-  - -   - -    --- --   -    - -- - - -   --   -    -  -     -          -- - - - -  -    - - --   -
-     ---          - -  - -- -     -       -  - - --    - -   -  -   --     -   - --- --       -  --
- -  --    - - -       - -              - -   --   - -   - --            -                  - -- - -
-- - -- -  - -    - - - -   -- - -         -    - -     - --      -- - -    -       ---  -  --   - -
-   -  -       --  - -     -        --      -- - -- - - -   - -           - --  - - -    -    ------
- -  --             -  -     - -         ---    -     -- --      -  ---  ---        -   -          -
- -          -  ---    - -      -   --- - - --- - -        --  -  -         --   -   -    -  -  ----
-      -  --       -   -- -- ---- -  -  -      --  - - -  -   -     --     -- - -   -  --     - -  -
--   -    - -    -           -  --            -- - --  -   -  --   -  -          -      --- -  - - -
--   - -  -        --  -  -          - - -  -           - -  --      -   -- -              -   -  --
-- -     -   - -        -  --   --    - -  -   -     -            -- - -    -   - -     --    - -  -
--  - --     -            --- -      -     -    -   --  - -  -         -  - - - -  --   --       - -
- -   - --    ----  --     -    -     -    -   -- -      --- -- -      - -  -- - -    -- --       --
-   -     ----   - -    -     - --  -   -    -        -- -        -  - -          - -   - - -   -- -
-  -  ---           --  -            - -  -- -  --        ---  ---  --- - - - ---  - - --  - --   --
-  - -    --      - -  - -- - -- --       -    -  -  --  -    -      -       -  - -     --  --     -
- ---    - --     -   -  - -  -  -- -- - -  --   - --  --    -  - -- - --  --        -    - -   ----
---    - -- -  --   -- --   -          - - -- -  --    -- -    ---     - -            ---   -      -
-   --     -  -      -   -          --- -      -  -  -  -  -    -    - -   --   -   ---     - ---- -
-   - -    --       - --   ------ -            -    --- -- -- -    -   -- -   -   ---  -    -  -  --
-   - -- --   -  -                       --- -   - -     --     ---   --   - -  --      ---        -
- - -       - -  - - -    --       -  -   -  - - -   - -   -    -  -- - ---   -        - -         -
--     ---     ----- -           -      - -  --- - - -- -  -  -  -   - --   -  --   -- -       -  --
-  - - -   - -     -      -        -  --    - -  -    -  --   -- -      - --            -          -
--    - - --    -   --  - -   - -  -      -  -  - --  -      -    -     - -   -      -        - -- -
-    -  - - -  -   - --     -   - --  --         -   - ---  -   --    -    - ----          -     - -
- -                 -   - - -- - -    - - --  -     -  -  ---  - -      -   -       -         - -  -
-  - - -  -         -           -  -- -   - -  -        -    ----  - --  -  -   --     -- -       --
- -     - -   ---           - -   -      -      -  - -  -         -    -  -   -- -    -    -   - - -
- -- -    ---    --  --      --       - --     --         -- -  - -   -     --     -      -        -
- -    --  -   --    - -    ---      -  -  - -      -  ---    -        -        -- -         -     -
-  -   -----   - --    - -          - -   -- -- -  - -    ---    - -  -     - - ---  - - - --      -
--   -     -   -     -   - -    -       ---        -      -     --  - -  -  -  -  -   -     - - - --
- - - ---  - - -- - - -   -          -     --  - -   -    --       -  --   -   --- ---    -  - --- -
-  -   -   -      -     - -- -  -       -     - -  -  -  - -   --  -      -   --  -      --   -    -
-   - -         - - -       -  -  --    --  -   --     ---  - - - ----- -  -    -- -  - - -  --  - -
- - -  -  -         --        - - -- -       -   - -- -  --        -     -     - -       -- -  -   -
- -       - -     -   - --       --        -- --     - -- -  -- -    - - -   -   - --       --     -
-           - -    -    -    -  -   - -  --         -- -  --      --    - -- -    -   - -    - -- --
-    --    -  -    -  --- -              -  -     -     -       -  - - -  -   -  -  - -    ----    -
-    -   -  -    -  -   --      -     -- -        -       ---  --   --     ----  --       - --  ----
-- - - -- - -     - ----  - -  -- - -   -   --    - - -- - -     -  --    --       - -    -        -
-  -         - - -    - -         --- --   -   -  - -  - - ---  -    --    -    -     - -     --   -
-      - - - -                     -  -  -      -   - - -- -  -        -        -  -  --  ---      -
-    --  - -- -     ---          - -   - --     - -  --- -  -    -- ---- -   -  -  -      -        -
-    --   - --     -   --    -  --   - -   - - -    -    --- ---      -      - -    -----  -  -   --
- -  -  -   -   - - --  -  -  -   -   -   -       -     --  --    - -  -    -   -  -  -  - - -  -- -
-     --  -    -  -  -  -   -   -   -   -  -   --- - - -     -- ----  - - ----      - - -  -  -    -
- -  -   - -  -     -- -   - --   -       -  -      - - -    -   ---  -      --   --    - -  -     -
- --        -- - --   -    -    - -  -   -   - -      -    -   --  -  - ----  -   ---  --  -  --   -
- -   --  -   -- - - -  -- -- -   -    -  --     ---     --  -      -   -  -  -         -   -- - - -
-  -    -  - --    --     - -   -      -   -  -   -    --   - -   --  -      -     -   - -  -    - -
- -       -    -   -- - - -   -   -   -    --       - -     -  -         - -  --- -- --- ---     - -
-   - --- -   - --           -    - -  - - ---  -   -  - - - ---  ---     -          --       --  --
--- --  -        - --       --   - -  -  --   -- ----  --   --    -  - - - -  -  -          --   - -
--   --  -        - --  -  -   -        -   ---   -    - -   - -       -     --          -    --   -
-   -  --    - -   --  -      - -  -- --      -  - -      - -   --  -   -       - - --  -- - - - ---
- -     - -   --  - - -      -         -    -       -  -   -  - -   - -    ---   -   -          -  -
-   -- -    - - -     -   -     ----  -     - --    - -      --  ---       -     -   -   -    - - --
-  -  -    --    - -    - -  - -                    --    - -  -   - -  -- ---          - --   -  --
-  - -      --       -      -      -   -  --    -     - -         -   -  - -   -  - - -      - --  -
-     -- - -     -   --      -- - -- --    -     --- ---  -  -  - ---        -         -     -   - -
- -  - -  -- --  - --   - -  --    -     -   - -  -       -   -  --       ---  - -  ---  - -     - -
-  -    -    -  - -- - -  -  - ---        -    -   --      -  --       - -   - --        - -  - -  -
-- -       - ---    -     - --   -     -- ---    -   - -        - -   -   -      - - - -    --  -  -
- -   -  ---          --- -   --   - --    - -  - ---         -         ---   --      - -    - -   -
-- - -  - -   --    -   -        -     -      - -   -    -- -  -   -   - -  --   -     -  - -    ---
-  -   -   - - -     -      ---    -     -- -  - - -  -- - -  -  -   --  - - -    --    -   -      -
-     -   --  - --     --      --    - --    - -- -     - -  -- -  -  - -       - - - -   -        -
--         -  - --  -      -- -- --      -       - --  - - -  - - - -      -  -   - ---      -  -- -
-    -  --         - ---  - - -  -  -   -  - ---        - -     -   - - -- -     -           -- - --
---  --  ---  --   -   - -      -  -       -     - - -    -       - - - -  - --     - -  -  -  -   -
-   - -  -    -  ---         -- -- -    -    -  --- --  - -- -- - -  - -  -  -      - -     - -  ---
- -  --   -       -       -    -    -  - - -        -  - -   - -   -   -- - -       -- --   -      -
-  --   -- -   -   -  -   --  - - --        -- -- -  -   -  - - -     -      ---       ----  -     -
-      --  -  - -   -   -     -   -   - -- -      -     - - --  -- ---  -- --  -   - -    -    -   -
-    --  -  -  - --   -     - -    -- -     -   - ----- -     -- - -        -    - -     --     -  -
-      -    - -               -  - - -    - - -                -    -  -       --   - - -    - --  -
----------------------------------------------------------------------------------------------------
