100
100
----------------------------------------------------------------------------------------------------
-               -      -                 -   - -    - -     -- -    -     --      -    - -    --   -
-      --   -    - --    --  --  - - --- - --     --          --  -              --    -     - --  -
-    --  -  -- -     -  - -   - -  -       - --     --   --     -  -   - ---    -  - -  -    -     -
-      --- -  - -  -   -- -       -            - ---           --    - - -    --    -  -  -  - -   -
-- - -    - -       - ---- - -- -          --   -        -   -    -   - -    --  -  -- - ----      -
-    -  --     -- --  --    -   -    -   --        --  --      --       -- --- --    - --    -     -
-    -      ---  -  -         -      -         -       -  --  --  --          -    -       --- - - -
---   -  -     -- --  -   - -  --  --        --         -   -   -      -    - --  -  --------   -- -
-  --   -    -    -  -  ---  -        -  - -    --       -  -  -     --    - - --  -     -    --- --
- - - -    - - ---  - --  - -       -      -       -  ---        --         -        ---  -- --   --
- - -   --  -    -       -   - -- -    -     - - --       -   -      - -            -    -         -
- -   --    -     -  -    -   -         -- -   -- --   - - - - - -- -  - --    ----  -   -  -- -  --
--        - --    -    -        ----  -    - -  -     -     - - -- -  - -   --      - -- -   -     -
-    --     -             - -      -           - - - - -- -      - ---  - -  --    - -            --
- - -   - -  -  -    -  - -  --  --  -- -- - - -- -   -- -             -   -         --- - - - - - -
-      -  --   -         -   - - - -  ---      -  -          -- -  --  - --   -  -      - -  - - - -
-   -        - --   -   - -     -  --      --     - --  -       --            --      -  -- -   -  -
-----            -  -   -    -  - --         -     -  - -  -     -      -  ---   --   -         -  -
-    -    -  -         -  -- -  -  -  -  - - -- -- - --           - ---      --- - -- - --         -
- -- --  -   --         -     -- ----- ---    -     -    -      - -- - -       ---    -    - -  - --
-        - -             -- -    -     - -   - - -   --   - -  - - -  -- -  -       - -     -  -   -
- -   --  --      -   --    -  -   -  ---   -    ---  -- -   -  --       - -  -- -     --  - -  -- -
-     -   -    - - -  - -       -- -- -  - -   --    -   -- -      -      -        -- -     -   ----
- --           --   --    -  -- -  -   --       -    -      -  --     - -   -- --    ---   -  -   --
- - -  -  -  --      -    -      --  -  -    - -  -  - -  - -- -       -  --        -- - ---   -   -
--         - -   - - --- -  -            - -    -   -  - - -  -    - --   -        - -   -   -     -
-    -    - - -    -     -  --       --  --    -  -- - -      - -   -  ---  - --    - -    -  --  --
--              - - -  -        - -   - -  -  - - --- --- -- -     -       - -      --   -  -  -   -
-    - - - -     -   - -  - - --    -  -  -  -           -      - -- -- ----  -    -  - - --     - -
-            - --    -  -  ---     - --    -    -- -       -       -       -    -  -  -  -    - ----
-   - ---   - -             -  -  -  -        -   -       --   - -  -       - ---- --  -  - - - -  -
--       --    -     --   -  ---        -    - - ----  -- --   -  --      - -       --- --  -  - - -
-         -  - -- -    --         -         --     - --       --  - -    --      - - -- --        --
-  --     -     - -      - - -        --   -- -  -- --  -  -    --     --- - --  -  -   -  -  ---  -
- -     -     -   - -  --- -      -    -   -    - -  -         -     -    -- -  - - - --    -      -
- -      -  --  - ---- --     -  --  -- - - - -   - -   -- -           - -   --   -  --     - -    -
-  -   --  -  -           ---- --    --   --   - --     -  -  - -   -     ---   -    - - -  -  --- -
-         -  ---   --   ----  -      --- - - -   -  - -           -       -     --  -    -    -    -
-      - -  - -   -    -    ----   -  --- -  - -  - - -         --    --    ---    --   -   - ---  -
-   - -  -  -        -   --  -      - --        - -  -    -  -   ---  -  --    ---       -  --   - -
- -    -  - - -  - -       - -  -     -- --   -   -        - ---  -   -    -         --  -   -   - -
-   -        -     -   -   -  --      - -   -   -- - -      -   - --- - --- -- -   -        -      -
-  -  -  - -     -  --  -  -      - -   -   --   -   -- - -   - --     - -   -   - -     -        --
- -  - -       -- -    - -  -  ---  -               - -  -  - --  -   - - -        -   -    -  -- --
-    -- -     - -    - -  -       - - - - - -    -- -      -     -- - -    -- -    - - -  - -- - - -
-  - -      -- - -  -   --   -  --     - --   -    -     - - --   - -         - -  -     -      - --
-  -         ---     ---   - ---          - --   -   ---    -     -    -- - - -- - -  - -  ---     -
--  - - -   - - -  -    --      -   -    -    -- --  --     -      -  -  -  --       - - --      - -
-  - - -- -     -- -  -   -  --        -    --  -       -    --         -     - ---  - -   - -     -
-- -   --  -  --- --- - -      -  -    -       - - --  - -- -   -    - -     -     -- -  -   - - - -
-  -  -   -- - - -   -   -     --    -    -  -     -       -     -  -  -   - ---- --       -  --   -
---   -- -     - - - - - --  -   -   - --   -  -  - -  -     -   -  --   -   ---      - --    -    -
-     -  - -         --   -    --  - -      --   - -   -    - -- -          - --      - - -        -
-  -   ---  -    ---    -     -   -    - - - -   - -           - -   -       - -   -  -- - - -     -
-         -        -  - - -  -  - - -  - -     -    -   - -     -      -- ---            -  -    - -
- --   ---- -  -     -  -         - --  --- -   -          -   - -----         - --  ------ - - - --
-     -  -          -      --  -  -- -    --  - -      - -  --         -      - - -        -  -    -
--- ---- --            -   -- - -  -- -- -  -   -- -  -    - -- - ---   --  -        -      -  - - -
-   -     -- - -     -   - -  -   --      -    -   - - --  --   - - --         ---      -    --  - -
-  - - -      --     - -   --   - ---   -   --       -  - --  -   -  --   ---   -  ----  -- - -   --
-   -      ---    - -              - -       -- -     - -- -    - -    -  - -  -     -  -  ---     -
-    -        - -   -  -- -    - ---  - - --      --        --       -         -      --        - --
-- -- - -- - -   -- -  -   ---    -- -        -     - - - -    ---    -- --   -   -      --   - - --
- -   -- -  -        - -   ---  -   --  - --   --  ---  -                        --  -     - -   - -
-      -- ---- --  -  - -- -     -    --      -   - - -     - -  -     -- -  -  -  - -  - -  -    --
-      - -       - - -   -  --- --   -    -     -  --         - --  --       -- --      --    --   -
-  - -- -   -    -  -   - -    -    -   -  -         -    -    -     - -   -   -  -     - -- -- - --
- -     -  - - --     -    - -  -       -- --     - --- ---    -   -    --- --    - -  --    - - - -
-    -- --   -    -   -     --- - --  -      - -- -  -- - -           -      -   --    - -  - -   --
- - -     -  -  -             -  -  - -   - -  -  - -    - --- --    ----   - - - -         -   -- -
-- -   -          -   -     - ----     -  -- -  --    -  -  -  -     -    -  -  --  -- - -   ----  -
- - -         -          -- -  - -- -  -        ----   --    --   -  -        -   -  - --   --   - -
- -    -         - - ---- -  ---  -      - -   -   - -  --- - --  --  -  -- -  -   --      -  -    -
-    --      -               -  --    ---  --  - -   -       - -    ---   - -  -  - - - -    --    -
-     - -   --     ---   - -  --  -      -        -- -   -   - - -  -            ---   -     - -   -
--- -      --- -       - --   -       -- - -         --  - -   --        - - --- -   - -   -    -  -
-    -  --   -    --  -           -    -   -   -      -  ---    --   -       -   - - -    -     -  -
-      -   -   --     - -      -   -- -- -       -                     - ---  -    -         - -- --
-     -    ---  -  ---- -  - -       -    --   -    --------- -   -  -- -   - -  -    -  -    - -- -
- -  - - -  - ---  --  -   -    ---      -     -      -       -      -  -                - -  - -- -
--    -- - -   - - -  -  - -     -  -    --         -  -        - - - --   -            -   -- -  --
--    - -      --- -    -  -   ----    -    -   - -   -  -    -- -- -        --  - -  - -       -- -
--      ---- -      -  -  -   - -    -   --   - -         - -    - -  -  -    - -  - --        - - -
-  - -   -   -  -  - -  --- -    - - - --    -- -   - ---        -   - -  -  - -    -  --   ---  - -
- --- -   --   -    -       - -- --      - -  - - -   --    -  - -  -   -- -     -         -       -
- -    ----   -     -         --   ---- -  - -    -   -- --    -    - --   -  -  -  -     -     - --
-  - -  -  - -  --  -      -- -   -    -   - - ---     - -    -    -    - - -  -  -    - -   - -- --
--  -   -- - -     -     ---     - - -        -    -- -  --    - --  - -- -  - - --  --  --- ---- --
- -  -  - -    - -   --      -      - -   -    - -      -    -- -  -     - -  -      -  -     -   --
--    -        -       -   --     -    - -- -   - -   --   --  -- -         - - -  -    ---  -     -
-  --          -  --- -   -  - - -  --      -          -   --  -      --            -          -   -
-     - -         -  - -  - -   - -  - --- -    -- ---   -      - ---   -- -   -      --     - -   -
-   --- -  - - --    -  --  -      - -     -   - -        -  --   -  -     -     --     -      -   -
-   - -    - -  - - -      --   - --   - --   - -        - -   - - -     -   --  -  - -  - - -     -
- --  -  --   -   -  -- --         --      --   -    - - -  -     - - -   -       --   -        - --
-   --    -  --  - --     -  --  -      -   --      - -  --      -         -     - -   -    -   - --
-    - - - -- -  -    -         -  -----  --     --  -  - - --  -   -- --    -     -   - -    --   -
-     -           --   -  - -   --      -  -     - -        -  -- -         -  -   - -      -      -
----------------------------------------------------------------------------------------------------
