100
100
----------------------------------------------------------------------------------------------------
-  -         - -      --  - -  -      -    -         -        - --- -          -       -       - - -
- - -   -   - - -   -   -       --  -         -        --- -          -- ---  --  - -- -    -      -
-     -  -          - -    -- -   -- --         -    -- -  -   -             -- -      - -  ---    -
-  -    -        --- -   -  --- -- ---       -  - -   -- -   --      -  -  --     -   -   - ---- - -
-  - -- - -   - -  - - --   - -  - -  - --   --          --       ---     -  --       -     -  -   -
- -    --   -        --  --      -- -  - - - - -         -   - -      --  -- -  -   - - - -        -
- - ---    -   -  -  - -   --- --     - --  - - --   -         -     -   ---  -     -       --- -- -
-- -  -  - - -   -     - -       -          - -        - -  -       - --    - -  - -  --     - -   -
- - --   -   -     ----  -   -           - -   - - -     --  ---          -  --  -   -      - - - --
-        -    --         -  -  ---      ---     -  -    --   -  -    -      - --   --       --  - --
-    - -  --  -              -  - -- ---- --  -  -- - --      - - -    -- -    - -     - --       --
- -     - -   -     --           -  --- - -   -----     ---- ---- -     - --  - -   -   -- -    -  -
- -  -  -- -  - -  -   -  ----  -  --- -    -   --- -               - ---  --    --  - - -    - -- -
- -   - - -  - -  - -   --         -  -   -   --     - - -    ---     -   -  -  - -    --   -   -  -
-- - -    -  -- - - -   ----  -      --    - - -----            -   --      - - -  - -- ---   - -  -
- -      --- ---  -          --  - -  -  - -- - - -   -     -  -    -  - --       -     - -  -   - -
-   -     --         -   --  -  --- -   -    -                -   --   - -     -- -   -      -  -- -
-            -               - -- - - --        -- ---     -  - ---     - -          -   -  -    - -
-          - -     - --  -      -       -       - -      -  -   - -  --      -  -     -        -   -
-            --      - -  -  -         --  -  -   - --  - -     -    -- - -   -     - - - -    -----
- -- --      -  - - -     -   ---  -    ---   ----- -    -   --   - --   - - -- -          -       -
- --    --         -           - - --  -  -  -              --   -     --        - - -   - -   -  --
-     - --  - --   - -- -   --                -       -      - -     -- --    -    - -    -  -  -  -
-  -- -                 - -    -      ---  -         -          -  - --  -  -  --       -       - --
--  -  -   -- --- - - -       --   -       -  -- --   -  -   --- -   -  - --   - -  - -    --   -  -
-    - -       ---   --  -   -  - -   -  -    - -   -   -      - ------ --          - --     --   --
-- -    -   -    -       - - --    -- - - -   -  --   - -    -      -    -  -- --         --   -   -
-     -   --   -      - --- --  - -     -                - --  -     -   -        - - -- -  - - -- -
-     -- -  - -  -- - - -   -  - ---- - -  ----   -- -- -  -      ---                              -
-        --  --  - --    - -  - -    -   -          - - -    ----         -  - - - -       -       -
-   -   - -    --     - -    --- -        -     --     -    ---   - - ---   -     -  - - -   --    -
-     - -    -  - -     --  -  -      -    - --   -------      - - -        - -  -  - - -   -  -- --
--    -- --  -    - --   - - -    --            -    -       --  -   ---- - - - -              --  -
- - --     - -      -   -         -  -- --- -     -       -- -----   -   -      -      - --- - -   -
-     - --            -                  -- --     - -  -    - - -  -- -    - - - - --   ---   - - -
--     -     --    -            --- - ----         -  - ---    -  --  -- -  -   -  -         --    -
- -- - --   - -- -  -                --    -- - --  --      -    -      ----       -             ---
--          -  -      -  - -      - - -    -            ---    -- -         - - -     -    -       -
--     -  -         -    --  --  -        -  -   -        ----   --- -  -- -      -  -         - ---
-     - - -   ---     -   --   --  - - ---     --     -  -       -    - --     -    --   - --  --  -
-   --- -  -         - -    -   -    -    -- -  - -  - - - ---    -    -   --     --     - --      -
- -           ---  --   ---  -    -- -- -  -    --  - -        - -   - --         --  -  -    --- --
--- - - -  -     - -    -- -- ----    --  --  -     -   --  -  --  -       -  -  -      -        - -
-      - -      --                 -  -    -   -     -   -- -- --  -   - -    - -   -     --       -
-   -  - -     -  -  -- -   -  - - ---   --   - - -      - - - - -  ----  --  -    -  --          --
- -  -     -    --  -      -        - -  -- -      -  -        - -    - --  -- --  -  -   -        -
--- -  ----  -  - -  - - --    -- - -   -  -         -   ---           -- --  -     -  - -     --- -
-   -  -  - -     - --   -  -   -    -     - -   -    -  - --   -- - - -  -  -- - - --  -         --
- -   -- - -   - -    -  -   - -  -  -   --   --  -    -   -     -    - - -     -      - -     --  -
-  -- -   -   --   - --      - --  - -  -  -     --    - - -   - --   -    ----   -       -   - -- -
---      -   - -     -  -   -    -   -      - -  -   ---       - -       -   - --   - -   - -      -
-- ---  -    -    -    --  -      -           --  -     - --      -    -  - -    -  -      -    -  -
-- -   -  -       -      -   -   -  -- -   -       - - --  -  -   - -  ---    - -          -  - -  -
-  -----  - - -  -         -  -    -  -  -     -- -   ----    - -  -  -  --    - -  -  - -  -      -
--      -   -     - - - - -   --   -  --      -                 -  --  ---    - -       - -    --- -
-     ---            - -             --   -- - - -    -  --                   -   -  -- -  --   -- -
-    - --   -     -  -      - -- -  -  -   - -     --- -   -    -    --- --  -- -         -        -
- - -    --      --- -  -    -       -  - -            -     --      -        -     -  -- - - - -  -
- -   -- - - -           -   -- --  - --  --  --   -            -  -  - - -- -  --    -     --    --
- -- -     - -- - - - - - -   -     -       -   - -   -   --  - -       --         --     -    --  -
-- - ----  - -  ---     - -        -- -   --  --    -  -   -  -- ----  - -- -- ---      -  - -     -
- --     - --          - -- --  -    --   -    -  - --       -    --     -  - ---   -        -   - -
- -          --  - - --   -  ---     -      -  --     --  -     -    - -  -      --    --     - - --
-  -  -  --- -    -- -  -     - - - - - - --   --  --- - -    - -  ---  --   -  - ---  -           -
--   ----  -           --  -   ---   - -      -   -      - - -   -    --    -    - -    -- ---   - -
- --- - ---        - -    ----   -   -  -  -  -    -      --   -   -     -     ----   -- -    -    -
-  -   -   -        -  -      -- -     -  -- --   -         -       - -    --  --  -    -   ------ -
-    - -       -  -  -      --- -      -   -        -     --- ----         -    -   -     - - -   --
--  - -  --   -- -         -   ------      - -- -  -     -  -       -- -  -               - --     -
-      - -   - -   --    --  --    - --  -    -        -     -   -   -   -- --     --              -
-    - - -- -     -   - - -       -  -- -     - -  --   -       -- -   --   -- ----- -   - ---     -
- -   --- ---- -   -   - -    -- -   -  - --- - -  -   - ---  -          -- -- -  -     - -   -- - -
-        - --    -     - - --  --  --  - -      -   -     -- - - ---- --   -      -  -       -    --
- -  - -  -  -   - -- -  -  -          - - ---- -    - -- -    -  ---   -          - - -      ---  -
- -- - -  -     -----   -  - --   --  - -    -    -     -    -      - -  - -    ----  -- ---       -
- - ---   - - - -   - -           - -   ---    -- - -    -  ---  -   ----     -         -    - -  --
-  - --   - -    ---        - --  --- - --       -   --  -     - -    -  - - -       --  - - --    -
- -     -  -   --         -    -  -      -  -   -    -   - -  -      -      -  -   --  -           -
-        - - --    --   --  -   --        - - -        -    -     - - -     -- - -    -  -  -    ---
-- -  --- -   -   --      - - -  -          --   -  -    --  ----- -       ---  -- -     --  -     -
-    ---  ----  - - -  --- - -       - -  -   -  --   --  -   --         ---  --   -  --  -       --
- --  --  -  -     --  -- -  - -            -       - -  -  -     - ---      -      --    --       -
--- - -  - -       ----       -   -  -       -  - -  -      - --  --- -   - -  -  -  --- -   - -   -
-  - - -      ---- -         - -  - -   -   -   -- -    -       --   --    ---- -  --   -        - -
-- -              -     -  - -     - -  - -    -    -          -   --   -       -   - -  -   -    --
-   -  -     - -    --       -   -   -- --   -   - -    -- --- --- -- - -  --    -    --  -      - -
-- - -          -   - -   -  -    -  - - - -   -    -   -- --- - -      --  -  ----  -   -    --   -
-  -- - - -  --- -- - --     - - - -       ---        -       - - - -       -  --   -  -  -    -   -
-- - -   -- -    -    --    -  --    -   --    - -- - --  - -          -   - -   --  --     - --- --
- -     -  -     - - -  -        ------      - - -  -    --     --     -  -  - -   -        - - -  -
- -   -  -   -- - - - -- -- --  --      -     --     -  -     - --  --      -   -        ---  -   --
- -   - -             -- - --            -  -    -   -      --    -- - ---  - -- -   -      - - -  -
---  - -  -     --  -             -  -  -    --   -    -   - -    - -- -    -  -  -          - --  -
-    -  - - -  --        --     -     - - -  -  -- -- -  -      - - - - --  --- - -  -  -   -   - --
- -   - --- -          -   ---     -- - -   --    -     -    -       -     -   -   -  - -   -- --  -
- -  - -   -- -          -  -  -- -  -        --   - -- -     - -- ---  -  ----- --  -- -   --  -- -
-           -     - -- -  - -    -  -  -   ---      - - -     --- - -  --    -- --   -       -     -
-       -    - -  -- -    -   --   -        - --  -     -  -   --   -   -    -- -    -     ---  -  -
----------------------------------------------------------------------------------------------------
