100
100
----------------------------------------------------------------------------------------------------
-         -       -      -         -          -   -  -  -  ----        - -   -       ---   -  - -- -
-     --  - - ----     -   --    -  -         - - - -  - -       ---       --  - - -   -       --  -
-  - -  -- - -   -    -        --    -  - - - -        - -   ---        -  --           -  - -     -
-  -   -  -  - -  -    -  --   -       - -  - -- -     -  - -    -  --   -  - -  -      -      -  --
--  --  --    - - --  -- -     - -     -   - -     - - ---  -- -      -       -  - --        - -   -
--- -    -  - -  -    -    -  -     -   -    - -      -    -   -   -     - --      --   - -- - -- --
- -    - -   -     -   -   -- -  --   -   -     - --   ---  --  - -    --     ----   -       -     -
-  - --   - -  -   --  -  --    -     - - -  - -     -- -     -  - -      -   -  - ---  --    -    -
- --        - - -     - -   - -     -  -   - -    -  --     -      -- - - - -     -     -   --     -
-   -    -     - - -   -  --  --         -  - -  -  - -    -    -   -   -      -   - - -- -----  - -
--    -     -              -- -  - - -- -   --    -    -              -  -- -  -               --  -
-  -      - ---   -- --   -  - - - - - - -  -    -   - - - -  --  --- -   -   -       -- - -       -
- - - - - -     -- - -- -     - -- -   - -     - -- - - -  -----   -  --  --   -   - -----      - --
- -  - -  -    -      --        -- --      -    - - --  --             -   - --   --  ---- ----    -
- -  --     -- --   -     --    -        - -       -  - ----  - -- -   -      -  -        -  -   - -
- -                --  -    --   -   - -  -  -  - -    -   -    --    - -  -- -  -   ---  - -  -  --
---   --    - ---  -     -    -- - -- -- -       -- - -  - -    -      --- - --          -     -   -
-        - -    -- - - - -     --   --     -   -   -- ---   -     -  --       - -  - --      -     -
-   ---      --    --  - -    -- -         -    -   -    -     -             -   ---   -   -- -- - -
-  -  -        - -        -  -      -- -   -         - - -   - - - -      - - -     --      --    --
-    -     -     -    -  - -  -  -   -   -  -    -   -   --          ------      -        -    -- --
-- --     ---           --  -   -- -  -    ---- - - ---   - ---- -   -  -   -   -  - ---    -      -
-       - -    -   --  --             -     --  -   -   --  -   --     -     -  -  -   -- -   -    -
- --        --   -   - -  --- - - -    -   -  -    -- -    - --- - -    ---      -  --- -          -
- -     -   -- -- -  -                   - - -   -       -   -        --   - -   - ---   -   - -- --
-      - --     -  --   -  -  -  --- - -       -  --- -         - --    ---   -   -    -  - - - -  -
--  -  -   - --      -  --   --  -   -   -   --  -   -       - -  -    -    --       -    --  - -- -
- - - -- -  -   -  -- ---   - -   --       - -  -    - -     -   -   -    --    --            --   -
-  --  -  -   - -          - - --           -- - --  --  --    -- -  -   -       -     -       - - -
- - - -       ---     - -   - -   -  -   --       -   -   -  --      -   -- -    -  - -  --    - - -
--     --  - --  -          - -  -   - --   -- - - -   --    ---  - - -         ----     - - -   - -
-    --  --       - --   -  --  ---       -  - - -      ------  ---   -    -  -     - -        -   -
-- -  ---   - --  -      - --        --    - -  -- -  - -     ---  -    -      -     -  --   -     -
-  - -   -   - -    -    -    --    -          --          - -     --  -         --   -    -   -   -
-       - --        -  - -  - -    - --- - -      -   -     - -   - -- --- -    -  - -      -      -
-   -    - ----  -- -    -       -  -        - - -          -  -    -- --  - - -    -  ---- -     --
-   -    - -  -  -- -  --  --- - -       - -  -       -      - - -   -  -  -       -   -    ---    -
- -- -       - - - - - ---    -  --  -      -     -      --      -- - -     -         - --    --   -
--      -         --      - -    --  -  --  -   -     --  --   -  -  --- - -  - --   -  -   --    --
-    -    -   -   - --   -   - -    -     -- -   --        -  -  -- --  -      -  -   ---  -  - -- -
- - - - - - -  - -   -     - --   - -  -             - -     -    -   --   -   -          -   - -  -
-    -    -  - - -    -     -    -         --    -      - ---   --         - -    -    -   --   -  -
-    --           -  -  - -    -    -  -- -    --    - -      --       - -   -     -    - - - -  ---
- --- --   --  - -    -- -- -  -           -  - - --       -        ---    -  - --       - -   -   -
--      -   -- - -   --        - -  -       -    -     - -  ----  -   -  --     -    -  --   --    -
-    -           -  - ------         -      - -      -     - -     - -          -- -  - - -  - --- -
-- -          --  ----      - -  -        -  -   -  - ---       ---  -  --- -- -  -       ---  -   -
- -         -   --     ---- -   -        -     --  -    - -   -   - - -      --  - - -   -   -     -
- -      -       -   -      - --- - -  -     - -  - -   - -     --   -  -    - -    -       ---    -
--  -- -  -   - -     -   -    -         - -  - --      - -    - --   -     --    -   - -   -- --  -
-   -     --       --  -    -- - - - -  --- - - --- - -  - --- - -     -  -   -  - -              --
---     -          - -   -  -    -- -  -              -   -           -         -  --  -   -  -    -
-  - ---    -  -   - -  -     -    -    -   -- - - - --             -    -   - -  -              - -
-      -   - -    -   -   --- -   - -  -   - -   -  --  --  -  - -      -  - -  -- -        -    - -
-       -  -          - -  --    - -  -    --  -  -    - -         --- -  - -- --    -  -    -- -- -
-    - -        --   -- - -    -- -    --   -- -    --    -   - -    - -  ----     -       - - -  --
-       -    -    -    -    --  -      -        -     -- -   - -    - --    - -       - - ---   -- -
- -      --- -  -- ---    -    - - ---   -- - - --  --     - - ---   -   --   -   -      -     -   -
-       -            --- -    - -    -     -      --   ---- -   -  -----     -  --   -      -  -  --
-   - -       ----     -     - - --    - -  -- --            -- -     --          - -  - -   -     -
--  -  -   --  - - - -          -   -       --- --- - - -  - ---  -  -  -   -- - -----     -      --
- - --               - - --  - -- -    --       -  --  -    -   -  -- -- -     -      ----- -  -   -
- --   -        --  -   -   - -- - -  -   - - -- --  -     -    --    --- -   -    --        - -  --
-     -   - -     -     ---   -    ---- --   -  -     --      - -    - -    --    -    -  -    -- --
--    - -  - --  -  -      --  -                      - -    -     -  - --     -    -  -     -   ---
-    -   -     -- - --    - -    -   - ---  -    ---         -- -     -      --          -         -
--   -  -    --        - -  -  -- - -   - -     - -      - --     - - - -- - -        - -  - -     -
- -- -     - - --- - --  -  -     - -    -  --        - -     - -  --  -     -    -   -  -- -    - -
- --         -    - -     -   --  - -  - -        - --    -  --     -  -  -           - -   --     -
-   -  - -- -- - -- - - -           -   -    - -         -  ---  - ----      -- -      - -      - --
----      -   - -     --- - -   --   -    --  -- - --- - -     -  -         --  ---    - -  --     -
--   --    --        - --   --     --  -  - -  -  - -   - --- - -     -  - --    - -   - -   -     -
-     - ---  -   -   - -  -   -   -   -    -       -----  - - -  -  -    --  -   - -    ---  -     -
-    -  -         -  --   - -        --- -  --   -      -  -    --  ----  ---- -       -  -  --    -
---    -   --          --  - -   -   --      -     -     -   - -  -  - -  -  -   -       - -       -
-   ----     - -- -   -  - -- ---       - --  - --    -  - - --- - -      - -   - -         --   - -
-  - -    -   -   -    -   - --    --             - --- - --        --     -  -       --    -      -
---- - -   --  - -   --   -   - --   -    -   -    -   -   --       --   - - - - - - - --        - -
--   -  --   --   -   ---      -  --   - --   - - - -  -- -  --- -       -- --       -      - - -  -
- -   -   -    -    -   - -  -      --  -  -   -      --  --   ---      -- -   - -    -  -      -  -
--  -       -  -   - --    ---     -       - - -  --     -    -       - -- -   --  -   - - -  - - --
-  -  -   -  - --  -    -    ---- -    --   -- -    ---       ----           -- - -         -  -   -
-     -  - - -   -  --    -        --  -  - - -    -    --     ----   -      -- - - -       -  --- -
- - -- -  -- - -    --   -   -     -   -- --        - --   -  -- - - - ---       --  --  -    --   -
-   - -    -  -     -     -          -- -     -    - - -    -   - -    ---- -  - -  --     -   - - -
- - ---  - -   --  -   - --         - -  - -  --  -  - -- -   ---  --    - -   - - -  - ---  -  -  -
-  -- - -   ----  --          -   -   -     - - - -      -  -        --  - - -           -      - --
--    -  -- -       ---- -  --        - --  -- - -     - -   -   -   --- - -      -  -  -  -  -    -
-  -- --  -  - -- -   -     -  -   -       --- -  - - - -      -  -  --   - -- -  --  -  -   -  -  -
- -    -           -   - - -  - - -    - -    -     - -  -  -   -  - -        --      - --  -   ----
-   - -  ---- -    -  ---   --      ----- - - -      - -        - -   --   -    -  -- -        -   -
-  - --     - -            --       -  -    -     ---           --  --    - -- -- -     --       ---
-  -      - - -   --    --  - - - - --     ---        -  -   ----  -    - -- -  -   -        -     -
- -- -  -  --    --- -   - -  -       - -      -- -- -   -  -   -   -        -  -     --  -      - -
-   --- -   -  --        - --            -  - - ---- - -- -       - --     - - -         --     -  -
--  -  -- -    -  --- -  -  -       -- - -- - -    - -   -  -        --  ---   --   --- - -     -- -
--  --   - - -  - - - - -       -         -   -  --   - ---  --   -    --             --        -- -
-      -   -    -          -  -     -        - -        ---  -   -   - -   -  - -    -- - - -      -
----------------------------------------------------------------------------------------------------
