100
100
----------------------------------------------------------------------------------------------------
-        -   --        -   --     -  -         -        -         -  -- -- -     - -      -     -  -
-   - --- - -   - -   - -  -  --      - ---           -    -  - -- ---   -    -     ------ ---     -
-    - - --  -- -     -  -  -   -      - - -     ----   - -   -  -  - --- -   -       - -     -    -
-  -- --  - -  -    --  -   ---    - -  -    -  -  - -    - -   --   - --   -  -  -  - -    --  -  -
-  -      - - -          -  -- -   -   - -    -       -    -  ----   - -    ---  -- -- -   ---    --
-   -- --   -   - -    --- --          -    ----   -    - -  -    -  ---- ---  -   - -   - -     ---
-      --- -                 -    -    -- -   -    -      -    -  -       - --   -  -  -    -   - --
-         - -  -    --- - --    -      -  -    --       -- -  - -   --- ---    - --  - - --        -
-    -  -   -- - -- -      - -  -- ---- -  - -     --      - -   -   -   -  ---       -     - --- --
-              ---  --   -- - -     --    -  -   -       -   --   -   -   -    -    --   -       - -
-- -  -           -- - - -    -    -    -- -  -   -   -     -   --        -- -  - -- -       - --  -
- - -  -  -  -  --    -  -  -   -    -- -    -- -     - - - -- -     -   - -   - -   --  --        -
- --   -     - -   --    - -  -   -  -    -    ---  -   - -        --  - -   -   -     -      - -  -
-    -    --    -- - - --- - -   -   -          -   -  -            --  -- - -       -  -          -
-  -       -  -   -       - --         ---  - -   - -    -- -  - -         -     - -      - ------ -
-    --  -  -    -   -        --- -  -    -       -   - -            -  -  -  --  -  -             -
-  --   -      -    ---- -   -    --- -         - - -     --      --           -- -  -- --    -    -
-       -  ---         -  -  ----       - --   - ---    -- -----       -     -      -       -- -  --
--   -  - -    -----    - --        --      -          - --      -    -    -     -    -   -  ---- --
-  -        --     - - --- -  -       -       -  -- -    -     -  - - -  -- --   -- -  -        - --
-    ---      -  - ---  - -           -- -     - -- -- - -       -   - - - -         -       - -   -
---  -  - --             -    -- - -         -   -         - -  -- - -   - --  ---   --   -   -    -
-   - --   -   - -     --  --- -    -                 - - -     - - -   --      -- --   -  - -  -- -
- --  -  -  - - - --  -    -- - -- - -- - -   -      --    -  -          -  ----           -      --
--     --   -  --    - -  -  -  -   -   -   --           --    -      -     - -- - - -   - -- -   --
- --  -     -   -- - - - -     - -    --       -         -- --  -     - - - - -- -            -  - -
--            -       -- -    --- --            -   - -    -  -- ----      - - - - --- -    -   -  -
-       --- -   - - -     -- - - - - --  -    - -  -       - -        -- - - --     -  ---       - -
-      -   -           -    ---    -   --   -   -  ---   -  - - - --  - -  --   -    -    -   --   -
-  --    - -  --      -- - -  -  -     -     ---  -       -  -      -     -   -  - ---  -          -
-      -     -     -     -  --         -  -     ---    -  -   -  -    -     -   -    -      -   -  -
-   --  -          - ---      -  - --       -      ---      --  -  -  -- --  -     --      -    - --
-    --   - - - - - - - --         --- -- -    -  -   - -   - -   - -      -   --  - --        --  -
-   -    -  -   - -  -     -  - -      -  --  - -        - -        - - -  -      --   --    --  - -
-          -  -   --- - -       -    -   --  -- -   ----     --           -- -    ------  -   ---- -
- -         - - - -  - ---- - -     - -       - -           -    -- -  --- -  --     -    -- -     -
-       --   -      -     --- - --   - - -        ---  - - - -  -  -  -  -- - -- - -- --   -   --  -
-   -   -  -    ---     -      - -    -   - -   -      - -    - - -    ---- - -- --         -   ----
-   -          - -   -  -      - -   - -    -  -  -              ---  -      -    - - --  - - -   --
---    -   --           - --   - - -  -  - -  - -- -     --  -     -- -- - -- - - -    -   -  ---- -
-   ---     -            -  --  - -  -  -   - -- -- -            -     -      - --    -  -    -- - -
- -   --       -   --         -   - - -       - -  --- -    - - -- -- - -    -     -   -   -       -
--   -  -- -   -         -  ---- -    ---  -          - -      --  -- -   -     -- - -  -   --   - -
-   --       - ----  - -      -  ---     - - -   -    -       -     -            -   -    --   --  -
-   -  -   - - - -   -- - - -       --       - -  -  -   -    ---    -   - --   - - -    --  --  - -
- -    -  -     -- -   --     -    - -    - --    - - -      -   ----    -      -  -  --  - -  - - -
- -     - ----     --- -- -     - - -  - --  -- -     -   -     -    - -  -- -   - -- - -- -  -    -
- -    --  -  - -     -      -         --     - -  - -  -- --- -  - - -- - - --       -   -  -- - --
-  -   -     -    -  -  -   -   -       - - -  - - - - - --   -  --  - ----   -- -   - ---         -
-    --       -  -         -  ---   ---    -- --     -   - -- -   -       -   -       -    -- -   --
-    - -     -   ----- - -  -   - -- - -    -     -      --  -- -- --- -   -   -   ----- - -   --  -
- - -   -  - --          -        - -      -      --   -   -     - - -     - -  --      - -  -     -
- - --       -  -- - -  - -     -   - -        --    - -    -    -    --    -      --- -   ---     -
- - -   -  -  -  -- - -    -      -   -      -   -       --  - ---       - - -   -     --    -- -  -
- ---    --    --      -  --          --     -   -   -  - -- -   -  -       - -    ---      -  -   -
-- - ---- - -  - ---    -          -  -           -       -    -  - - --         - -    --- -    - -
-   -  -     -  - -- -   ---  --   -- -- ---  -- -- --- -   - --    -   -    - -    --             -
--  - - - -   -  --    --   -         --          -- -      -  -       --- - -- -   -  -   --    - -
--      -           - -    -             -- -         - - -  -   -  ---       - -- -  --  --       -
--      ---   - -  -     -  -  -    -   -     - --    -- -   -    -- --  - -  - -   --  -- -    -  -
-  -- -    -    --    -  -  - - -- -    -     -   -  - -  - -    --  -  - -  -- -  -- --      -  - -
--   -- -        -     --   - - --    ---     -  - - --  -       - -       -- - -    ---   -  -    -
-- - --    -     -   -  -   --   - -     -     -      ---      -  - --  --     -   -  ---    -- -- -
-   -  - --  -   -       -- -- -   -         -  --   -     --      - -       -   --  -  -   -      -
- -   --  --- -    -      --      -  - -    -      - - -      -      --- -  - -    --       - -- - -
-   ---     - - -- - -  - -- - --  -   -   - - -  -    -      -            -   -      --      -    -
-  -         - -  -   - -- - - -      -  -   -       -  -    - -     - -      - - --   --     -   --
-   -  - --  -    --   -    -  -   -- --- -   --     -- - ---    -   -         ---        - -  -   -
- -  -- - --   -       - ---   -         -          --  - --    -    -     -     - - -      --     -
-- -  -     -  - - -            -  -   -  -   -    -  -        -     - -   - ----  - - ---     --  -
- ---  -   -   - -  --  -- -     - -  -   -  - - - - -   -   -  --  -  -    -    - --    -      -  -
-  -    - -  --   -  --- -       - --   -      --   -- -   -   -  -  - -          -   --    --   ---
-  - -   - -  - -          --    ---    --   - -  -   -    - --                     -  ----  --    -
-    --      - -     -         - -   -   -   -  -  - -   - - -             --     -    -          --
-- -   - -    - -   - -  --   -   -      - -   - -  -  -    -      --- ---  - - -          -     - -
---  -- - -  -    -     - -  -   -  -   - -      - - -  - -       - -     -- -  -      --          -
-  -       -   -      - - -   -   ---  -- -       -   - -   - - ---        - --  -  ---  --   --  --
--  -  -   -  -  -   -  - -  -  -   - - - - - - -  -       --- --  - -  -    -  -  - -    -    -   -
- -- - -    -  -- -- ---- --      -  -  -  - ---- -     -   -      -       -      -   -- -   -    --
- -  -        --   -  -     - ----     -    -    --   -   --   -    - - -    ---  -    -  -  --    -
-        - - -  -  -       -         -- -  --  --   -   -- - - - -   -    -    -           -   --  -
--  - -  - - -   ------- - - - --- - - -      --   - -       --- - -- - --    - -    - -    --     -
-       - - --       - -    -    -     -- -    -  -   -    -    --  -  - -  -    -  -     -      - -
-  - - -  - -  --  --  -     --  -   ---   -     -          -     -     - -  ---  -    - - -  --   -
-       --       -   -    -   -            - -  -     - -   --  -               -   -  --  -    -  -
- --        -- - -- -    -  -          -   -    -  ---       -   --  - -- - -              --   -  -
-- -  -  ---   -   - -- -     -   - --- -   -   -   --   -    -     ----                -  - -  - --
-  --          -  - -  -   - -    -- -  - -   --       -- -    -  -  - -- -    -   ----- -- -      -
- - --       -- - -- -     - --         -   -    ---  -  -   -        -    - -- - -      -         -
-  -   - --   -      -    -         -   -         -    -- - ---        -- -- - - - -   -    -   - --
-   -  --      -  - --  -            --   - - -       -        -   - --  -  --        - - --       -
-  - -  - -- --       -          -   --  --  - ----      -- -  -- --   - -   -- -  --   - - ---  - -
-    -   - --- -     -  --     - ---- -   --  -           - -  -  -     -- --   -    -    - -  - ---
-    -   --  -   - --    -  -         -- -     -    ---   -- --               -    --           -  -
-      -    -- -   - --    -   - --       ----     - - -    -       -        - --  -  -    - --    -
- -   -   - -      - - - -  -  -  --  - --      -    - - -- - -- -  -        -        -- -- -      -
- --       -    -  -      - -       --  - ------    -    -   - - - -    -- -   ---   - -     -    --
-  - - - - -  -  - -  - -   -     - -         - - -     -  - - -    - -       -  -  -   -  -   -   -
----------------------------------------------------------------------------------------------------
