100
100
----------------------------------------------------------------------------------------------------
-         -                 - - --      -   -  -     -        -             -     -    -      -    -
-   -- -   --- -   -- -    -       -  -      -    -         -    -    - -   -   -                  -
-  -       --    -     -   -- - - - -   -     - - - -     - -    - -      -   - -      -    -   - --
-   -        -- --   --    -     --  --  -  - -    --   -   -  --   -   -  -    -- -      -  -- -  -
-  ------  --       - --  - -  -       -   -           -   - -     -      -            -- -  -    --
- - - -   -  -       -  -    -            - -      --- -     ----   -- -   -   - -- -   - - - -    -
- --      - --- --      - -  -- --  - - - - - -   --   -    --  -    -      - - -  -    -    -    --
- -  -    -       -       -     -- -       -   --    -            -     -        ---    -  -       -
-       - - -  -        -  - - --         - - -   -      -      ---    - - -- -       - - -  -   - -
-      -     -          -   -       - - -      - -   -- - -- -  -      -   -    - ---    - - -  - --
-   -   -- - -           -      ---    -  -- -   -   -      - -  -       -  - - -- -- --        -  -
-   - -      -   ---   -- -      - -    -   --- ---  -  ---  -       --    ---- -  - - -   - -  -  -
- - -   --  - ---  --    -   - -- - -  ---         --- --  -       -   -  - --- -            - - - -
-- -    -   - -  -      -  -      - ---   -    - -  - --   -  ---     - - -  -  - --    - --      --
-  -      -  -          -   -   - -    -- ---   --   --   -       - -  -  - -   -      -  - -   -  -
- - - -    -- -    - - --  -     - -          - - -         -- -----       --  -    - -  -- -  --  -
-         --   -- - -   - -   -  -   --    -   - -  - -     -  - -   - -       - - -  -  ---      --
-  -  - -     - -   --      --   -       -     -  --  -   -    - - -     - --  -       -  -   --   -
---   -          --  - -- -     - --- -    -          -   -     -   -  -  -         -    --   -  - -
-- -   -    -                  -    --      - --    -  -    -  - - -   -    -  - - --  -           -
- -    - -  --  - - - -   -   -   - -    -        -  -   --   -     - -                  -      -- -
-      - -  ---  -      - - - -       - --         -  -     -   - -     - --- -     - -  - -     - -
--- - -   - - -     -  -  - - -     - --   -  -   -         -  - -    -            - -  -      - - -
-    -  - -  -  -   --  -     - - --      -      ---  --- -  -  --             - - --- - --   - -  -
--    --    -    - - --    -                  --    -     - -  -  -   -     - - - -  - -  --      --
- - -  --   --        - - - -  -    - -   - -      --  -   - --- ----        - -     --  - -- - -  -
-- -- -- ---      ---  - - ---   --- -  -        - --   - -           -  ---    -   -- - --   -    -
-    - --   -  -   -  -   -     -     -  - --       -  -   - --- --       -- --  -  -- -    - - -  -
- --    - - --  -        -    - -   - -     --  -- - -  ---    -  -- -- --   -  -       -     - -  -
- - -      -  -  -   --   -  -   -   -   -- --   ---   - - --      -    - --  - - --- -   - --   ---
-  --  -  - ---- -  -   -  -    - -        -     -         -  -      -   -   - - -   --  -   - - - -
-  -     - -     -  - -   --     -      --   - -   --   -   -   -  --   -   --   --    -           -
-  -   -  - - --  -  - --  - -         - - -  --  --     -      - -  --   -      -- -   -     --   -
-  -- -  -  - -   -   -       - - ----   - -    -   --   --         -   - -    - -        - --    --
-     -   -     -- ---- - -- -   - -    -  -       -   -   - --    - --    -      -- ---- -  --  - -
-  --  -     -  -    -    - -  -- -    -  -  - - -  - -  --  -  - - -    - - --          -  -  -   -
-  -       --  -- -   -    -  - --  - -   -  --     -   -  -  ---    -         --   -   -   --  -- -
-       -- - -         ---    -       - -- - -     -    ---       - -  - -    -   --    --   -    --
-   --  -    -     -  -      - - -- - --    -    -- -   - ---- -    - -- -- -        -- - --   -- --
- -         ---  -  -- --  - - -         -   - - - --        -   -  - ---   - -      -  -          -
- - -   - - -    --     --      -      -          -   -   - - --     - -  -        -  -    -- -    -
--         - --   -     --- - --   -- - -----        --   -     -     -       - --  --   -   -     -
-    -   - -   - -- ----     -  --- -    -  -  -  -- -          -- - - - -   -      -- -   - -  -  -
-  --   --     -      -  -- -     - -  -  -     --  -   -     -  -   -   -- - --        - - -     --
-    ---   - -   -      -     -    ---     ----       -   - -  -  -  - --    -     -  -   -   -    -
- -  -   -               -  - -     -- -- -      -  ---  -        -- --    - -- - -             -- -
--  -   --  -- -  - -      -  --      -   -         - -   -   -     - --  --    -    -           - -
-         -  -    -----    -     -     ---- - -- --  -     -     -       - --  --     -      - -   -
--  -  -  -        --      -     -   -     -- -      - -  --   -   - -   -       --   -            -
-   - -    - - --    --  - -   - -- - -  --   -   ---   -  -         -- -- --   -          --  -   -
---     - - --   --   --     - - -- -   -  --- - -     - -  ---- -  -    -   - -      - -- --   -- -
-- --   -     -   -           -   - --   -        -  - -         --  -  - - -       -   - -       --
- -     - ---   -  - -  -     - -   -               - -  ---    - -   -- -       -   -- -   --     -
-   ---       -  - --   - --         --  - - - -        -   -      ---- -  -  - --  -     -   --   -
-- -  -    --  ---     - -  - ---   -- -  -   -      -   -       --        ----      - - -   - - - -
-- -    -    -   - -      -              --                - -        -  - -  -- -     -  - --     -
-   -   - -      -- --  --  - -- -    ----- --  - -  -    -   - -  - -      - - -    -    -   -    -
- -    - --  -  --- -    ---  -     --     -        --  -   -- -         - --    -   ---    -      -
- -                 - -  -      ----       --   -    -  -  -- --  --    - -              --      - -
-  -      -   -   -   -  - -  -    -    --- - -    --     -   - -  --     -     --          -   - --
- -  -   -      -- - - ---   -  - - - - -  - -          - - -   --  --   -  --  -- --    ---    -  -
-   - -- - --  -  - - -    -      -  --    -  --              -  -    --         - -    --   --  - -
-          -       - - --    -- -    - -     -     --  -   --- - -           -    - --  - -    -   -
-- -  -       -      - -      -      --    -         --  --  -   -   - --- -   --  -     - - ----- -
- -     -   - -- -        -     -  -          -            -  - -  -   --     --  - -  -   --   -  -
- -    ----        - - -      -   - -    --     - -   -    --        -   - - -       -- -      -   -
---    - -   ---   --   -- --  - -            -  - --    -   -  ----     -  - -- - - - -  - --   - -
-      --          -            -     ---   - - -         --    - - - - -  -    -  - -   - --     --
-   - - -- -  -   -- --   - -     -    - --  -        -   - -- -  -     - --  -    -   - --  - --  -
-- -  --    - - - -  -  - -    --   -     -    - -          -   - --  -         ---  -- -- ----   --
- -- -    -       -  -   -   -     -  ---  -  -       --  - - - - -  -  - - -- -  - - -      --    -
-   --    -  - -          -  -    - - -  - -- -   ---      -   -    -       -   - -- -       -     -
- -    --   -    - - -     -   ---     --  -     - -  - --- -    -      --  -    - -      ---   - --
- -      -    -    -       -  -  - -  -     -     - -- -       -        -       --    -     -    - -
-  -  --   -   - -- -  --  -    -   -  - --     -    -- -  - --  -        -  -- - - -- --  ---  -  -
-     -   -  --  -  -   -- -    --    -      --    -   -- -    --    - - -  - -   -    ---       ---
---- -     - -  -  - --     -  --  -  -  -   - ---            -   --  -  -- - -  -     -- -  ---   -
- - -- --     -    -     -       --     -- --      -  ---    -   - -       - -     -        -   - --
-    -     --  - -  -- ---   -  --  -  - --  - -  -       --- -   -   -               - -  - -- -  -
--               ----          --    -     -    -   - - -  - -  -   -   -  -- -        - - - -- - --
-      -    - - -  - --- --   -   - - --  --    --   -     --   -- -  -       - -    -  -  -  -  - -
--    -  -  -        --  -  -  --- -  - --   - -  -    -  -  ---  -    -    -  -  - -      --- - - -
- - - - --    -        -   - -- -   -     -      - -- -   - --   -- -- ---   - -     -     -       -
-     - --- -  -- - - -- -   -- - -  ----   -   - -  -    -    -    -  -    -          ----   --  --
- -     - -    --  - -  - - -- -  -- --   - -      --    -    -         -     -    -       ----- - -
-       -  - ---             - --- -        - --     -  - -  - -   -   -    --- -  -  -         -  -
--  - -- - - - -   -- - - -- -   -   --- - --  - ----       - ---   --  --       ---        - ---- -
-  -    - -    - - -   -     - - -  - -     -        ---  --       -  -  -    --     -  -  ---     -
- --  - -  -    ---  - - -- -   -  --  - --  --  --        - -  -  --       --- - -  - -          --
- -  -  --  - - -  - -       - - - -   -- -  -   --     - -  - -    -      -  -   -  -  ---- -- - --
-  --  --  - --        --  - --  - - -      -        -   --     -   - -        -   -   -  -    --- -
-  -  --  -    - -  -- - - - - -   -  -         -  -  --   -- - - -    - --    - -- -   -       -- -
--   -  - - -  -      -       --     -  -  -  - -- - - - --    - --        -          - ---   - -  -
-          -      -- -  - - -  -   --  --- ---     - -        -    ---  -     --   -     -  -  --  -
-   ---  - --  -     -    - --- -- - --- -   -   - -   -     -  --    ---  -  -  -   - - -   -   - -
- -- -    - --   -                --   -   -  -     - -   -       - --  - - -    -   -  - --       -
--    -           --  -  - - -  -   - --            - -   -- - -  -     - -  - - --      -- --    --
- --    -- ---      - -    -      --  -        -    - -  -  - -   -- -        - -      -    -  --  -
----------------------------------------------------------------------------------------------------
