100
100
----------------------------------------------------------------------------------------------------
- - -  -  -  -       -       -   -        -           - --      -     -      --    --       -- -   -
-       -    - ---  - - ---   -   -  -   -   -  -      -   -- -- ---- --   -   -      -   ---      -
- - -- -  -     -    - - -      -- - - -  --  - -  -  --   -  - -      -   -   -   -    --    - -  -
-  -          ---- - -- - -          -  - - -  --  -   -    -   -    --   -   -   -  - ---    -    -
-       -  -  - - --  -   - -  -         -         -    -  --  - -  -    -     - -  --  -  -   --  -
- --  -- --- -      -  -      --  -   - -      -   - -    --     -     - -   -   - -  -- - -      --
-   -    --    -   -    -- -       --       -   - -    -  -        -        -  - --    -  -  - - - -
-     -   -        ---   - - -    - -     --   -    ---  - -    --   - - -  - -           -  - -   -
-       -- - --  -        -        ---   -   -  -    -     -   -- -    -   -   -   -- -    -       -
- ---- -  -  -       ---  -      -      --  - -   -  -  --  -    -   -  - -       -- -   -- -      -
--     -   - -   ----         -  -  -  -   -  --  - - -  -  -  -      - -  --        ---- -    --- -
-      -- - -- -      -- --     -     -  - --     ---                -   - - -   - - -    -- - -   -
-   -- -  -    -  -     --   -   --  -----      -   -    - -- - - -- --  - --  - -  - -  -  -      -
- -   -  - -- ------   -  - -     ---   -        -  -      ----    --  --   - -   --   - -  -  - - -
----   --   -    - -    -           -       -      -      -   -- -          - - -        - - -  ----
-  -   - --  -        - - - --- -  -  -     -   -   -            - --  -  -       -   -  - -   -   -
--  -  --     -     --  -   - - --   -   - -  --        -     --- -   -   --     -      -  - - -  --
-       -  - -   --          -        ----   -   -- - --  -- -     -         -   - - - --    ---- --
- --    -- --      -   -  - -  - -- -     --- --  -   - -     - -- -   - --   - -   - -  - - - -   -
-- --- -  -  -      -- - -   -    -    - -          - ---  --   - --- -  -  -     -     --    -    -
- -     -          --- --   -  ----    -  -  -  - -  -       - -  -- -    -- - -       -  - -  --- -
- -   -  - --  --    - -  -  -- - -   -           --  -- -    -  -  -  -- - --      - -  -     --  -
- -  -   --  --     -    -    -       -   -   ---    --   -       -   -        - --    --   ---   --
-- - - - --   -      -- --  -  -       -     -   --   - - -      -  - -- ---- -    --    -         -
--   - -    - --    - - --   -    -   -  -  -- -- --   -        - -- -  -- -    - ---      ---    --
- --      -    -   - -   -   -       -  -         -       -            - -    - -     - -   -   - --
-       -    -         -  -   - -  -    - -    -- -- -      -      - - --- - -- -    --  -         -
- ----- --- - -   -  --- -    - -   --    --- -  -       - - - ---    -   - -   -          - --    -
--           - --   -   --   - --     --- -  - -- -  -      --   -  --   --- - - - -  ----     -   -
-    --   -  -        --   - -  -- --     -   -    - ---           -       -  ---   -- - --  -  -  -
- -      - --   -  - -      - -- -- --      -     -     -  --  -   -        -         - -      -   -
- --                        -       --  -  --      ---    -      -  -- -   -- -  -   -   - -   - - -
- -  -  --   -- -  -- -      -     -    -    -   -   -   - - -- - -  - -                           -
-  -    -   -     -  --  -      - -   -    -  - -  -- -  - - --      -           -- -   ---   ---  -
-         - -    -  -    -     --   --     -     - - -    -      -    - -   -  - --    --  --   - --
- --  -  -     -  ----        -         - -           --  -      - -- --     - - -   --  --   -  - -
-         --               -- -      -    -   -  --  -  -  ---      -  ----  -  -  -      -        -
-- -    -    -  --  ---  -  -- -   -     -- -   -   -    --- -   - --      -  -- -    -    ---   - -
- - --  -     - -   -       - -       -    --      -  --    - -    - -  -     - -   --    -   -  - -
-  --    -- -    -    - -   - -    -    --  --  - ---- - ---  - --        - -- -  --         -     -
- -  -      -   -      -  - -    --   - ---      -  --  --    - -     -   -- -   - -  - -- - - -- --
-   - -  -     -  ---   --        ---- -    - --  -      -  -   -          - - ---        -- -  -- -
- -    ---   --- -  -    - -  - ---      - --    -    -    -                -- --- - -   --  - - - -
-  -       - --  --- ---  --          --       - - - -- - -   -     -       -  --          -- -   --
-    - ---   --  -- --  -   -  - -- - -  - -   -             -  --    --   -  - --    -- - - -   - -
- ---      -    -     - - --   --  -   --   --  --       -     -    -    - ---   --  -   - --   -  -
-       -   -   --         - -        -  -- -        -- -   -   --     -    -- -    -  --       -  -
-   -   -   -         -      -  -----    -    ---         -  -----  ---   --     - -   -  -- -   - -
- - -  -    -      - -     - --    -     -  -- - - ---  -  -         - --      - -     - -      -  -
-   -  - -   - -        -- - -  -          - - -     --- --    --- -        ----  -       --  - -  -
-  - ---  --      - -   ----- -  -  - -  -    -    -       - - -   -    ---      -  -- - -  -   -  -
- -      -  -  -  - --   - -    -      -- - -     -         -    -  --   - -- --     - -      -   --
-   - -  -   -    -- -    -     -  -    - -   -  -     -    -   -         -  -- -- --  ---        --
-     --- - - -   --  - -      -- -  -- -     -  - -   --   -   - -     -- - -    -   -   -        -
-               -   -   -- -    - - -    -- - - - -  -       - -     - -   ----     -    - - -     -
- -       - - -   -   --     -     -- --- -     -    - -   - -  --   -    -  --  -      - - -   -- -
--  -      -   - -  - -   - -    - -  - - -   -   -- ----      - --    -  -       -   - -     - -  -
-       -    ---            -  -    -  --- -         - --- -        - -    -   -- -     -  - -     -
-  --- -        -  - - - --       -  -     --     - -       -  ---      --    - -     -   -   -- ---
- -  -   - - -   --  -  - -         --   - -          -     -   - - -      ----          -- -      -
-  -         -- -      --      -  -    -   - - -      -- --- -   - --   -    - -   - - -   - - --- -
--     -    - - --    -  -  --  - -       -  -  -  --  -- - - -   -- - -- -     --                --
-  -      -  -- - -     - -    -         -    - ---    -   ---    -  -   -- - -   -  -   -    -    -
--  -   -- - -     - -   -  -- -  -- - --     -    ---    --      - -   -       -     --   -  -    -
-     -        -- -- - - --       -  -    ----   --  -  -  -    -    -    --  -   -       - --  ----
-     - -    -- --  - -     -- -- -  - -  -  --   -    -- --     -  -         --      -   - - --   -
-- -- - - --  -  -  - - - - ---   -  - -   -     -     - -      -- -   - -    - - -     -   - -  ---
-  -  -         -  -    -- -   -- -   -           -    - ---    - - - -       --- -  -  -   -  -   -
-        -  ----     --     -  -   - - -    -     -   - - -       -    ----         - -  -         -
-     -       -  --       -- -   -     --   -   -  ---     --     -- -- --  -  -    ----  -  --   --
-    -  - -  -   -  -    --     - -- -    -      -   -    --    - -   -    --  -- -- --  -  -   -- -
--         -   -    -      -- - -       -  -       ---- -  --    -     -             -  -  - -- -  -
- -- - -  -         -- - -  ---   -   - -         -     -- -  --     - - - -- - -- -             - -
-- - -      -      -   -      - --           - - -   --             - - - -     ---  -       ----  -
-   -    - -  --  -     --   - -     - -   ----     -   -      - - --        -    -    --  -   -   -
- - -         --   -    --         - -   - - - ---  --- --- ---       -   - -   - -       --- -    -
- -  -    -          -      -      --    --      --  -- --    --  ----  -         -  - - -  --     -
- -      -  -  -  - -   - - --    -  -  -  -             -   -  -     --  - --      -    --  -  -  -
-  --   - -     - -   -       -  -  -     -   ---   -    -         -      - -- -   -        -      -
--- -- --       -   -    -  - ---  -    -- --  -   - --  -                -- - - - - ----   - -- ---
-   - - - -  -   - --        -    -        -  - - - -     --   --     - -      -- --    -    -     -
-     -       ----  -   -  --   ---   -- -  - -                      -- - - - -   -     --  ---  ---
-   --        -   - - --     - -    -        --  - --- -     -    --      -     -- -   -        -  -
-   --- -- - - -  -  - -      - -    -- -       - -   -             --  -  -- - -         -  --  ---
-      --   -   -   --      -    -    -   --- -           -  ---- - - - - - - -    - ---        -  -
-       -   -     -   - --- -   - -   - -    -  - --- -  -    -      --        --        -   -  - --
--  -  ---    ---     - - - - ---  --   -    -  -    --   -   -          -       -    -        -   -
-- ---          - - -      -    - - -    -   - -    -     ---  - -                 - -  -  --   -- -
-     -   -    -  - -- - -    -  -       - --  --    - --     -    - -   -   -         -          --
- -  --     --      -  -- - -  -  -   -      -      --  -     ----     --   --   -- -- - - -     - -
-       - -     - --     --  -   - - - - -   --   -  - -    -     -  --  -       - - -  - -   -  - -
- - -  -   - -     -   - --    ---      - -  -  -     -     -- - -      -   -  -     - -           -
-       - -  -   -  -  -  -  - -   - -- -  -   - -  -  -   --  - -- -      --        -   --    -  --
-   - -    - -   --- --     --    --  -  -     --- -     - - -     --   -  -  -- ---   --       -  -
-   - -            -   --- -      -  -   ---    -     -   -   -  --     -  -   --    -  -    --    -
--- -    -   -  -   -   - - -   -  -      --   -    --     -  -  --    -      -      -----    --- --
-      -      - -   -- -     -     --- -  --- --    -  - - - -- -   --   ---   --     -  - - - -   -
-    - -  - -       - -    - -  --   -  -   -       - -- -    - ----   -      -     -    -    -    -
----------------------------------------------------------------------------------------------------
