100
100
----------------------------------------------------------------------------------------------------
-  -           - --          - -          ---   -     -        -   - --  -    -  -     -    - ---  -
--      --- -    -   - -   - -  -  -   -    -   -- --    - -      -    -     - -             -  -  -
-    --     -  -  --- - --           - -    -- - -  - - -         -   --  -       -           -- - -
-  - -- -   -    -   -  - -   -     -  -         ---  - --   --   - -   -   -- --  --  - -- -      -
---        - -   -    --  -  ---  - -      - -  -   -   - - -- - - -- - -    ---               -   -
-   --  ---    ------   --  - - -  -- -  -          -     --   --  - - -    --    - - -  - - - -   -
-  -   -   ---   ------  -   -       - -    -       -- -- -      - -   --  -  -  -   --   -  -     -
-  --  --   -   -  -  -   - -    --  - --  - - - -   -   - -  ---   -    -  -- -   -   - - -     - -
---  -      -       --   -   -        -  ---  -     --     ---      -      - -     - -    - -- --  -
-  -   -  -  -      - --  - -  -          -- -  -  --   - -   - --        -   -   - - -   - --    --
-  -     -    -    --    -                    -      --     - -  -  -- - -  -   -  -- - -     -- - -
-  -     -    -   -  - -- ----- -   -- ---  ---  - -  - - -     -----  -   -    --- -- -   -   -   -
-  -- --   -   - -  - -  -  -  -    -   -        - -     - --  -     -   --   -  -    - - - --  -  -
-   - -     - -- -- -   - -       -     ----      - -   -    -   --     -    -      --      - -  - -
-   - ---    -  --     --  -      -      -  - -   - -   -   -  --              - -   --    - - --  -
-     -      --  ----    - - -      - --     - -      -   -  - -  -     -   -     -----      -     -
-   --    --    - -     -   ---        - -             -- --       - ---- -   - -   -   -       -  -
--- -   -  - - - --    - -- -   --  - -   -  -  - -       -     --  -    -     --     -- -- -     --
-  -      -      -   --      ---  -      -  -    -     -  -- -   - --  -  - --       - - -  - -  - -
--    ---     --    -   --      -- -   - - - - -  -      -- -   -   - -     -  - -   -   ----      -
- - --    --   ---       - --   - -   -- -   -- -   -- --  -       -     -  - -  -           --  - -
--   --  - -   -   -  - - -  -    - -   --- -  -    -  -    -    -   --         - -- -      - -  - -
-- -  --  -    - --- -  -    -     - -              - - --     - -      -  - -      -  --      -   -
- - - - -- --     - -     -   --   --     -    - --  --  -- - -            - -- -    -- --        --
--  -- ---   ---     - --  ----   --   --  -        - -   -       -  -    --   -           -      --
-  -  -        - -  - -   -      -- -  - -  --   -   -   - -    -   - -       -      - -    -   -  -
-  -- -    --   -     -   -- --  -- -- -    - -    -      -    -            -  - -  - -- -  -    - -
-- -   --   -     -   - -  - -   -  -      ---           - -    -      - --  -  -     -          ---
-   -  -      -  -        ----   - - -  - -      --- -     - - -        - -  - -   -   - -  -  --  -
-- -     -  --  - -- - -     --- -     ---            --  -      -     -    -  -    - -   -  --    -
-   - - - -   -   -- -         -     ---  -      -   -  --    -          - -- --      -     - - -  -
-  -  -   -      - -   - -  --- - -                -- -   -   - - -  --  --   --    -    -         -
-   --      -- --- -    -  -  - -- - -- -  ---    --   -- - --     - - -- ---   -  -  - -   -- -   -
-   -   -- -          -          - - --       -  -   - - --       -   - -   -  - - - -       - -  --
- -   -  -- -  - -   -   ------ - --     --  - - - -- -   -- -- -    - -- -   ----   - --     -  - -
-   -  --   -     -  --   -      -  -   -        -  - --      -  --  - - - -     -  -        -  -  -
-     -   --   --       -    -- -        - --  -     - - - -    -  -              --  -            -
- -     -   - ---- --   -   - -   - -  --      -    -    - ---  -   - --- --- - --- -    -         -
- -  --     -  - - --    -     -- --- - - - -- - -   -     -       -        --      -   - -   -    -
-   -   - -     -      -  - --  - - - -- -     -  - -   -   -    -            -   -    - -  -  - - -
-- ----   - - -    -    -     --     -  - -   - -  -    -          --- ---   -            -- -     -
- -     --   -      -   - -      - -   --- --  -    -      -  -        -       -- -  -  -       -  -
- -       -     --   - --- --     -      --  - -   -          -- -  - --    -    -   -    - -     --
-   - - -  -  -- - --       -      --       -  -    - --   --  -  -      - -  - - -      --    - - -
- - -      --              - --    -    -    -  -  - -     -  -     - --   --     - - - -- -       -
- --      -  -- -   -     --- -  --  -  - -   -     -  - --      -       -        -  --      - -   -
-    --  - -          ---    -  -  -- --- -- -- --       -   --  - -   - - - -    --  - -   -  -   -
--  - -     - - -   --  - -            -   -   -   -   -    -   -- -    -   -  --            -- ----
-        -- -     -   -    -     - -- -  -  -   -- -  - -     -   --  -    -  -   ------   -  -    -
-   ---  -  ---          - -    --      - - -- - -       -     -   -- - - ---          - - -    -  -
-   -     -   -  - - -      - - -       --    --   ------ -               -     -  --  -   -  -  - -
-   ---      -  -  - -  --  --      -      -- -      - -    -- --   -     -  -   -       -    - -  -
-  -       --- - --- --    -  -- --        -- -    -  --  -  -       - --  - - - ----  -      - -- -
- - -  -- -   - - -  - --     --    -        ---- -  -- -  --     -   -  --    --    - -       -  --
- --        --          - -     - -   -   --     -  - - --  - -      -    - -- -  - - -  -         -
-- --    -  -    ----- - -     -  - --   --   -  - - - -     -- ----- -- -  - -          ---   -   -
-    -  -    -  -     -  -  -    -- -   --    - -  -    - -   -      -     -- -  --   -      ---   -
- -     ---        -          ---  - - -   - -   - -- -  -  -     - - -     -    -  -  --- -    -- -
- - -           -- - -   - -    -  - -         -   -        - -   - - -   -    -  -          -     -
- -- - --    --  - -    -   --  - - - -      --- -   - - - -   -  - -  - --  ---   - -  -  -    -- -
-    -         -  -  - -  - -  --  -              -- -     --- -  - --          --  - - -          -
-- -- ---     -  - - -     -- -  -   -- - - -- -      -         -          -----     --     -      -
-    - - --         - - -  -  -    - -    -             -  - -  ----   -              -    --      -
- - -- -      - -        -  -          ---   -     --  --     -  - -       -   -        --    - -  -
- -      - -               - --   -        -      -  -    -    -   -    - -  --   -     -  --  - - -
-  --  -- -    - -     --   --   -  -----  --- -- -- -  - - - -     ----      ---  -   -     - -- --
- -- -     --    - - --   -            ----       - -  -     -    -     - -   -  -  -- -    -      -
- - --  -  -  ---   -   -     -  - -- - - - -   --  - -       - --  ----  - -    -    -      -  -  -
- -  - -    - --  -- --  - -  -  - -  - -- -         --   -     -   -  -- --    -   -  -- -        -
- --    -  -   -     - --  - --- ---          -- ---    -   -    -      -    -  - -   - --    --   -
-    --  -        -       -      - -   -  - --   -   -     -   -  - -    -     - - --  -  -  -   - -
-         -   -   -- ---          --   -  -    --    -  -  - -  -- -       - -     ---        -   --
- - -  ---        --- - -  -  -- - -    -  ---  - - - --     -    -     -- -   -      -    -    -  -
-  --            -    -     - - -     -         - -- --  ---  - -- --       - --     -   - -       -
-   -   -- -- --  ---  -   -  -  --  - -  - -   -   -   --          - -         -    -  -     - -- -
- - - - -  - - -     -  -       -      -----  --  ---   -   ---   -          - -     --- -- -      -
- -       -- --  --           -  --  --  -  -     --              ----- -  --  -       --- ------  -
-- --    -    -   - --  -   - --- -    --  -   - -- -    -- - -- -   -  - -   -- -   -    -  -   ---
-     --   -            -   -- -   -     - -- -     -- -  - - -  - -    --    -    --  - -    --- --
-    -  - -- - - -   -   -  -- -  -  -  --    -  --   --             -     -        -    -         -
-       -        -  -       -  -    -  -    -         -    - -    -   - --   --    -     -    --   -
- -   -  -    -  -   --  -   - - -  - --      - -   -- - -        -          - --       - --    -  -
- -    -  ---         --   - - --  - -  - -    ---   -        -     - --   ---     -    -   -    - -
- -- -        -  -   -    - -  -   -- -- - --        - --   -- -    - -   -  -  - - -        - -   -
- -     -       -  -    -    --       -        ---  -        -  - -       --  - -    --      -     -
-    -     - - -     -  -   -          -    -      -    -     -          -      - -       - --  -  -
-         -    - -        - -   --  - -      -- - -      --   -  -    -   -   -     -  -- -  --   --
--- - -   --- - -  -   - -        -- -   -  - -   -  -- -    -         -    --  -  -- -    -- - -  -
-   -  -      - - -  - -    -  -  -  -    -  ---      -  --- -   - -       --- -  -  - ---  -   -  -
-  -   -     -     -    -    -  --- - - -  - -- -    -    - -  -   - - - -     - - -  -  - --  -   -
- -   -    -     -       - - --  -   -   - ---  -- -- -  - --      -    -        - -  ----  ---  - -
-     - --  -   -    --     - -   --    - -   -  --  --   -  -- -     --  -    - -    - - -      - -
-  --- -  -  - - --- -- -     -   ---- -     ---       -- --- -   --         -  -   --- - - --   - -
-   - -       -- -   --    - - -    - -- --- -    -  -  - -     -   -      --      - - -   -  -    -
--- - --  --   -   -    - -  -       -     - -            - --     - - ---  - ---       - -    -  --
-- -        - -  -  -    -   - - -  -  - --- -- -    -          - -  --      --  -    -  - --- -   -
-  -- --      -  --  - - -              --      -          - -      --   - - -    - --  -     -  - -
-        --        --    -   -  -     -   --        -     -                  -   -    --   -   -   -
----------------------------------------------------------------------------------------------------
