100
100
----------------------------------------------------------------------------------------------------
-  -                  - -- - -   -  -    - -  -       -- -   --- -   -    - - -- -   -  - -    -   -
---  ---  ----  --        - - -     -  -    - --   -   -     -  -      -  --         - -       -   -
-   -  -    --    -   -- -- -    - - - --         -    -    - -   -- -   -  ---   --    --  -      -
-  - -          ---  -  - - -    -  -  -- --- -  - ---- - -   -  -  -  - --- ---    --         --  -
- - -  -  -  -  - -    -   -- -  ------  --     - -     --   -----   -     --   - -    ----  -   - -
- -      -- -     - -- --       -       - - -         - -   --    --  --   - --- - - -            --
- - - -    -             --    -  ---  --  - - -  --  -                      -   - -- ---    -  -- -
-   --   -      - -     -        -           - --   -  -            --    --   -     -   -- -      -
--   - - ---- - -      -- --              -       - ---   -  ---             -   -  --- -- -    -  -
--  -  --   -  - -   -   -- -   ----     --    -       --       -  --  - -- - -   -   -   --  -    -
-  - - - --    - -- -    - - --   - - - --    -    -   --  -      -     ---  -  - --  -        -   -
-  - - - -   -          -   -   -- ---     -   -- --     - - -  - -    -  - -  ---   --- -  --     -
-    -     --     -   --     - -       - - -           - -       -   --   -- -    -  - - - - --    -
-          -    -  -- - --       -    - -- --    - -- ---- - ---   -        -             -   -- - -
-            -                 -  --  -  --     - -   --  --       -       -      -      -   - - - -
- - -- --   - - -   --    --       - - - -       -              --  -     - -  - -      -   -  -  --
-     --    - -            -  -        -     - -    -   - --     - - -  -    -     -- - -   - -  - -
--         -     -  - --  -         --      -            -  --     - -----  - --       -       -   -
-   -    - - -      - ----    -- -          -    -     --- -    - -  -   -   - --  --  -- -        -
-- --   -    - -  -     --      - ---- -  -  -     -    - - ----   --    - -   -- -  -         -  --
-      - --  - - -        -  -   -  - - -       -      -  -- -          -    -   -   -  -  --   -  -
-     -   -     -   - -- - -  -    -     -     -   -  --  - -  -       - -- --     -    -     -  - -
-  -  - - -  ---    --    - -  ---- -     --   - - -       --     --  -- --  -        -  - -- - - --
-- -  - - --      -     -         -    -       ----    -       -        -    -    - --   --   -- ---
-            -  -            -    -   -    -   - -  -   -  - -- --           --       --  -   -   --
-  ---  ---  -    ----  -   -    -      -   --- -  -  - -  -       - - -  --   --  ---   -   ----  -
-      -  - - -  -  - - ---- ---  -- -  - -- - -        -   -   -   -     -       -- --- ---     - -
-        -            -  --      - - --  --- --    -  - ---  -  -  -  -     --- - -     -    ---   -
-  - -     -  - -  -  - - --  ---- -   --    - - -- - - -    - -   -  -       -  - -      - -   -  -
-  --       -        -     - - - -- -   --- - -  --    -         - -  --- -  -- -  - - ---         -
-       --   --  -   -   -  -   - -   ----  -       - -    ---    -          -    -- -        --  --
- - - -    -   -  -       -      -      -        -   --    -    --  ----  -   ----  --          -  -
-- ---  --    - -  -  - --  -    --- ---   -       --          --- --             -- -  --  -- - - -
-     --    -  -     - -- -      -- -        -  -  - -   - -          - - -    -             - -- --
- -     --  -   -   - - -  - -  - - ----          -                - - -         - - -      --- -  -
-     -    -    -- -  - -- - -      ---   -   --- - - -   -      -  - - -  -         -  ---  --    -
-  -    - -       -   - -        -- -   - -     ---               - - -- -     --   --     - -  -- -
-  - -- -  - - -      --   - -- -    -    --         -- -  - ---   -       - -  -         --       -
-  -      - --      --   -  -      - - -    -      -       -    -     - - - -- - --- --  -  -- - - -
-    -- -   -    - -  -   -- - --      -   - -- --   --  - ---    ----   -     - -  -  -   -  -  - -
-   -    --    -   -  -  -  -  --- -    -   -     -        - --  -     - - - - -  -    -        -  -
- --   --     -     - -- -             -   -   --- -   -     --  -  ------     - -   -    -   --   -
-  --   -       - -    -      -- -   -           -  - -    - -    -- - - -  --  - ----    - -      -
- -            -- --    -  --           -  -- -      -   -                 -  -       - - - - - -- -
--     --- -    - -    -   -  -  -      - -    --       -- - -  --  ---   - -    - -               -
- -     -   -       - -  - -         --   - --       -          - -- -    - -      --- --- - -  -- -
-     -             - - - - ---  - --   ---   -    -         - --   -   - -     -     -- -      -- -
-       -- -   - -   - -    -   -    - - - - -- --  - - -    -    -    -          ---      - - -   -
- --      - --  -  - ---     - --  - -            --   -    - -   -    -   -      -  - -     -   - -
-       - -     --      -  -         -      -        -   - -   - - - -- -   - - --  --     -  - -- -
-   -  -   --  - -   -- --- -      --    -    ---   -     --  -  --   -- -       -- -  -    --- - --
- - -   --- -  -  - -  -  - -        -      -         -      - -    - - -     --     - -   --      -
-   -    --    --             -  -     --   - --  - -   - --  -    -       -  -            -   -   -
----  --   ---  - --- -    ---       -   -  -    -      -   -   - -    -  - -  -    ---       - -- -
- -  - --    -- - ---     -  -  -     --  -  ----     --  --  -   -- -        -   --   -   -  - -- -
--   -  -   -  -      -  -        -   --  -       - -                 -  - ---  -    -         -   -
-     -- -     - -       --                -  -   -    - --   ---  -   --        --- - -   --  --  -
-      ---    -      --        --- - --   -          -           --        -   --   -     -- -   ---
-     -- - -  --       ---       -  -   -  -   - -      -   -   -  -    - -   -   -   --   -  ---  -
-  -   -  -    -        --     -  -- - -  -               -           -- - --    -   -        -    -
- -      - - --  --   -   -   -- -       - -    ----  ---   -    -  -   ---      - -   -    -  --  -
-     -  -  -  -  -   --    - -   -    -  -      -  -    --    -   -   --   -     -  -   -- -- -   -
-   -   -- - -   -  --     -  -- --   - --     - -  - - -     --   --   -   ---  - --      - -   - -
-- - -   -  -   -  --   ---   - -       - ---   -    -      -  -        - -     -   -  - -    - -  -
-   --   -   -  - -  -   - -   -   - -  -- --  - ---  -   -  -- -- - -    - -     ---    -    -   --
-  -   ---   - -- ---- - -   - - -       --           -   -   --   -   -   -    - -  --        -   -
-    - -   - -   ---- -  -- - - - -         - -       -     --  --  -     -   -  - -    --  - - -  -
-- --   - - -  -     -  ---  --      - -    -      -      -       -- -       - -   - - ---- - -   --
- --   -    -   - -   - --      - -   -     -   -         -     --  -        --    -- --   --    - -
- -  -    --   -- -     -     -         -       --           - - --  -   - -   -      - -        ---
---   - ---  -   -  -  -  -    -  ---   -   -  -        --     --   -     -  --    --      -  -   --
-   - -  -  - -      --    --- -    -  - - - -        -    -        -  -  - -- -        -   --  - --
--   -   -     --- -     -     ---   - --  - -    -   -- -  -  ---   -  - -- -  -       - - --   - -
--          --               -  -- -   -    - - -   -   -    -- --    - -  -    -      - -  -    - -
-  -  -    -      --- -  - --    - --  -   -         ---  -  --     --   -     -      --     -  - --
- -    -  - --   - -  --- -   -      -              -       -  - -- - -     --       -  -      -   -
-  -    -   - ---      -  --  - -   - -    ---      --- - - - -- - - -- ---         -- -  - -  - - -
- - -- --    - --- -    -  - -    --      - - - -      --      ----          --    -   ----   --   -
-         - -  -     -   ---  --    --- -           ---  - - --   - --  -       ---         -      -
- -       - -  - - -  - -        --- -  --      -     -    -      - -     -      -  --             -
- -  -   -    -    - -       -    -   -   - -   -    --   -   -    -    -      - ----  - - --     --
-     -      -  - -  - -  --  - -  -    --     - - -   -   --  - -     - - - -- --- -     -  ---  --
- --     - -   - -      -   ------     ---   -- -    -      - -  -  ---- - - --    -----    -  -  --
--  - ----   -  ---       - --      --          --- - -- --     -     -       -  -    -      - -  --
- -  -          - -        -    - -     ---    -     -    - - - -   -- --   -   -  - -   --- -    --
-      --- --    -    - - - --- -   --- - -  - -   -   -    - ---- -  - --  -    -     -       -  --
-    -     - - -  -  -   -    --  -   -    -     -- --- --       -    -    -- -- -   -   -  ---    -
-- -    - -   - -  -    - --    -  -  -     - -   --     --- - -      ---      - --     -  - - --  -
-     -  -   -   --- --   -  - -       --  -   -        --        - -   -         -    -  --      --
-   --     --   -          -- -  --   -  ----- -      --  -    -   -        --     - -  -    -- - --
- -   -  --  - --- -    ---    -  -  ---  -     --   -  -    -    -- -- ---     ----  -       --   -
-   ----  --  -     -  -    - -- -         - -- - - - - - -- - --         -               ----  -  -
-  - -        - --   --  - - --  -     -  -      - - -                -       -       - -- -- -   --
-  - -     - - - - --   -  -- --        -     - -   ---     ---  -       -- - -- -  ---  -   -- - --
- -   -   -   -   --      - - --   ---   -- -      -    -- -     - - -      -    -   -     -  -  - -
-  -  -- -- -    -  ---     -   - -    -    ---   -- --   -     -  --   -   -- - --   -         -  -
-  --   -        -   -   -     -    -  - -      --   -  - --   -   -        - -    - -   --    - ---
-     ------ -- - -        - -  -    -  ---- --  - -   -   - -    -     --   --   -      -  - - -  -
----------------------------------------------------------------------------------------------------
