100
100
----------------------------------------------------------------------------------------------------
-          -        --  - -  - -   -- -       - -      -  -       - -   -      - --  -  --         -
-  -   ---         -  -    -   -     - - --          - --  -    -    - - - - --- -             - - -
--  ---     -     -- -    -  --    --- -  -       -   -  -   -   --- -   -  -     -  - ---   - --  -
-    -      - -  - --  - - - -  -   - --      --   -------      -     -    - -    -       -- -   - -
---    -- - -   --  - --- - - -          -- --    -    -  - -  -      -    -  -   - --- -  -  -    -
-  - --  -          --     --   --       -    -- -  ---   -      -   -             - --  --   - -- -
--   -  - - -     -- - -  - --   - ---- - -   - --  --   - -            - -    -  ---  -  -- -     -
-   - ---   -  -          -    - -  --- -   -  -  - -  - -    -- -  -   -- - - -       -- -  ---- --
- -    - -   - -    -      --  - - --- - -            -       -        -       -   -   - -      -  -
---    - -    - - - -    -        - -   - - -    -   -    -      -    ----   -   -   -   -  - -   --
-          --    ----   -  -  --     ---  -    - --      -     -- --- --    -  - -   -  - -  - - - -
---           --    - --     --   -        -      - -     -     --    -    -  --          ---  -  --
--  - -   -   -  --  -   -- - -     -    -  -      ---  ---   - - --     - -    -         --   -  --
-    - -   --     ------- - -  --- --- - -   - -      -     -  - ----- -         --   -- - -- - -  -
-     ----    -       -   - - -  -  - -  --       - - -  -----      -             -    --      -   -
--    -        --   - -     -    --      - -     -         -   -- -    -    --   -          -  - - -
-- - - - --   -  -  -  -  -  -  - -      - - -            -- - -    -   -   - -    - - --       -  -
- - - --     -     - --    --     -  ----     -    -    -      -        -     - - -  -     -    -  -
- - - - -   -- -  - -      - - - -        -- -- -         -   -- --   -        --      -    -  - - -
-    -- -   -            -   -       --- -         -     -- -  ---        - --      -         --   -
- --  - -     -  - - -  -   -  - -- - -- - - -- -     -    -   -  --   --     --     - -    - - -  -
-      -  -    - - -          -  -- -  --  -    - -   -- -  -   -    -- --   -    --   -      -  - -
- --     --   -  -----  - --      -- - - -  -    -  -  - --   - - -         -      ---  --   - --  -
--     -     - -   --    -  - -           - -      - -    -  -  - -         -  -        -  -  -    -
-   -- -    -  -      - -    -  ---    -    -    - --       -        --      -  -     - -  -  -  - -
--     -        - --     ---          - -                    --- --     - -  -  -  -     -     -   -
-           - --      -     -   -    -  -      -      -  ----            -   -  -   - -    ----  - -
-         -  -    -  ----  -   -    -  -- -    - -   -     -  -       - - -- -        -  --    -  --
-   --               -      -    -  -      - --     -   -   -  ------     -      -   -     -  -  - -
-- --  - -   -     --    ---  -    --  -- - -      --   - -  -    -    -     --- -       -  -  -   -
-          -    -- ---   -  - -  -  --     -  -    -- -     - --     -- - --  -- -   - - -  -      -
-   -  -          -  -  - -        -      ----     -   - - -      -    --     --   -  -    -   --  -
-  -   -  -     -    -  -       -  --- - - - --   - -     --   -      --  -     --       - -- - -- -
-  - -    -              - - --      -    -  -   -  - -   -    ---    -    --- -  --  -   -        -
-  -- --- -   -              ---  - -          - - -      --  -  - -- -       - -   - -    - --    -
-      - -               - - -    -   - -    -    -- -   -     -  -      - --  -  -   -- ---     - -
- - -          -- - -  -- -  --- -   -  -  -  --  -      -      -  -      -                 -    - -
-  -     -   -      --   -       -----   --         -     - --    ---     - -      -   -- -   -- - -
-   -                - -- - - --       --     --       -   - -   -     -- - -- ---    -     --   - -
- - -  --  --  -   -  - - - - -  - -      -  -    --          - --   -    - --      -   -- -- -    -
- - -    - -     - -  - - - -      - --- -  -- ---     - -- -          --      -  -       - -  -- --
-       -   --         -  -- -- -- ---     -      -         -        --   -   ---  --  -- -        -
--- -    -  -   --      -- -    ---  -  -   -- - -     ---    - -  -     - -     --  -   -         -
-  - -    -   - -  -   -  - --      -    -     --   -- -    ---   -- -   - - -- -  -       -    -- -
-- -      -   -  - -         -    - --    -   -       - --   -  -   -  -    -  -       - -         -
-  -  -  -     - -       --    -    --  ----   - - -  --   - -    -     -  - -   -  - -   -  --    -
-       -  ---- -  -       - - - --    -   - --  - -   - - -    -  -  -- -   -     - -  -    -     -
-   - -----  -    -  -  -  -                --    - -      - - -- - -  -  - -     -         -      -
-  --    - -   -    - -- --    -   -- - - -  -       --   -      -  --  -   -  ---- -       -- -  --
---  -   --        -  - -      --   - -        - - -----     -   -        - -           --  ---   --
-   ---     -   --    --      --   -  - -   -      -  -  -  -   -  --  - -          - -    -       -
- --   --- - - -  ---       - - -  -  -  -   - -    --   -    -   -  -    - -      - --        -   -
-        -  --- - --     - -- - - ---  -   -     --- -   - --- -   ---  ---   - - --     -  -      -
-      --      -     - - -  --    -  -     -    -    - --          -   -  --   --    -    -     -  -
-    - -    ---    -  - --   - ---         -    -     ----- -           ---  -- - --- -   - -- -  --
- - --  -      --  -    --    - -  - --    --   --    - - ---- - - -   -    - - -     - - -    -   -
--- - - - -   --   -   -  --   - - - - -     --- - - -     -- ---  --- - -   - -   -       --   -- -
-        -- --  --    -  -    - - - -  -- -   -      -                 -  - - ---- - - -- -   -    -
---   -        - -      - -  - --                    - -   -   - -    -    - -   -  -  -         - -
- - -    -         -    -  -       -- --   -   -  -  -     -     -- --        --   -  --  -   - -  -
-    -  -    -- --    -      -    -    --   - -   -       - --          -   - --   - --  --        -
-- -      - --   - --  -- -    - -         - -  -  -   -   ---     ---  --- - - - - -  -     -   - -
-- --   - - - -   - --   - -  -      - - -  ---   -  --                -  -- -  -  ---          - --
- -  -      --   -  -  -   - - - --       -   -   --    - - ---  -   -           -   -      - -    -
-- -  -         ---  --  -        --  - -       -  -- - - --      -   -  -- --  -  -  ---  -   --- -
-   --  - -        -      - --- - -  ---  - - -   -       -  - ---   - - ----   -  --   -  -     - -
--  -  -  -   -       - -    -  -   - -    -  --     -      -   --   -- -  - --  -     - -- -   -  -
- - -   --- -      - - - ---  --- -- -  - -     - ---   -       -    -       -  ---  -            --
-  -- --    -     -     -   --    -   - -     ----    -     ---     -   -     -   -   -  --   --   -
-  -   -  - -   -            - - -- --    -      -     --      - -    -    - - - -      --   -  -  -
-  - -        -    --    -     -      - -    -  --- -    - - --  ---- -- - - -- -  -    - -- - -  --
-   --- --    -  -      -  --  -     -  -     -    -  -- --   - --   -  -          -     - - -     -
- -   --   --      --  -      --  -       -  - --- --- - - - - -   - -- --  --   -   --       -    -
-    - - -          -       -   -  --  - -- ---  -     - -        --  -  -      -   --    - --   - -
- --  -      -   - - -     -  ---       -       --  -    - ---       - -- -- - - -    - -  -       -
- -    -   -       --        - - -        ---- -  - -- --     -    - - --   -  --          -   -- --
--   - -  - - -   -  -    -   -   -   ---     -        -  -- -  - - -       - -- -     -      -    -
-- -  -   -     -  -   -    - - ---      -  -      -   -  - - -      -   -  - - -    -   ----  -----
--  ----      ---    -       -  --     --  -  -  - - - ---  -   - -   -   - -  -  - - -    ---- -  -
-- -     - - -   - -  ----   -   -   --  -- --    -  --      -     ---   - --             -    -   -
-   - -- ---  ---  -    - -  - -   -  ---   - - --      --  -- ---   --          - - - --          -
-- -    -        -    -   -- -   -        -  -   --      -     -   -  -      - - -   --   -    - ---
--  -  - ----   -     - -- --- ---   -  -   -   -  - -  - -    -        - --         - --   -    ---
--    --  -- -- -                -  -  - - - -       -   -- --     -          --   -   -         ---
-  - -  - -    --         -      - --    - -  -   -        - -- - -  ----    --- - -   -   -- -  ---
-  - -- -  -    -- - ---     -    - - -  -   - -- -  - -  -   -   --    - --  -    - -      --  - --
-            --         - - -  -                - -       -    - - - -   --          --  -         -
-    -- --      ---- - -  -   -    -    - --- --     -     -   - - -  ---    -    -     -      -  --
-  -  - -    -       - - -    - -  -        -- -   - -    - - -    ---   -- ------             - - -
-  -- -  - --- -         -     -    -  - -  - -    - --  -    -   --   -- --    -   -  -    - -    -
-    - -      - -           - --- -       -      --    -    ---     --   - -  -   --   --   --    --
-- --- -       - ------     - -  -   -  -- --   -   - -  - -  - -      - -    -- -   -    - - - -  -
-    - - -  ----      -  - -    --  - -  - -    -   --  - -   --    -   - --     - - --    -    -  -
- --   - --    - -- -    -       -- --   -  --  -- -  - - -       --        - -  ---          - - --
-   --  --   -      --   -   - - - -  -  - - - - --  - - - - --    - -----    -  -   -  ---  -     -
-  -  -  -   -     - -  --    -- -  --  --    - --   -  -- -        -                -   - --    - -
-    -   -      -  -        ---       -     - -     -        -  - -  -  --   -   - -       - -  -- -
-   -        -       -  ---           -   -  -   -  -              -   -              ---      -   -
----------------------------------------------------------------------------------------------------
