100
100
----------------------------------------------------------------------------------------------------
-              -                     - -  -       -   -    -  -           -- -       -  - --       -
-- ---   --  -    ---- - ----- --   - --   -   --      - -- -  --- -     -   -    -   --- - --- -  -
-  -        ----  - --   -      - - -      -  - -- -    - -             ---  -     -   - -  -   -  -
- -    --    -  -   -  -- -- -     - -  -- --  -       ---  -- -       -    -  -- -       -     -  -
-  -   -    -   -        -      -   -  - - - -      -       -     -   -- -   -    - - --  ----     -
-- -  --  - -     - -      -   -   -           -  -   -      - -     - -     -- --       -  - -  - -
-- -            - - -    - --      -  - -   -   -     -   -- -  -   - - -  - -     ---    - -  -  --
- - -- -     -  - -  -- -  -- -- -  - - -- -            -          -     - ---  -   -   -   -  -   -
-- -         -  -- -  -         - --  -         -   --       ----  - - --     -   -  -    -     - --
-     ---  -    -    -  -  --  - -    - --- - -  ---    - --        --    -   -  -  -  -           -
- -  - - -           --  -  -   -  -   -        -   -- -- - - --  -    -     -- -   -- -- --- -  ---
-        - -   ----  - -  - ---- -  - -       - -   -        -    -  -    --           -      ---  -
-   -    -        -   --   -- --  - -     -           -  -- -  -  - --  -     -  -----  --        --
-  -           -         -   -    -    --      -         - -   -   -        --  -   -- -   -    -- -
---  --     -   --    -  - --- - - -    -  -      -  -     -        ---- ---   --  -- -  --        -
-  -     -  -   - -  - -    -  - -    ---  -  - -  - -      -         ---- - - -- -       -- -- -  -
- - --  -   -  - -   -   -   -  -       -      ---   -    - -   ----      - -  -  -   -  -         -
- --  -   -  ---  --   - --         -        - -           -      -- -          -        --        -
--  --- - --     -  -- - --- - -----  - -----   - - -  ---   -   -   -  ---      -    -- -  --    --
-  -      --  --- - - -  -  - -   --- - -  -  --  - --    - -   - -  ----  - -  -  -   - -  -  - - -
--    -   -- --          ---  -     --     - - -   -   --  -              --- -  -         -   -  --
-       -      -  --   -        -    ----   --  - --   - - -  - --- - -- -  - --  - --   -     --  -
----  --           --  -  -    - -       -  --   -  -    -- - -    ---   --  -       - - - - -- -  -
- - -   -    - -  - ---   --                  -   --  ---      - --    --- - - -        -        - -
-  -  -  -- - --    -  ---       --      -- -   ---  -   -    -  -  ----    -- --  ---  --  -- -   -
-  -  -              -     -       --  - -   --      -- -  - --    -  -        - -     - -   -   - -
--  - -        - --  - --   - -- -- -   - - ------ -   - --     --     - --   --- --  -   --      --
- -   -  - --       -  -  --   -   - - - -           ---    -   -  -- - ----       -   -   --   -  -
- -  -     - -   - -   -- --    - -         -    -----   - --         - ---  -  --   --          - -
-    --    -- -      -  - -  - -       - -  -  - --  - - -- -  -- - - - -   - -- - -  - --   -- -  -
-  --  - -      - --   -   --   -      --     -    --  -   -          --  - -   -    - - -         -
- -  - --  - --- -  -    -- -   --- -- -   --    --     -  --  -       -    - --   -  -    - -     -
- ---            ---  -   - -  -        -           - -  -  -    - -  - - - -   --       -   --    -
-  -  -      --   -         --       -            - -  -   - -               --        --    -- -  -
--- -   -    -- -  - - -- --   -     - ---   -     - - - -         - --  --      ---     -  ---    -
-  - -   -   --    -- -   --   - - --   --       -  -      --  -  -     -            ---  -      - -
- - -         - - - -           -   - -      ---  -       --   -   -   -- -- - -   --  ---  -- -   -
-   --   -      - -- - -- -     - - - -      --   -- -     - -  --   --  -          ---  --     -- -
--    -- -   ---   --  -   - ---  -   -    - --       -  -  -- -    ---     - -  -  -       -  -   -
-   -      -  --  -  --             --   - -  -    -- - --     -       - -         -  -   -   -    -
- -  -      -   -  -    -   - -    --   -- - -         -  -- -  --     -  ---           - -     -  -
- -  - - ---     -  - -  -  --  -  - -     - - --  -           --      --  -   -    -- - -     -   -
--  -   -- -       -  -        - - -  -  -  --  -- - - -  --  -    -           - -     -----    ----
-   - -    --    -- --  -  -   - - -    -    - -    -  -   -     -  ----  -     -    -  - - -    - -
-  - - -  -    -  -      -       -         ---   -       ---   - -  --  --             -  --    -  -
-- --   ----  -   --- ---              -       --   -         - -     -- -            -    -   -- --
-  -- - -    - - -   -  -     - - - -   -    -    -   - --- ----    -   --  --    -   -  - - - --  -
-    ---      - -    - -- -      - ---   --  -- -     -   ---  ---  - --- -- - -    - -  -----     -
--    -         -   - -  - - -- -  -  --    -      -  - -  - -     -    ---- -   -    - --      -  -
-     -         -   - -        - -      -  --          -        - - -  -  -      -     -  -  -  -  -
-   -    --  -     -  - -    - -    --- - -  -    -- -      -  -   -     -      -  -- -  -   - -  --
-   -            -    ---    -  -- -     -   - --       - - -   - - --  -   -     - - - -   -  -   -
--  -    -      ---   -  -    ---  -   -   - -   - - -  -  --   - --      -  --   -   -   -  -  - --
-- -      -       - -   -   -    -    -   -- -      --          -   -- -- -     - -     -- ---- -  -
-   --  --   -  -          --   - -      --  -   -   -      --   - - -     ---     -    -       - --
-   --    -        -     -  -         - - - -   -     -         - - -   -       - - ---  -- -    - -
--    -     -  -      -    ---    - --     -  - -  - - -   - ---   - -     - -   --     -   - -- - -
--  --     - - --- -   -       -  --- -   -  ---  -- - - -       -   - ---    --  ----  --     -  --
-  - -      -    - -  -- -  - -  -    - -   - ---   - --    - -- -  -      - -   -   ---- -        -
--  -  - -        - -       -      -       - -      ---   -     - -- ---  -  - -  --  - -   --  -  -
- -       -  -        -   -- -- - -   - - -  ---   -       -   -  - -     -  - -   ---      -      -
-  -    - -  -  - -           -  -- ---- -  -      -   ---   --    - - --  - - -   -- ---  --   -  -
-- -  - --   - - - - -   -  ---      -     - -  -  -           - -   - -- - -       -           -  -
--        - -      - -    -- -   -     -- -   -- -   -  -   -   - -  -     - -      -- --  ----   --
- - -  - -    -  --  -    -   -   -    -    --          -        -     ---   -  - -- - -         - -
- -      --        - -  --      -   -        -   -    -      --  --- - -   - - -   - -       - -  --
- -   - -  ----  - -     - - -  -   -  - -  -      --   --       - -- - --       -    --- --   --  -
- - - -  -        -  -  --- -  -   - ---  -   - -- -- -- - - -- -      - --    -   --  -      -   --
-  -      -  -  -   - -     -       -  - -      --  --      -      -    --    - -        -   -     -
-    --       --               --      - - ---- -  -    -   -       -          --    - --        - -
-    -       -  -    - --       -   - - ---    -  - ---      - -- - -     - - -   -   -   --- -    -
- - - -          --  - --         -   -  ---    --     -  - -   - --  - --  -   -  -   --    - --  -
- -  -  --                 - -  -      -  -       - - --    -      -       - -              -      -
--- --     ---  -     -   -   - - -  ---   -     -      -    -   -      - --        -         ---  -
-        - -- -         --    -         -        -   - --        -----    -  -  - -  -  -  -    -- -
-   --        - -  -   -  -   - --- -  - -   -      -  -      --           -     - - --   - -  --- -
----  -   -- -  -  -  - ----  -     -      -    -   -           -- -       -        -    - -       -
----- -   - -   -     -   -   -  -      -    -  -     - -- -- -    -       - -  -- - -      -- --- -
-     -  --     -- - -  - -  -      - -   -  -      - -- - -   -      -- -      -      - --  --    -
----   - -- - - -     -    -    ---   -       -   --    -  -  -      -   -   -  -  -   - - -    -  -
-    --    -       - -  -   -        -   - -- -          --       --   -   -  - -          - - - ---
- - -          -  -   --  -      ---  - -    - -  --- -    -    - - -           --  ---    -   -  --
- - -  - --  -  - - -   -  -- --   -  ---  -  - - ---  --           - - -- -  --     --  -      -  -
-  - - - -        -    - -   - -    -- -     --- -         ----     - -- -    -  -  - -      ---- --
-  --  --  -    -      -  --   -  - -    -- -     -  -   -         -- -  -           -  --        --
-  -  -  --  - -   -    -    - ---     -  --   -- - - -- --    - -   --    - -      -      --   -  -
-  --  --        --  --   --   -  -- -   --   -  -    - - --              - -      - --- -       - -
- -    - -   - -    -  - -  - --     -    -  -       - -          - -   -  -  -   - -   --    -    -
-   -- - - - -   -  - --     -- ----    -----  -        -  --                -  - - --  -       -  -
-  -   -- -- - - --  --       - -   -  -       ---  -  - - -      --   -  - -    -        -- -- ----
-    --  -  -     -  - -- -  -      - -       -   -    - -  - -          -   - - - -     -         -
- --- --   -    - -   -  - -       -    -  --   --   -     -    - - - --   -       -  -- -    -    -
- - -          - -      --    -  -   - -  - -   --     - - - -   -       -  --   - ---   - -       -
- -  -   -    -     -  -  --- ---     - - - - --  --     - -  -- - - -     -        --  - -       --
-  - -  --   -  -    -       -     -    - - - - -     -      -  - -   -  - -   -           -   --  -
-                - -- --   -   -  - --   ---       --  ---        - -- - --  -       -- --         -
-   --   --       -     - -  -    - -  -  -  -- -  -  -   -  ---    --  -       -  -- --   -  ---- -
-     --     -  -   -  -       -        - - -  -      - -    -   -         -- -         -    -     -
----------------------------------------------------------------------------------------------------
