100
100
----------------------------------------------------------------------------------------------------
-             --    - ---    -    - - -     -       -  --   -       -   - -      --- --     -      -
-   -       - - ---     -   -  --   -    -   -    -   -  ---  -----   -       -  --  -    --- - -  -
---    -   - - -  -- -    - -  -     -      - - - - -  --   - -    - ---      -  ---        - - ----
-  -  ----  -  ---    -- --     -    --    - --  - - -      --  -        -  -   -- --      --  -----
- - -  ---  - -  - -    -     --- -   -   -     -    - -  --  -    ---        -  -  - -       -    -
-         -    --       -                 -   - - -      - -- - --   -    -        -- -  -  --- ----
--   --  -   ---  - -  --- --             - -  --        -      -  -   --         --- - -  -       -
- --       --     -  -   -  --   -- --   - -       -       --- -   - - ---    - --    -   - -   - --
--- - - -    ---  -- -      -      -  -- - -       -  -  -        - -   - --    -  -- -  --     - --
- -- -   -- -  -  -  -- ----        -   -   -  -   -       -  - -  -    - --  -         -     -- - -
- - -     - - -- -- -            -   - - --     -  -    -   -  -  --- - - - -    -- - -    - -  -  -
-  -  ----     --     ---- -- -    -  ---    ------ -  - -  - -      - --  ---- -  -     - -- --- --
- --  - - -    -   --    - -   -  -    -     -         -   - --    - -     - -- --        - -      -
-       -  --       -   --   ---  -- ---  -     -     -- --       -   -  - -   -  -  -    -      - -
- -  - -  - -  -  --   -        -          - --       -   -  --  - - - - -   -  --          -      -
- - -   -- ---   -   - - - ---   -    --       - -- -   --    --     - -   -  -    -      --- -- - -
- -  -         --  - -  -   - -   --    -            -- - -  -  --  -    - -        --      -   -  -
- -   --     -    --  --  --  -   -  - - -          --  - -  -    - - -  -  - -       - --- - -    -
- -   - -- -  ----    -   -            -          -  -   -      -- -     -   -  --   --      -   ---
-   --       --  - ----     - -     - - -       -   - --  --   -    - --   -   -      -    --   -  -
--      - --    --  -           - - -      -- -- -        ----     --    --   -  -    - - -  -   ---
-        - -  -       -  -  -   -        -   - -  -            -- -  - --   --  - - - - -- --    - -
--   -       - - - - -   -  -  -         - --  -   -    -    --       -            -         -     -
-     - - -       -                  -- --     -     - -   -- -    -- - -  -       -     -    -    -
-   -   - - - -  -     -  -  -   -   -  - -   - --     - -   -   -    - ---- - --  - - ----- --    -
- - -  -- ----          - -  -     -        -  - -    -    --   -   -      - - -  - -  --       - --
-    -    -    ---      -  ---  -   -       - -  - --  -   - - ---  -    - --  -             -  -  -
-   -  -    --  -       -  - --             - -   -     -   - -     -  -  - -  -        --- -  -   -
- -  - - -    --  - -    --    -           --   -      -             - -    -  --        -  -     --
-       -   - --   -   --  - --    -     -      - -  - -     - -  -          -    --   -   --      -
-  - ---    -     -- -  -- - -         --  -            - -          -    -  ----    - -- -   -  - -
-  -       -    - -  -   -    - --  - -   -   --  -     -  - -       -- -  --   - -   -     -    - -
-  -- - - --    -  - -   --  -    --- --- -     - ---- -- - -- - -    - - - -        - -- --   - - -
- -  --  - -    -- -  - -       -      --     -    -- -   -  -  -   -     - -  -                  --
-  -   - - -  -- - -           -   -  --- -     -     - - -  -      -      --- - --   ---  -   -   -
-      -  -     -      - -   - -      -      --  ----  ----    - - -     -- -  -   - -   -   ---   -
--- - - -    -  -  -   - --  - - --  -  - -- -        -    --- - - - --     - --    -   --   -  -  -
-  -    --   -   -      -    - -    - -           -   - - -         - - - -        --     --- --   -
-     -  - -  --  -   - -   -   -  -     -   ---   -   --   ---      -  - -  -- --     - -  --   ---
-    - -   - --     - - -   -    -   - -  -- -  - -   -    -     -    -- -    - - - - --      --- --
-  -   - - -   - --    -  -  ---   --  --- -   -        -  -   -  -   - -- -  - -     -  - - -    --
-    -  --  -    -  --  --  - --        -   - - -    - --   -      -     -  -     --  -- ---    - --
-    -  - -- -    --      -       -     -- -     -----    -  - -- -       -  ---      -            -
-  -  -     -   -     -         - --   -  -   -   ----  -     -       -   -     -  --   -     -  ---
-    -     ----  --   -     -       -         - - -- - -- - -            -    -      -    - -      -
-   -  -     -    - -         -  - -    -  --    -       -        -- -     -    -    -      --    --
-   -   -  --  --    -    -   -  --   -- --        -- -  --   -          -    -    -  --  - - - -  -
- --   -  -      ---  - -    -     -       -   -   -    -      - -     -  - - --- --   ---  - - -  -
- -      --    - -  - - --      - - -          - -       -- -- --  -- --    -  - -  --     -    -- -
-      - -  --    - -  -   -         -   - -       --  --     -    -  -- --   -   --   --  -      --
-     -      - -- -    -    -  -   - ---- - -    -  --   - - -   --     --      -  - -   - -    -  -
- -   -  --   -- - ---      -- -  -  -   -   -   -     -- - -- - -  - --     --  --  -    -      ---
-   - - -   -    --   --         -- -       -   -    -- --    - -  --   - -- ---   -- -- --        -
-- -     -  - ---  --           -  -   ---            -- ---- --      - - -          -  --     --  -
- -       -- -    -  - --               -             - -    --       - -     -   --     ---   - - -
-  -  -  --  - -  - -   -  - -  -    --- -   -   -  - - --         --      - - -   ---  -  - - -   -
-  -   --     -  - -     - -            - -     -     --  - - -  --   -  -      -      -     - - - -
- ---  -  -- -  - - --  - -    - -    -      -     -  -- -           - -- -- - --   - - --  -  --  -
-  --  -   -  -- -    - --  - -- -    -  - - --  - - --  - -  -   --        -    -    -   --- -    -
-  -  -  - - -             --  - --   - -    --    --      -   - -    --  - -  - -     -  -    -   -
-- --      -       -  -  -   -   -  -  - -  -   -    -  --  --       -     -- ------  -  - -   -   -
--   -     -      --  -   -  -        - --      -   -         - -   - -     --     -  -  -  -      -
- --      - --  ---      --     -  - -  -   -       -     --  - - -  --    -     -     -   - -     -
- -- -  -    -          -  ---       -  - -- -         -   -  ----       - -  - - - - -- --     ----
--- - -    - -    ----          --- - -     ---- -  --- -- -       -        ---   -- --    - -  -  -
-     -- - --      -    ----   -   -                        -   --- ---           --    -     -  - -
- - -- --         -              -  --   -   --   -    - -   -- -- -    ---     - -  --    - ---   -
-  --   - --           -    - - - --    - -  --  - - -      -  -  - -    -       -- -       -   -  -
-     -       -      --      - - -- --- - - -        - -  - - - -- -   -     -- - -  - -           -
-        -        --  - -  -  - -   -     -  - -- - - -    -    -    --       --  -      -        --
-  -   -   -   -   -     -    - -- - -   -   - - - --     -  - -       --    -   -      -     - -  -
-  -   -  -         - --- -   - -      -  - - - - - --  -  - -   -   -        -  -  - -    -       -
- -    -  - -      - - -  -   -       -    --  -  ---  -        --  -   --- -  -     - -   --    - -
- - -- -- --    -   -  ---      -   - -  -  ----     - -    -      ---           -   -    -     -  -
-  -         - -   - -      - --   --    ---  -- - --- --   -  -- - -- -   -   --  --   -  - --- - -
- -   -       -- -     --  ---- -      -    - -- -  -       - -  - -       -   -  - -      --   -- -
-      -         - -  --  -  - --  -   ---      -  ---  -    - ---       -    -  - - -- - -  -    --
- -    -   -      -     -          - -       -- --       - - --     -       -    -       - -  - -  -
-    -  -  -      -   -  - --     -  -   -          ---     -  ---   --- -        - -  --        - -
- - --      -   -      - - -     - --- -    --  --- -  - --   -    -       - - ---  --  -    - -   -
- -    - - -       - --     --    --   -  -   - -  - -  -   --       -  -             --  -    - - -
-     - --   - --  --  - -    - -    -    - --  -  -   -  -- --  -  -      -               -     - -
- -   - - -- -   -           -- ----    --   - -   -   -  -     -    -   -   -   - -    --        --
- ---  - - -   -  -     --   -         -- ---   ---    -    -    --- -     -  -   - - -    - ---   -
-  - -       - - --   - -    -  -  - --- -       - -   - - -       --  -  - -  -    --    -    -   -
-         -    -  ----   -  -     -     -     -  -   --       -   -  ---        - - -  -   - - -   -
--  -     -   -   - - -     ---   -    --      -  ---      - -    - -  -     -    -           -    -
-    --- - - - -- -  -    - -    -- -      - -        -   -  - -  -- --     --            ---     --
- -       - -      ---- -  - --     ---  -        --  -    -- -              - --  - -    - ---  - -
-  -- ---  -      - -  -- -    -    -      -      - -   --    --    -         -- -    -  -   -- - --
- -    -- --        -  -- - - -  - -   - - - -  --   - -  -  -   -  -   - -   --- -  -  -     ---- -
- -- - --  -     -  -   - -  --  -   - -- - -  -     -         - -  ---     ---     - ---- ---  - --
--- - -- - -              -     -  - -   -- -    --     --     -   - -- -   -  -  - - - --        --
- -  - - -       -           -  -- - -    --   -- --      -   --  - -    --   --   -   - -- -   -- -
- -   -   -   - --      -     -- --    ---   -       --     -     -   --    - --  ---   -      -   -
-                     -       - -   -    -      - --  - - -    -   - - -    - -   -  --- - -    -  -
- --   -  - -   --    -     - ---       - -  -   -        --  - --  ---  -   - - -      - -    -   -
-   --      -  -   - -      -    -- -    -  -   -   -     -   - -     -  - - - --   - -         -- -
----------------------------------------------------------------------------------------------------
