100
100
----------------------------------------------------------------------------------------------------
-   ----  --   -     -- -     -  --           -     -  -      -            -          -     -    - -
-   -     -- --  -   -   ----  --  - -  -    -       -     -     ---    - - -- --              -  --
-  --       --    --  -        -  --   - -   - -   -       -  -- -   -  -----    ---- - - - -- --- -
--   ---       --   -    - -- - --  ---            --        - -  -   -         -    -           ---
-   -   -- --      -- ---   --     -   ---     -    - --- --     -     -  -  -   - --   --  -      -
- - - -      -     -     - -  -    -- --      -   -   -       --     --    -  -    -      -      - -
-  -    --- -   - -  -- - -   --     -   -     -   - - -   -            - -  -     - - --    - -   -
-     - - -  -- - -      -    -      -    -- -     -    - -  ---    - -   -- --   -             -  -
---   ---  -   -- -         -   - --   -   - - -  --  - --  --         -    -   -   --      - -    -
- - -  - -   -            - - -  -   - -            -- -   -   - - -    --   --        - --  -- -  -
-  - - - - -    -    -  ----  -    -     -   - -     - -                  - -   --- --- -    - -   -
- -    -    -  -   -     - ---    -  -   --         - - --      -     -    -  - -  -    -    -    --
-   ---  -  -    -    -   - - - - --     - - -             -- -      -  -     -    -     --     -  -
--   -       - -   --- --       - - -- - --- -  - -        -  --- -     - -    - -  --    - ---- - -
-  -    -  ----  --    -   -     -  - -  -        --- - -              -  ----- - --    --      -  -
-     -- -    -    --  -       -  -   --   --  --     -  - -  - --  -                - ----  -  - --
-    -  --    -        ---  - - -- -   -  -      -  --   -  -- - --- -  - ----    -  --     --  ----
- -          -    -     -      -      - -   - ---   - -        -   -    -  -   -  -   - --- -    - -
- ---  -  -- -    -            - ---- - -   -    - -  --         - - -   -- -          -  -- -  - --
-        --    -  --    - ----     -   -  - ---  ----  -  -     -      -       -   -    -- - -   - -
-- --   -      --  -   -     -- -   - -- -    -   -  --   -        ---               - - - -  -  - -
-      - -  --    ---     -  -    -  -       -  -  -   -   -  -   -       - --  ---  -       -     -
-   - --       -   - ------ -   - - -    --  - --    -    - --         -       -     - --   ---   --
-         -  -   - - - -       -    -    -     -- -    -  -   - --      --   --  ---  - --  -  -   -
-       - -  -     - -     - -     -    -    -  -- -     -  - - -  -- -- - -   ---- - -  -    -  ---
----   --     -         - -     --   -  - -  - -   - ---       - -- - - -  -  -   - - --   ---  -  -
-   -     - - - --- -         -   ----  --  -  --   -        - -  --      -        -   - -    -   --
-  - - --      -   --   -     -       --  - -     - -           - -    -   -     --  -   -  --     -
-    -        -  -     -  --  - - -  -  -- - -  -  -     ------ ----          -    --    -    - -  -
- - -  -        -  --   -  --       --         -     --- -  - -         -   - -  ----- -  -- -  -  -
-         - - ---    -  - -   --  -          -    -    -  --      -  -  ---  - --     -  --  -  -  -
--    -  -  -      -     - -   -  -         - -       - -  -        - - - - --   -       - --  -   -
-     -      - --    - -      -    -    - -   -- -- -  -  ---- -  -   - --   --- -                 -
--   -  - --   -  ---- --        ---          - -- -   -    -         - - --      -   -- - - - -   -
-   -  -     -- -   --- - -- -        -- - --        - - --   -- --   -   -  ----- -  -    -   - - -
- - - - -  -- -  --  -  - -  -    -            - -  -  --     -- --      -    -   - -  - -    ---- -
- -  -       - - -         -     -    -   -  - - - --  -  -  -      ---     -  -- -   -            -
- --     -   - -   -     --  --       - - -   -- - -     - - - ----    -  -  -- ---    -    -- -- --
-  ----   --  - - -- -         - -- -  -       - -    --  --    -- - - -   --  -  -     - - -  - - -
--  --- --  - -   -                      --- -- -  --  -      -    -     - -   - --   -    - -  -- -
-           --   - -  ---  -   -  ---  - - -    -   --   --  - - --   -    -   --          -    -  -
-- -  -   -  -     - --    - -   -     -     -- -    -    - -   -         -- -     -           -- --
- - -  -- - -  -- - -      -- --   -           --     ---  -- - --- --     -- --- -   -   -      - -
-         - - -  - ---- - - -- -- -- --- -     --           -- - -  ---  ----  --  -  - - -   -    -
-  -   -   - - --- -    -      -         - -      ---    - -   -- -      --  -    - --  --  --     -
-   -   -   -     - - -    -  -     -     --   - -       -  --     -   -   -      - ---   -   -    -
-    -     -  - ---     - - -  ---    ----     --  - -   -    - ---     --       - - -- -     --   -
- -    --            --  - -  -    - -   -  -      --  -  -  --    - --    -  -    -      -   -- - -
- -            -           -- - --- -   - --     --            ----   - -- -      -  --   -- - -   -
- -     -- -- - - -       -- -  - -  ----    ----  --  ---   --    --   --     - -      -  - - -   -
--  - -  -      -   -- - -  -   --  -         -   -        - ---       -  -- -      - -- -  -- -   -
--      -- -    --      --- -    -  -  - --  -             - -    -  -   -      -      - -  - - -- -
-- --     -- -  --   -  -   -- -- -   ---     ---- - - -     -    -- -      -   - -  -- -  -  - - --
-   - - -      - - -         -        -  -   -   -- -  -    -    -    --    - --- -     -    ---   -
-   - -  --- - - -         -    -  --  -  - ----    -- -- -  -  - ---   - -      -  -   -- -     - -
- -   - -   -  -   -  --  -     -         -  -   -   -     - --      -    - -      - -    - - - -  -
- - - --      -- - --  - -   - -    -  - -  - -   -  -   -      --  -   -   ---    -- --- -     -  -
- - - - --- -  - -    --   -  -       -    -    -    --     -      - -     -  - - -- -   -         -
- - - -      -  -  - - -   - - - -     --   - -  --    ---    -      ---     -    -     - -  -     -
-- -     -- -            -  -   -   - -- -      - -   -  -  --- -         -- -           -    -   --
-     -- -- -  --   -     --  - ----        - - - -  ---- -  - --- - -  - -         -  -      ---  -
-  -        -                    --   -  -  - - - -   -    - -- - - --  -   -   ---  -   -   - -  --
-  -     -     - -  -  --    -  --  --     -    -    -     -- -  -      -   -   -  - -    - - -    -
-    - -  -  --      --     -  --    -  -   -   -  --      -- --- -  - -  --     --       - -     --
--      -  - -   -  ----   ---    -    -- - -   --  -  -   -    -   -      -      -     -       -- -
--    -   ---  -----    -  --  -  -        -    - --   -  - - -       --   -  -           ---      -
-    -       - - -  --  --     ---        -         -        -     -   - -   -       -  - -   -- ---
- - -- -  -- -  -  -  -  -  --   -     -- -   -   -     -- -- - - - --       -  - --     -     -- --
- -   -    -- --  -  - - - -   -       - -  - - --  - - -  ---  -- -    - -    - - -  -    -  -  - -
-   - -   -     -  --  -  -     - --  -      - ---    -- --      -            - --     -   ---   ---
-  -  - - - -         -  -  --- - - --  -  ---  - - --- -      --        -  -  -    - -   -        -
-    -  -  - -  - -   - --     - -  -- -  --  -        --  -  - -        -         -        -- --  -
-    - -   - -   -  -      - -     -    --           -   - -- - - -    -  -  -- -  --  -    -  -   -
--   -    -    -    -   -       -    -    --  - -- ----  --   -- - --  -    - -  -- -     - -     --
-    -           -       -    -     --    -- - -  - --      - - -     --      -    - -  -- -       -
-    -      --             - -  --      -       -- - -    - --- - ---- -   -  -              -  -  -
---         -  -    ---   -  -   -          -     -  -  -          -   -     - ---    -     -      -
-  -   - -  - -  -  -    --     - -      -      --  -   -  -      -  - --   - - --   - - -    -    -
--- - -          - -  -  -     -- -   -- -  --  - -   - --    - -  -   - --   --  - - - -  -       -
- -   - -      --    -  - -  -  -- -  -   -     -    -    -  -   --      - -   --   -     -- - -   -
- -   -    -       --  -    --       ---     - -   -    - -   - -   -       --   -        - --  -  -
-- -      -- -- -         - - -   -       - --  -       -   -     -      -         -  --   - - - - -
- -    -   -       - -     --    -              - -      - -----    -     -   ---    - -   -  -    -
- -  -    -     - - ---      ---   ---    ---        ---       -  -  - - -   -   -    - -  -  - - --
- -          -     ---   -  -    -    - -    -     -- -    --  -    -- --     -  -- - - -    -   - -
-   -   - -    -- -      --  -       - -     -  -  - - - -   ---  -- -- --   --   -  -   - -     - -
-   -  -   ---      - - - - -       -      - - - -   -  - - -    -  -    -- -    - -        --  - --
- -     -  -   ----   - - --    -      - -   --- - -  - -  - - -  -  ---       -    -- - -         -
-  - -    - -      -   - -   -- - -- -    -     -       ---     -  --   -   -     -     --  --  -  -
--   - -        -   -- - ---     -   -   -- ---              -    -   -       - -        - -  -    -
- ----     ---     - - -  -   -      -        --- -  - -         - -  -       -  - -  - -       -- -
- -  - -    -   -  -  --- ---   -  -  -       -  -   -- -   -    -  -    - -   -  -   -- --  -     -
-     -     --  -        -        - -  --- --  -         -   -    -  -    -     - -            - - -
--- -  -  - -     -  - -   -- -  - -- -             - -- -  -   -   - -   -  - -            -  -   -
--   -- -         -  -  -    -- - -  - - - - -  -- - - -  -   -  -     -  -  -   -       -   -  -  -
-      -          -  -  ----    -  -   -   --     --  - -   - -         ---          -   -    -  - -
-   -  - - -  --  -         - -    -  -      --       -      -- - --- - -    --      -- -    -     -
-       -  -          ----   -   -- -        -  --     - -                - - -     -     -  --    -
----------------------------------------------------------------------------------------------------
