100
100
----------------------------------------------------------------------------------------------------
- - ---   -        -           -   -- -     - -  -   -    - -     -       - --   -  - - - -  - -   -
-   -      -  -   -     -  -  -       --  -   - - -  -   - -    -- -   --         -   -         -  -
--   -     - -  --- - -            --   --  -   - -   -    -         -    ---     -    -  -    - - -
---    - - - -            -    - ---  ---  - - -   ---- -     ---- -    -    ---  -  -  - -      - -
-   --    - - - ---  -   --  -----       -  -  -- -         --       -- -   -     -    -     --    -
-   -    -     - -      -  -       --    - -     -- - -  -     -       ---    -- -- - -    -- - -  -
- -    -  -     - -   - -  - - -- -   - --     --      - - - - -  --       ---        -  -   -  - --
-  -     --   -  --      -   --      -  -    - - -  --  - - -- -  - -        -- - -     -  ----    -
- -  -   -  -  - -    -    -    --        - --- ---    --    -  --    -   -   - -   -  -      --   -
---  -     -    --  -   -      -    -     -      -        --   -    -   -  -    -  -   - - ---   - -
-- -        -       -    --    - --    -  -       -     - -  - -    - -   -        --    -      -  -
- ---   - -   --- - --    -      --     -  - ----   --     -  - -    ---    -         -     --- -  -
-     -- -    --    - --- -    -    -          --  -   ---  - -     -      -         -- -    -- -  -
-- - -    ---    --   - -   - - -      --  - -       -        - --   ---   -  -   --    -  -  -- - -
--   - -  -    --   -      -  --   -    - - -           - - --     -  -      - -        - -    --  -
-  -  - -  - - - - - -  -    -  -   -    -     - - - - -    -- -  -   - -  --    - --            - -
-      -  -   -    - -       -    -   -- -- --    - -   -  -- - -   - --  -- - - --   - -    -   - -
-    -        - - -   -  - -       -   -- -- --    -        - -     -- - -  - --   --       -     --
-   --      --  --  - -- - -- --   -  -      - --       - - -      -     - -    -- - -    -   ---- -
---   -    -- - -  -     - -- -- - -- ----  - -  -    -- - - - - -     -  -   - -  - ---    -  -   -
-  -- - -      - - --  --    -     -    -  ---  -   - --- -  - -  - -  -               --      -  --
--  --    ---    -  --   - -  --   -     - -  -      --   -   - --          ----  --  - -  -   --  -
-----  - - -   - - -   -  - -       --     -    --  - ---          ---   - - -    -  -       -     -
-        -   - -  -     - --  -     -   - -  -  --      -       -      ---- -       -    - - -- -  -
--- -      -- --     -    - ---    - -             - -         -- -   -     -  -        -         --
-         - - - --      -- - -     -- -  - - --- - -  - --  - - -      --- -     -          -    - -
--   --    --  -  --   -    - --  -   -        -      --  --        -  --- - -  - --- -     --   - -
-     -- ---    -        -   - -  -         - --   --       -   -  - -   - -   -  -    -  -- - -   -
-   - -   -- -   -- -    - -           -         -       --   -  - - -   -  -  -   - --  --- -   - -
-  -    -          --   - -    --   -  -   - -   -- -     - -  -          - - -  ---    -  -   --- -
-   - - -   --   -  - - - - -   -- -  -               --  -   -         --       -     - -   -    --
-   -- - --         - ---  -- -  --     - -  -   - -       -   -  -  - -   -    -  -    -   --  -  -
- -    -  - - -  -  -    -   -     -    - -    -  -  -  --  - -- --  -  -  -        -  -    - -- - -
- -  -   --   -   -   -   - -      -   - - -   -   -         -    --   -        --- -      -    -  -
-   --       - -   - --- ---- ---   - -  -- -   -        -   -----   - --- -   --      --          -
-  -      - -   - -  --   --    - - - - -      - - --  ---      -        - -       -  -   --       -
-    -        -  - -    - - --  -   - -  - -      - -   -      -  -  -      - - - -  -      -   -  -
-        -- - - -   -    -  -- -- -   -    - - -    -- -         --   - -   - - - - -   ---      - -
-  --                 -    - -- -   --  -         -      ---   -  -   - -     ----     - -   - -- --
-  - --      -   -  - -  --       - -     -   -    -  -    -   -  -      ---       --     - --   - -
-   -  - - -        -      ----         -     -       -        -      -   - - - - -  -   -   --  - -
-   - - -   --- -- -   -      -   -   -   --      ----- -- - -   -    - --     - - -  -  -   -   - -
--  -  -- -       - -           --  -    - - --   --  --      -     --- - -  -     -     --  - -   -
- - --   -      -    ---  -   - - -   -    -        -     - -   --   - -  --             -    -    -
-- - - -  --     --                  -- --    -      - -  -        -    -  --            - -  -  - -
- -    - -     ---      -  -   -    - -  -   -           -  - --  - --  -   -- - - ---    - -      -
- -- - - -   --   -      -      -      -  --- -   -        - ----  -   -      - - -    -    - -  ---
-   -- -   -    --  -   -- - ---       - -                 - -     - -    - - - - -  --          - -
-  -  - -  --  - --   --   - -  - -  -  - -  -             -  --        - -- --      -   -   - - - -
--- ---       -   -       -  --- -  -     - -- -  - -  -       --- --  -- -        -     -   ---   -
-   - -  -  ---       -  - -    -- -    - -- -       --  -   -  - - --   - - - -   -  -  - - -  -  -
-   -    --- --     --     -   --                      - --  -  - -     - --- -     ---   - - -    -
--       - - --    - -   - -  - -   --     -  -      -         -       -   -  -    -     - -   - ---
-  ----             -       -- -   -    -     ---- -          -  -     -  -   -   - --      - --   -
-  -  -- -       --   -        - -      - -  --   -     - - -   --             -  -  -   - - -     -
--  -   - -       - -    -  -     --  - --  -  ---   -    -- --       -   -   -  -   -          -  -
- - -  -- -  - -  --     --- --  -    -         - --          - -   ---         -  -   -        -- -
---  --     -   -    -  -  - ---   --  ---     - -         --- - - ---     -  -                   --
-  -    --   -      -   -      --  - -  -    - - -    - - -     -  -  - --    -  -    -     -    - -
-- -          - -        ----    -  -- --     -- --     -  -    -  -  --  ---    - --- -  -        -
- --  -   ---     --           -  - - - - -     - -  - -    -  -       -     -- -  -  -       -  - -
-       --   -      ---- ---         - - -  -  -- --       - -- -- ---   -   - -     ---    --     -
- -        --  -      -         - -     --      -    -      ---      -    -        - - -- --  - -  -
- - -   -- -        --- -       -- -  -  -  ----  - --     -    - - -- -    - -    - --   - --  - --
-    -  -    - -      --   - -- -  -     --- -  -    --            --   -    -   --      -   -    --
-    -      -      -     --    - -      - -  -  -      - - - -    -  -- -- -  -   -- -     -  -- - -
-    - - -  -               - --     -       -  --- -- - -     -  -        ---   -   - -- ---   - --
--    - -    -     -   --    -         - ---- -    -  ---    -        - --            -  -  -  -   -
-  --  - -  --  -           - -- --  -          -      -   - -     -                   -  --     - -
-  - -    - - -     -    -  - -     - -- -- -- -  -   -   - -       -  - - --    -- -   ---  -     -
---    --  -  -   --      --- -    -   - -             -  -   -  -    --      -  - -  -    -   -  --
--   - -- - -   - - -- --    -  ---   -   - --  -  -  --  -     - ---   - -  - - - - --- - - --  - -
-  ---   -  - -  -      -    --   --  -     -       -  - -    ----- - -- -   -  -     -    --   - --
- -      --  --- -  -      -    ---    -- - - - --  -  -     - -       -- -  --     -   -- - -     -
------  - -    - -- - - -    -- -   -   -     - -  -   -   -   -      -      -      - - - - - ---  -
-      --  - --   -  -     --  - -  -  -  - -  -    -- - -  --    -  -     - -  - - - -            -
-- --  -    -  --- -   ---     -- -- -  -- -   -       -      -       -    -  - --   -  - - -  -- --
-            -     ---  - -   -- -- -  -    -        - -  - -   - - -     --       - - -   --      -
- - -      -- -   -   -    --    -      - -    ---      --           -    -    ---  -    - -  -  ---
-   -     -    -  -    ----      --      -  - -      - -        -  --     ---- - -  -- -  - -  -   -
-  -   --  ----    -  -    -- -- -- -  -- - --- -  ----  -  - -     -    -   -- ---  -   -       - -
-      -  - -  --   -  -  -    --               -        -  - - -- - - - - - - - - -- --  -  -  - --
-   - -        - -- --  -- --   - - -- ---     -  -   --  -  -   -   - -         -     -         - -
- - - - -          -- -    -   --  -    -   - - -  -  - --  - -      --  -   -  -    -  -      -   -
-    -      -    - -- -         -   - -- -       -  - - -        -    -         -        -  -    ---
--- -- - -   --    -   -    -  -  -   - -----   - - - - - ---   -    -   -      - --  ---  -       -
-      - -- -    -    --   -- -  -  --- -    -  - - - -   --      - -    -  - --   -   - - -     ---
- ----    -  -   - -  - -      --- -       -  -     -       ----   -- --- -     -  --  -      - -  -
- -  -      - --   -     -     -  -       -  -   -  -  -  -    -  -   -      -        - -- -       -
-- - -        -  - -   --  -     ---      - -  -  - -    -  -      -- --         - - -   -    -    -
- ---   - - -        -      -  --    -   -  - -   -  -      - - -  -    --  - ---      - - -- --   -
- -        -       -    -      - - -    - - -  - -       -  -  -       -        -  - - -- - - -  - -
-  -     -  -     - --          -  -  -- -- --     -  -  -  -  -   --   -       - - -  -    -- --  -
--       -- -   - -      -   -----    - -      - -- -  -  - -     -    - -    - - -  ---- - -  -   -
--  - --   ---- - -  -     -  ---  -    - - --  -    --        -- --    -   -   ---      ---     - -
-    - -   -   -    -    -- --    - -            -  - -- - -    -  -    ---   -   -   - -  --  -   -
-      - - -  - - - -   -  -  --     -   - - -     --   -- -- -   - -- --  -   - -     - -   -     -
-  - -    -  -  -     -   -     -  -   -       -    --       -          - -- -      -  - -  -      -
----------------------------------------------------------------------------------------------------
