100
100
----------------------------------------------------------------------------------------------------
-     -      -  - -     --    --    -        - ---  -  - --   -       -  -    -   - -  -   -  -    -
-      -   -    --   --  -    - -  -        -     --        -        - -  -   - -  -  --    -   -  -
-- ------  -  --       -    -- - -   -                -    - - ---- - -       -    - -  -  -  - -  -
-- --   --  -   --  -   --       - - -   -         -  - -                 - -  -  - -       -      -
- -    -   - -  -   -        - -  --- -    -- -   --    - --    -   - --     -    -   -   - -  --  -
- -   - - -      --   -     -   --       -    - - - - -      -     ---- -- ---   -  -  - - --   -- -
- -       -       -  - -  - - - --    -     ---  - -     - -    --     -        - - -- -- - -      -
-    -----     - ---      -  -  -         --       -  -    --     -- -  -  - --    -  - - -   -  - -
-- -  -  - -  -- -  - -       --   - -  -     -   ---  ----  -  -     - -       -  --       - - -- -
-  -   --- -   - --  -  -    - -           - - -- -----    - -- - -  - --- - ---  -    -      ---- -
-          - -   -  -- -     - -     --    - -  - - -         - -    -     --   - -    -- -       --
-- --  --- -      -   --   - -    -  ----    -   --  -- - -  -- -  - -     - --  -   --  -    -  - -
-             -        - -- -  ---  -   -      -   ---    - -   - -   --- -  -    ---    - - -     -
-     -- - - - --   -   -            --      -- -          - -  -   --     -   -         -   - - - -
-  -     - -       - -  -   -- -      -  --   - -      -       - -  --    -        -  -      - -   -
-    -                 -       -           -  -- -    -  ---- --    -  ---  - - -      ---   -  - --
--          -     -        -- --  --  --   -     --     -         -   - -    -  - - --  -  -     - -
- - -- -  --  ---  - --   -  -        -   ---     - --   - - - --  -  --  -   - -     -  - -     - -
-  -  -  -  -   -     ---       - --   - --        -      -  --  --     -  --    ------ -     -    -
-   - -     -     --      -      -  -    -  - - -  ---     -  ---    - -  -      -     ---    --   -
-   --  - -  --  -   ----  -  - -  --   - --     -      --- --  -  -   -   - - -  -  -- -        - -
---   --     --- -     - --  ----      - --       - -      -  -- --  -  -       -- -       - -     -
-       - ---      - -            --      -    - -  - --- -      -       --- - - -- -   --     --  -
-       -    ----   ---      -         -       - ------  --  --     - - -     -       ---  -- -    -
-   ---   - -    --  -   -  -    --- -    - - - - ---  -        -     -  ---- -   -- -   -    -   --
--    -    - ---- --    -             - - -  -  - -  -  -      -             -    ---   -  -   - - -
- - --   -  -     --              --   - - -   - -   -  --      -   -  -  - -- -       - -    -  - -
--- -  - - --        -- -  ---      - -   - -  -   - -   ---         --   - - -  -- -   -    - -   -
- - -  --  ---- -- -    - -    - -    - ---  -            -           -  -      - - - -  -    --  --
-- - -   -         -       --- --   ---       - ---  - --     ---  -- -      -     - --    - -     -
-    - -     ----   - - - -    --      -  -                -   - -         -  --     -    - -    - -
-  -   -- - -    --    ---  --    -  -  - - -  --  --    -   - - ---     --    - -  -   -     -   --
-  -          -    - -       --         -    -      - - - -      -      -   -- - -  - -   -- - --  -
- -     - -  - -- --   -  -   -   - - -   -   -  -   -      -  -  - - - -  --   --     - -  -  - - -
-          - --    - -  --     -  -    -- -   --  -  --    -    -  -     --   - -            -   - -
-           -  -     -     - -    -          ---         --  -  -  --    - -- - -- -           -   -
-   -   - -   -  -      - ---      -- - -- - - -  -  - - - -  - -  -  -   -- -- - - --   - -  --   -
-  -  ----   - ---- --- -- -   -  -     -- ----   -        -           -    -  -  - -   -    --   --
-  -               --           --         - -      --     -      - -     ----- -      -  -      ---
---   -- -- - - --  - -  -  --  -  -  -- -      ------   -   -- --    - --    - -   -   --- - - -  -
-   - -- -    -   -      -      -   --      - - -    - -   -   - - - -  ----         -    - -   -- -
----  - --    -    - -      - -       -   --   -   -- - -  -  -- - -        -      -   -   -  -    -
- -     - -  -  -    -  -- -        -    - -  -  -  - -   - -    - ---    -     - -  -   - - - -   -
-     - -   - - -  -  -      --    - -   -  -           - -   -     -       -   -   -     - - -  ---
-  -      -      - -  -  - -   -  -  -    -   --  --    -    --  - - -  - -           - -  -- ---  -
--    - -  -  - --- -  -- -     -   -  --- -- -   -   -  -       --  - -- ---  --   - -     ----   -
- -   -  -   -       -    --- -   -- -     -        -      -   -    - -        - -     - -  -   -- -
-    --      -   -      - -    - --   -  -     -  -    - -      --- - -    - - -   -- -   -   --   -
-- -     -  -      - -- ---  -    ----  --    - -  - -- ---   --    -    -     - -- - - --- -    - -
-   -  - -   --        -   -  ---    -  --  -   -- -   -  -   - -  -  -      --      -    - --     -
--    --   -   -- --    --  - --   -      -   -      --- -   --   -  --   -     - - - -  -- - -   --
-         -  -  -                   -   - -- - ---  -           -            -                -    -
-        -    -- - -  -  -   -   -      - - -   -  - -   - - -   --  ------- -  -    --   -   -- - -
--  -  --    - -   -   -   --  -    --  -- - --    -        - --         -  --   -   -      -   -  -
-    - -     -  - -   -       -   -  --- -     -         -     - -   - - - -       -    -  - -  -- -
-   - -     -- -- - -   --   - - - -   -     -    -  ---      -- ---        --  - - -    -         -
-     -     -   -            -    ---       --- --        -    --   -  --  -----    -   -   - -  - -
-    -      - -- -      --   -          - --        -   -  -  -    -      -   -  - -        -  - - -
-   --    -  -- --       --  - - -- --  -   - -- -  - - -   - ---  -   - -   - - -       ---       -
---   - --  - - -   - - -  -     -- -  -   -  - -     --   -  --  --   -  -- -    -- --   - - --  --
-  ---  -  --    -    -   - -  -    -- --    -    -    - -     -   -     -   -        --- -  - --  -
-  --    --   --  - -  - -  - --  - --    ---        -  - -- --- -   -- -      -  - --      -     --
- -     -   - -- -   -   -       -                --    --     - -  -        - - - - -- -    -    --
-- -- -  -      -    -  -- ---- -- -  -  --  - -    - - --  ---   - - -- --  -   -  -   -       - --
- -  -- -  -          --  -    - - - -    -- -     -- -  -                   - --  - ---   - -  -  -
- -   -   -         -- -   -    -       -    --    -      --- --  --       -  -  -  -   -       - --
- - --  -  --          ----   -  --        -     -   -                    -   --- - -       -     --
- -   -  -     ---  ---   - -   -  -- --                -         -  ---   - - -        -  -     - -
-- -    - ---      - -- -- - -   -     --  -    - -  - - - --  -   - -    -- --   -- -     - -   - -
-   - --     -     ---       -      --   -     -      - --   ----     -  --  - -   -   -   - -  -- -
--   -   - -  --     -    -    - ---    - -    - - --              - -- --- -          -    -- - ---
-   -  -      -     -    - - - --    ---   --    - -      -  -             -       -- -    -  -   --
- -- - -   -   -   - --   ---  -  - - - -   -- - ---  -   - -   -  -       -  -  - -   - -       - -
-    --   - --   ---    --- -       --    -  -- -  - -  -  -  ---    -   --- -     -          --   -
-    -   -                 - - -  --- - - --       -  --     -    --           -    --   -  -   -  -
- - -  -  - --     -   ---   -       - - -   -       -     - --  -   -  -     -    - - -- ---      -
-   - - -   -        -     --  -  --   -  -   -  -  ---    --   - -  - -           -  - -   -    - -
---      -- -    -          -- ---   - -                -  - --       -  - --   -  -   -   -   - - -
- -  ---    --   - -     - -- -   --   ---   - - -  -   - - -    -  --  -           - -   -- -     -
- -     -          -  --   - --   - --     -  ---  -    -     -    -   - - -  -    - -   - - --  - -
- - --        - --      - -     - --   --- -     -- ---        -   -- ---   -    --- -   -  -      -
--    -      -  - - ---   -- - - - - -  -      -     -    -      -   - --           -   - -   -- - -
-  -  --   -   - --- -   -         -- -  - -     -   -      -     - -       -        -  - --  --   -
-   -     --        -     -    - --       --   ---  -     -   --     - --- -  - -   -     - -    - -
- --    - -   - -- -    -      -    -   -  -      - -  -     -     - -   -- --   --  ----     -    -
-       - --  ---      -     --      - -  -            ---  -   -- -  -      --    - -   - -       -
- -  - --  -  -     -            -   - -   -  ------ -- ---          -   - -   - -     - -     - - -
-  - -- - - -    -    -  -  - --    -      - -   -   -- -      - - - - -  -  -   -  --       -  -  -
-        - -  --  --      -  --  -    -- -- -      --  - -- --  -  -  -  - -          -  --   --   -
-   -- - --  - -   - --   -   - -  --    --  - -- ---  - -    -   -    - -        -        -  - -- -
- - -    -  -        -  -  - -         -    --         - -- -     -   - -               -          -
-- -  - -           -   --  -    - - - -- -  - -- ---- -     -- - - -    - - -      -      -    -  -
- -  --  -       -   -    -   - -     -   ---    -  -           - - - -        -    -      - -- -  -
-    -   ---- - -     --      - -      -      - ----          -   --         -  -          ---  -  -
-        -   -- -      -        -    -     - - - -    -  -       - -  --       --    -    -   -    -
-  -  -   -        - -  ---- -        - -       - --      -     - - --  ----- -           - --   ---
-  ---                 -    -     --- - - - - --  -   -       -  -  -   -  ---   -  -  -           -
-     ---- -      - -   --    -      -   - --        -      -  - -   -   -   - -    --   -  --     -
----------------------------------------------------------------------------------------------------
