100
100
----------------------------------------------------------------------------------------------------
-       -    --  -     --  -        -   -  --      - -    -  -        - -     -          --        -
--           -    --  -  -    -  ---  -   -  --  -  - -     -  -- - ---   -      - ----  -   -  -  -
-             -    -  -           -  -  --  -    - --        - -  --       -  --       -     ---   -
- - -  --    -  -    -    - - --        ------  -   -        -  -- -      - -   - - -  -- - --   - -
-   ----- --      -   --        -- --     -    -    - --          --- --     --          - --  -- --
- -          - -   -  -  -- - -   - -- --     ----  - -    - - -       -  -          -  -    --    -
-      -    -      - -   - -     -        -    -     -     -       --  - -- -   -   -            - -
-  - --      - --      -       -- ----   -   -        - --    - --       - -   -   -- -   - -   -  -
-    - -   - --   -                - - -- - -    ----- - - --          -   -- -   -  --- - -       -
- -   -- --  ---      - --   --  ---        -     --     --- - -  -  --    -        -- - ---- -   --
- -  -  - -       - --- -       -       -  - - -                -  - -    --  -   -      -       - -
-         - -     -        -- -   -  ---     -- -    -    -       -  ---          -    -       - - -
--   --  ---  -    --- -        - -    --   - -      --        --  -     -   - -  - -   -- -   -   -
-       - --   --     --- -   - -   --    -    --   - -      --      - -        - -- -- -  - -  - --
- --         --   -  -    -     -- --   -            --  -  -       -    -    --          -- - -   -
-     -  ---   ---  - - --   -     - --   - ---    - - -     -  -- -- -    --  -     - -   - -  -- -
--      - --  -   -  -    --  - --- -  - - - -       -     - ------   -      -           -    -    -
-  -  -      -  -   -  -              -        -   - -  -          -    -     - ---           -    -
-    -   ---- --     -  -       --  - -     -  -    - - -  -  -     -   - -  - --  - - ---  - -    -
-  -          -       -- -  - - - -- -- - -   -  - -     ---  -   --  - --  -- -  -  -       -  -- -
- -   -  -     ----- - - -   --  -   - - --- -   -    - - -  --       -   - -    ----     -    - - -
- --  - -     -  -          -     - -   -        - -     - - -  -    - -     -               - -   -
-      -   -  -     --  ----   -    -    -    ----  - -      - -    ----- -     - - -    ---     - -
-- -    --  - -   -      -     - -    -  -   ---     -  -     -             -  -      -    --   - --
-    -   ---  --- -        -- - -  --   -    -  -  - - -  --  - -- -    - --  - --- - --  -- -     -
- -  - - -  --  - -    -   -  -  -   - -  -   - - - - -     - -    - -       -      -  --     --   -
-   - --      ---  - -      - - -    -- -   -        --  - - - --        - - --  ---   - - -      --
--  -     -   - -      -  --       -- -          -- -   --          -  - -     - -  ---  - --- -   -
-  -  --   - - - -  -      ---      -  --  -- - -  - --     -  - -   - - -   -   -   -- --  -      -
---        -       -  -       -     -      -  --    - -     -  - - -  -   ---     - -   - --     - -
-  - ---  - -    ---     - - ----- -  -   - --   --- -  - -            -  -  -    -  --  -   -  - --
- - -- - - -            --  -      -    ---  -   -    -  -    --  - -- -    --  --  --      --  -  -
--   -         ---  - --  -      -  -  -  -       -  -      -   - - - -    -            -- -  - -  -
-- -   -     --      - -   -  -  ---   -   -- - -  -   - --   -      -- --  -       --   --  -    --
-- - -   --              - -       -    - -    --- -  - - -   -    ----      -   -     -   - - - - -
-  -    --    - - -  --    --        -   -  - -        --   - -  -   -   ---- -  - - -- - -- --  ---
-  -  - - -      -- -   --      - --    - - - - ---- -  -- - - - -  -   -  -    -    -    -   ---  -
-  -  -  -  -      - -       -      --      -   --   -   -       --      --  -   --     - --       -
-   -       - ---    -    -- -    -      -- - - - --- -  -- --     - - - -         - --          - -
--  -   - -    -   -   -  - --  --  -- -- -  -   - -   -   - --  --- -- - -    - -     -  -        -
-  - - -         -   - -     - -  - -     --  --   -  -  -         -  --     ---- - -  - -   -  -  -
- -  -     ---- - -   - --      - -   -   -  --   - - -  ---   -       - - - -   --     -  - --  - -
-- - -- - -                - - - -       -   -  -   --- - -      -  --     -   -- -   -   -   ---  -
- -    - -  --     --    -     -- --            - --    -  - ----     -    - --   - -   -       -  -
- -    -     - --   --- -   ---  --   -  --   -          -   -   --          -  --           -     -
-   -   -  - -   --- - ---     -           -    -- -   -             - --  -        -- --   -    - -
--   --   -       -  -   -  -- -- -- - --       -   -  - -  -        -   - -  --- - -   - -    - ---
- ---    --   -        --  --   --          -    - - --  - ---   -  ----  -  -             - -- -  -
-    --              - - -    -- - -           -      - - --    -  -        - - - -  -    ---    - -
-- -  - - -- -     - - -   - --   -   -    --    - - -    -- -     - - --    - - -           -  -  -
--   --    --  -  -            - - -    --    -   -  -- --   - - -  --    -         -  - - -  -    -
-   -   -- --  -     -  -     --       -  -  --            -   - --  -  -   -   - -   - -   - -    -
-   -  -       --          --- -- -            -   -  --   ---  - --     ---- - -     -  - -    - --
--        - - - -  --- ---     - -   -       -- -  -      -     - - ---- -    -      -- - -      - -
- -- -  - -----    -  -   -       -    - -  - --     -      -    -     -    - --      ---      --- -
- - - -  -    -  -   -  -     - -   -   ---  - -- --   - - -   -   - --  -            --   ----   --
- -      - - --    -   - -- -  - - -    - -    -  -  - - -   -  -     -    --       -    --    -  --
--          -  -      --      -      - -   - -   -  -   - - - -   ---     ---  - -- --- - - ---    -
- -           - - -    -- -   -    - - -  -  -   - - -      - -      -  -   -  -       - -    -  - -
-- -  ---  -    - --   -  - --  -       -  -     --    -        - --  --  -    -  -           -    -
- -  -      -   -   --  -        --      - -   -   --  ----      --  - - -    - -      -   -  -   --
-     --    -  -  - - -    - --   --        -   -   -        - -   -    -    --   - - -  - -     - -
-  -        -- ---      -      - - -    - -         - - - - -  -  -  -   -    -  -         - -    --
- - -     -       -- --     -    - -  -  -    -     -      -       -    -- --       -     -   --   -
- -  ---   -- -     --  --     -  -   -   --   --    -     -   -       -    - - --    -  -       ---
- -       - -    -       - --- -   -- - -- -  - - - - -  -  - ---                - --- --- - --   --
- -  -  -   - --    --   - -   -       --  -     --   --  -         -   --- -   ---    --        - -
-    - -     - - -       -- --  --   --     -  - -    -     -- ---      - -       -  - -      -   --
- -  - --     --     - -- - -   ---- -- -  -    --  --- -              -    - - -   - -   --    -- -
--      -          -   - - - -- -   - - - -   -      -  -       -- ---     -  -   --  -     - -    -
-   -   -  -- --         -  --  - --   --        -     -  -  -  - -     - -  -  -  -- -  - -- - - --
- -   - - -     -- -    - -    -    - -       -- --  - --    - -     ----  -   -   -   -   - -     -
- - -  -  --          - --       -              - -    -  -    -    - -       -      - --    - -   -
- -     --  -    -- - -    ---   -  --  --   - -   -    --          -    -  -  - - --- -     --- - -
-  -     -  --   -  - - --  -   -  -    -  -  - -     - -  --  - - -       -    - -   -          - -
-   -  -  -   -  -  -----     -    ---  -  --  -- -   - - -    - --  --- -       --   -  - -   -- --
---- -              -     - -  --  -     -  -  -  - ---      -  -  - -     - - -  - -  --  -   -   -
-    - - - -   -            -     - -- -  -- - -       -   -   --   -     -    -----          - - --
--       -  -  --- - -   - -      --       -  -- -- -  - -    - - -- -  -   - -      - -  -   -- - -
-   -- -           -- ---   -  - -      - -     - ---        - -        -   -  -- -      - --      -
-   -    -  -  -  --       -   --  -   -  -- - ---     - - -   -  -   --      ---  --  -    - - - --
- -     -    -- - -      -   -- -    -  - - - -    -----  - -  -      - -          -- -   -   -    -
-  - - ---  --    - -    -- -  -     -- -    - --  - -  -    -  -   - -   -  -  --    -  -   - -   -
----     - -      - -   ----  --  --  -     - --      -        -  -   -   -- -       -    -   -  - -
-       -  --   -- -  - --   - -     -- -  -    - -     -----  ---  ---  -      --   -    -   -  - -
- --     - -  -        --   -  - -  - --- -  -   -- --  -- -  -    -   -  - -   -- -   -          --
- ---  -  -   - -  - --  -             -- -         -  -    -   --    ---         -  -  --  - --   -
- - - - -    --   -   - - --        --  -   -   - -     - -- - -    -     -  -- -  -        -   -  -
-- -   -     -     --     ----  -  -    - -   - -   -   -- ---       - -   -  -         -    -     -
--  ---   -     -       -   -  -  -  -     - - -         --   -  - -   -           -- -   -- -   ---
- --   -  --      -    -   -     - -- --     -   - --  -   -  -  -  --     -  --     --     -      -
-          --  - -   -  -              - -  - --- - --    -- -       - -      - -       - -      ---
- -    ----       - -- --  - -   - -   - - -           - - --   - -   - -- -   --        - -  -  - -
-- ---- -  - ----- -  -  -    --  -   --       --    - -          -   --   -       -     -    -    -
-   - -         -  --     ---    ---          --  - -      -  - -   -  - ---    -   --   - -       -
-  --         -      -     -    ---    -          --   -  --         -- -  -      -  -  -    - -   -
-      -   -     -   ---  -    -     ----  - - -- -  -       --  - - -       - ---     -  --  -    -
-    - -  -  -      -    -    -    -    -   -- - -     -   -    -   - -       -    -  -     ----   -
----------------------------------------------------------------------------------------------------
