100
100
----------------------------------------------------------------------------------------------------
-  ---   -- -          -  -         -     -   --  -     - - -       - --  -    -            - -    -
-   --     -  ---   -           -- --  --- - -  -- --   -  -    - - -   -       --- --- -     -  ---
-      -  --           -   -     - -      ---      ---       ---- -  -    -   - -  - -    - - --   -
---    -       ----  -     -   -   -   --  - ---       --  -     --  - - -   -  -       -  -       -
- --  - - -  --     -  -  -   -    -        -    ------   -    - - - -  -- -  --                   -
--  -    -  -  -- -  -   -           -   ---  --    -    - -     -    -- - -  -- -   -  --  --- - --
-         - -          - -   -  -   - -  - -   ---        - - - -- --  -     - -    -  -        -  -
-    -   -   -  - ---   -- -  -- -     - -           ---  - -         - - -         - -    -  -    -
-  - -    ------ -    - - -  -  - -- -        -  --- - -  - -    - --  -  --      -       --       -
---  -      -  -   -      -    - -  --  -- - --- -    -    --  -    -   --   -       --    --  -   -
-  -     - -  -- -  -      --    -- --     --- --    - --    ---   -- -- -      ---      -      ----
-     --  -     --   -- --   - -            -  -----     - -  -  --                  ---   --     --
-    -  -  -   -          --  -  -         -      -  -   - - - --          -     ---- -  - - - -  --
- -  -   -   -  -   ---               -  -  -- --   -- -   -    --   - -  --- -    -    --  - -    -
-    --     -  - -     -  -  -    -    -       -  -- -     - --    - -  -  -   -  -       - -      -
-  -- -      -       -  -           -      -  -      --      --  - --  -  - -   - ----  -  -  --   -
- --   -  -   --        -      -- -- -  -   -              -  -      - - -   - - -    -- -- -- -  --
-- -   -     - --       -- -    -  -      --  -        --  --  -- -                  -  - --   -   -
-    - - --     -  ---    -   -  -     -       - - -    - - --       ---   - --   -    -     - --  -
--  -   -  -- -   -     -   -  -  ----  -  -              -- -   ---  - - - -        -        -  - -
--    -   -  --  --   ---    ---         - -     --- -   --- -        - -   -  -   -     -     -   -
-- -  ---  -  ---      -  - - - - - -   - -    -             --  -  -     --  - -    -          - --
-- - - -   ---    -      -   -  -  -     -- -   - - - ---  -      -  -      -- -       -   - -  -  -
-  --  -        -- -- -      - -  - - -      -      - -  -- -  -  - -  -----       --   -   - --  --
-        - --- -    - - --          ---  --      -   -  - -- - - - -  -    -         ---      -  - -
-   --          -   --     - -   --     -- -   -        - --   -      -  --- --   ---   - -   -  - -
- - - -- -- - -  -  - -  - - -  -   - -           -       - -      -         -          -  -  - - --
-  - - --    --  -  - -  --     -    - - --  - -  - -   -  - - -  -  - -  -      - --     -  -   - -
--        - - --    --   - -       - - -    -- -   -         -  - - --  - - -    --- -   -  ---   --
- -  -- -    --   - ----     --    -   - -- --  -    --- -- -- -  -  ----- --- -             - --- -
-    -         -  --    - -   - -   - -       -     --         ----    -    -    ---     -- -- -   -
-   -     -  -   -     -   -      -  -  - -    -        - -  - -- -  - - -              -      - - -
- - - --   -  -    -   - --- - -   -   -   -    ---     -  -   -- --   -   - --  -- -   -          -
-  -   -         -   -      - --    -----  - - --     -- -    -    --      - --    -          -    -
--  --   -           -   --             - -               -  -  -      -- - -    - --      -  -- - -
--      -         -  -         -- -- -    -   -- -   --   -       -  -   - - --  -          --   - -
-   - --  - --  - - - - --  -- -      -- - -        -  --  -   -     -- -    - -   - - - - --  -   -
--    -   -  -  -       -   -   ----     -         --  -     -- -  -  - -    -  -      -       --  -
-- - -  -   -   --   ---      -       - -  -   -   ----       -   - -- -      - -- -   --  -- - - --
--   -   -  - - -    -  - -      -   -   -      -       --      -       -- -- --  -  -        -    -
--           -  - --  -      -   - -      - -     - ----  --   --   -   - -  -   -    ---   -   - --
-- -   -- -  -         -       -   - -  -   ---    -  -  --  --       -  - -  -    - -       -     -
---   -    -        --  -     -     -  --       -    - -  --    - -   - - --- -- -   - - - -     - -
- -   -- -      -      -          - -   - -   -  - --  -  -      --  - -     -    -- - --- ---   - -
-  - -       -  -  --  -  -- -  -- - -         -         -  ---     - -   -  -  -  --- -   --  -   -
-  -- -   -  ---  - -  -- - --          - -  -  -- --            -  -      -  - - -      -    --- --
- --     -      -        --    -  - --           -- -  -  -    -   -    -    -   - --   -  -   -   -
-   -  - -   --   -----  - --  -  -  -- -  -  -- -  -   - -- --   - - - ---     - - -  - ---  -    -
-  - -  - ---   -- - - - -- -     - ---   -   - -      -    -       --        - - -- -      - --- --
--        -   --  -   ---    - ------- -   - -  -- -    -   --  -- -      - - - - -   - -     -    -
-   -----   -   -   -   -                       - -  --  ---     -        -   -  - -    -   -   - --
--               - - - -      -- -   --   -  --  --    -       -   ---            -    -  -   --   -
- -  ---      -   -      --  --   -      - -   ---    ---    -     -       -- --  -  - --  -- ------
-   -                - --   - - - - - -     -  -  ---       - ---  - ---          -     -  - -     -
-      -     -  - -      -      - -  -   -   - -      --        --      --  -  --     -- -    --   -
--  -  -     -  -   - - -       -  -  - -       - -- -    ----        - -     -  -      -   - -    -
-  -   --  -  -      -      -    --  - - -  - --- --  - -     -     --- -               - -    -- --
-  -  --- -  -    - - -  -    -    ---   -  -   - -     ---     -       --- --   -  -  -  - -    - -
- -           --      -  -  - - -     -   -     --  -     -  -    ---  -      -    - - -       - - -
- -  --- -  -  -     -  -  -     -      -   --   -   -    - - -  -     - -  - - - - -- - - - --   --
-   -    -  -   --     -         --   - ----  ---   - -    -  -       -        -         - -   -   -
-    - -  -        -- - - -   - --     -   - -  --   - ----  - -- -  - -----           -  - - -- - -
-   -   - -     -  - -  -    - -  --  --  - -      ----- --   -  -  --- -- -    - -- -   ---   - - -
--    --  --   -      --  ---    -  -  - -   -    -   -  -       --  --  - -     - -  - --         -
-  ---   --  -      -      -     -               -  - -   ---    -- -      - - - -- -      -  -   --
- -  - -- -   ---  - - -  -- -  -     - --   - -  -   -  -   --   -       -   ---  --- - -- -      -
-   - - - ---      -   -  -    -     -       -   -   - --  -    --   - - -          -   -    -  -  -
- --  --  - -    --- -  -- - -   - - -    -    - - - -- -     -   --  - --    -     -     ---  - - -
--- --  - - - - - - -  -  - - -  --   -     -        -     -          - --  --  - - -  - -  - -    -
-    --     - - - - - -                  - -        -  - ---    -  -    ---  - -    -  -         ---
- -     -  -- -  -   -  - -   -     -- -      ---- -       - ---    -    - - -   ---     - -  -   --
- -- -       -- -   -        - - -    - - -  -- -    -       ---   - - -         -     -   -- --   -
-  -  - -       -   - --    -  - --  -- -       -   --   --    --- -  -   - --  - - - - -    -  -  -
-      -  -    -   - -   -   --    -  -   -- --- --      -  --   -  -  -     - --  - - - - -    -- -
-  --- ---   --  --    --     -    --  - -- -  -   -       -  -    -      --   -   -     - --- -   -
-   -     --   -  --          -     -   -         -        -   - -  -- -   - -- - -  -  --- -- -- --
- - --    -  - -       - ---  - -      - -        - - -  -   -  -   -  - - -   - - - -  -  -  -   --
-   -  -    -  - -  -        --    -   -- - -- -  -  - --   -       - -   - -- -          --   -   -
- -- - -  -  -- -  -  -  - --         -         -   --  - -   -  -  -  - -       -    -  -  -    - -
-  - -        - - - -  - -   ---    --  -    --    -     -     -        --       -  -  --         --
- -   --                  -   -    -   -            -   -    - -- -- --- -   --     --  -  -   - - -
--   -   -        - -   - - - -     -- -   -     -- --   -   --     - - -  - -      -  -           -
-      -   -   --  -    -  -          -     --      -- -- --   - -    - - --  --      - - - -  - - -
-       -- -     -  -  - -    -   --   ----     -   -  -- --   -  -   -   - - - - -                -
- -      - -    - - -  - -   -  -   -- -     -   -    -  -     - -  - -  -   --    --  -  ---      -
-      -    -  -   -  - - - -  --    - --- --   -   --  --   -- -  -   -  -  -  -     -- -   - --  -
-  --- -   -   - -- -- --  -   -   - --      -   ---  - ---- - --    -    -   -  -   -             -
--   -     -    -  - - - -  -  - -  -   - - -       --    -    -  --   --     -    -  - -        - -
-    -   ---  --    -- -- --  -    -  - - -     -     - ----   --   - -               -    -       -
-      --        - -  --     -  - - - -  -         --   -     -   -   --   -  --    - --   -   -   -
- -  -- -      -   -          --          - --  - - --    -      -  -   --  --   -- - -- -       - -
--   --        -       --  --     - - - - -   -   - -   -  -- --- --   -   --   --      -   --  -  -
--  -  -  -   -   -          -    -   -   -      - - -  -- - - -- --   --   -  -    -   -  - - - - -
--  -       -  -  -     --  - -  --  -  -    -  -- ---      -   -    -  -  -    -       --  - -- - -
-- - -          -   -       --    - ---    -     -    -  -- - --          - - -     -    -  - - -  -
- -   - - -        -    --      -  --- -     - -  - - -   - -  - -  --   -  -      --   -    -     -
-      -   - ---    -     -   -  -- -   -    - -     - -  -  - -        ---   - - -- -           - -
-    -- -- --  -     -     -      -- -        -- -              - -  -             -  -     --     -
----------------------------------------------------------------------------------------------------
