100
100
----------------------------------------------------------------------------------------------------
-  --  --                    -    --     -      --  -  -     -  - -  -     -  ---     -  - --    - -
--   -     -  -  -- -  - -  -  - -     --       - -- -  -  -   - - -       - -   -     --  - -- - --
--  - -  -- -      -  -          --   -   -- - --     -  --       - -  -      -       -  -    - -- -
-               --- - - -     ----  -     - - -       -- -      --   -       -   - -      -        -
---   --     -- -    --  -        ---  --      -    - - -  -         - -     --      --  -     --  -
-  -- -  - -     -       --  -   -   -            --  ---  -    -            -  -        -        --
-   -  -   ------ -- -     -      -  -   -            -      - -  -- ---      -        --   -  - - -
- -   -      -      - - ----       -  -    -  -  ---     -  -  - -     - -  -  -     -  -  --      -
-     -  - --  -   - -           -- - -   - -   --- - -     -  - - - -  - -  -  - -  --    -   -   -
- ---  - - - -  - - -  --   --      ----      -       -  - - -  -   -  --            - -   - -  -  -
-     -     -  -  - -  --- - -    - --      -  - -        --   - -    - - - -    -  - -  -  -- --- -
--   - -  --     -- -  --   -    -        -  -  - - - --   --   -   -            --    --    -     -
-  -   --   -   - - -   -   --   --  - -  --    - - - -----  --- - - -- -     - ------- - -     -- -
-    -   -   -- ---        -     -   -       -   -- -    -         -  - --  -     -   - - -   - -  -
- -- -    - ---   -  - -    -    -  -  - -  -       - -  -   --  - --     -   ---  -   --    -- -- -
- --     - -    -  -  -   -- -   -- - -- - - - -- -- -   - -   -  ---  ---- --     -       -   - - -
-  -  --- - -- - - ------ --     - --      -  -   -   -- - - -          -     ---   - -  -   --   --
-   - -    -   -   -    -- - -  -     -   - -   --- - - -    -  --  -     -  -     - -     -      --
-         - -     -     - - -   --- - -   - -        -  - - - -   --- --    -  -   --   -  -    -- -
-   - -    - --   --   -  -      -  ---  - -    --   -                 -  --    --    - -     - -- -
--      -  - - -      --- -  -  -         -         -       --  -      ---    - -  --    -- -   -  -
--   - -  - -    - -     --  --     --   -  -   --- -  -  -    --    -     - --        --  -- -- ---
-  -      -  -   -         -   -          -  -      --  -  --     - -  --    - - -      --  -   -- -
- -     --  - -  - - - -- -- -       --                   --    -    --       - - -- - -           -
--   --  -      -     - --      - -    -    ---        --  --      --- - -   -- --      -      --- -
-           -- -     - --     -     ---           -        -   ----  - -  --      -  -     - - -   -
-   -    --  --  - -   - - -- --   -  - -     - -   -   -  -----   -- -          -- -  -   -  - -  -
-  -   -    -       -      --- -   -    -    - - -   -      -    -      -       -   - -      - -   -
--- ---  -   -   - -  -      --  -    - - --   --     --- -- - -       --    -    -  - -  - -- - - -
--    -        -   -       -   - --- -     -       -     -       -- --       - -   - -  -    -   ---
- --    -    --  -  - -    - --- -   -   - - - -     - --    -        --   -   --            - --  -
--   -   -              --   -      -    --     -- - -- - -       -  - --     -       ---  - --   --
-   -  --  -     --    -   -  -   --    -  - - - -- - -   ----    ---  -   - - --    -      -    ---
---  --  -  -  -  -   - - --  -- -   - - - -   - - -   --        -    - - - - -     -   - -- -  -  -
-- --    - - -  -  -               -       --    - - -     -  -  --    --    -- -      -  -  --  - -
-    -   -        - - --   -  -  -      --            --       -      -    - - - - -   - -  -      -
---  - - -    ---  --    - - - -   ---  -     -- --       -  --  ---   -            -   -   - -- ---
-        - -      -       - -- -    ----        -     -     -  -  --         -- -  -  -- -- -      -
-   ---   -   - -  --  ----   --- --     -    - -    - --  - - - - -    -  -  -   --       -   -   -
-   - - -- -    -- ---    -        - --          - -  -     -            --     -    -    -    -   -
-     - ---   -- -  --      -  - -        ----- -    ---   - ---- -   - - - -      -         -     -
-- -  -    -  -          - -  -  -   -   ---   -    -  -  - -     ---  -- -     -    --  --   - -  -
-    - ---          - --        -    - -        --   -  - -    - -  --   --   - --    --     -     -
- -          - -       - -   - -      - -- -      - - -- -   -     -   -    --  - -     - - --   - -
---  -- -    -    -  -      -- --- --- -   -  -  -     - -  -  --    --  -      - - --    -   - -  -
-  --   - --     -   - - -     -  - --   -  -    - - -      -        --       --            --  -  -
-     -     -  - -     -- -- -  ---- -- -    - -   - - -  -- --  - -  - -    - - - -    -  -  -    -
-         -   -- -   --     ---       - -- -     -- -         -  - - -  --  -        -  ---   -   --
- -   ---  --- -   --         -- --        - -   -   -   --  -   - - - -      -- -    -    -  -    -
-     -  -       -   --  -- --  -- --  -  ---     ---      -----   - - -  -       -  -         - ---
--   -  - ---  --  -     - -  --   -- ---   - -    - -     -    -  -   --    - -   -   --  -       -
-    -  -    --  - - - -    -  -   -    - - -     - - -- -  -  -- -     - -          - -       - - -
-   -      -       - - --      -              --       -    --  - -  -  -  -         -    - - ---  -
-      -       -  -                --  -  - -  ----    -    -     -   -   - --  --     --    - -   -
-   -       -- -- -   - -   -   -  -   -     -    --         -- --- ---  -    -   - -- - -  -      -
-   - - -     --  -   -  -   -        -    -      --  --  - -      -    -   --      - -   -     -  -
-  -  -  -  --   -      -  -   -    -    --        ---           ---- -         -    --    -       -
--   -   --  -          -- -        --  -- - -  ---  - -    -     -   -  -   -               - -- --
- - --     -  --- -- ---  -- - - -            -     --   - - -    - - - --  -   -  -    - -  -  - --
- -      - - -     - -  - --- --  - --  -     -   -- -   --   - -    ---    - -    ----- -   --  - -
- -   -- -- -  ----  - - - -    -      -     -     --   - -     --     -    - -        -- -    - - -
--- - -      -          --- -   - -  -  -  -  --    - - -  -   -  - -    -   -     - -    -  -     -
- - --  -  -         -    - - -      -  -    -     -   -  --    -       --    - --      - -- -   - -
-        -      - - --  --   --   - -    -   --        - -    -     -       --- --  -      -  -   --
- ---     ---  -  --  - -- --      -  -   -    -   - -  - - -   - -  -- -  -  -   -- -  --        --
--    -      - --  --    -- - - -  - -   -      ---   -   - -  -   -        -- -     - -   -    - --
-       - - ---    -  -        - -  -   -   -  -       -   - -   -     --   -  -          - -  -   -
--- ---  -          ---     -    -      -   --  -- -- ---  -      ---- - - -  -  -  --  -      -   -
--     - - -      - - - - - -  -   ----   -      -           --          -  - - -  -- -  - -- -   --
- -  -  -   - --   - - ---  -  -  -  -  -   -- -       --- - - -  ---- -  -   -  - -- -- -  -   -- -
- ---    - -     -  -   - -    - -  - -    -   --  -     -   -  -          -       -   -  - -   -  -
-    -      - --  - ---       - ---       --     --- -   - --  -- ---- --      --    --     ---  - -
-      -   -  - - -      - --     - -    -  - - -- --         -    --    - --   --       - -       -
- - -  --  -- -   -  -   -          -   - -  -         --            -       - - - -    -- -  - -  -
--     -- -   - -  - -      -   -   -       -            -   -   - -      -   --     - -          --
- - -  -   -   -  -    -  -      -    -   - - -  --  -      --  - -   - -    -      -- -  -- -  -  -
-    -  --      --  --  -           - - - -  -   -       -  -   -  -    --   -  - -  -   -      -  -
-     -    -  -   -  -   -    -  --   ---   - --  -    -  -       - -   --   -- -      -     ---   -
- --  -    -    -   --      -       --   -   - - -   -        -   - -  --       --         -     ---
--    -  -    -  - - --        - - -        -- - -- - -   -   - -- - -      -         -      -     -
-        -  - -          -        - -    - -  -            -  -    --      -  ---  - --  -      -  -
- -- - -    - - -      - - ---        --         --         - -  --  --- -- --   ----      - -    --
- --             -  --        - --  -   -  -       -  -  -     -   -      -  -         -    - -   --
- -   --  ----  - -  ---  -  -   -        -    -      - -        --   --   -       - -    --   -   -
-  --   - -- -   - --     -  -   --  - -  -  -   -  -      -  - --    -  - -  -  - -   -    -  - ---
--  - -   --      -  - --  --    --  - -  -  --- -    - - -     - -      -      -    -  -    -   - -
- ---  - --    ---- - -  -   -  -       -   -         -- - - - -   --  ---  - - - -   - - -     - --
-     -    -     -  -   -    --- -   - --   --  -  -     - ---       - --     -   -    -   -    -  -
-   -   -         -  -  -- -        - -  --         --    -   - ---- -   --  - -  - -- - -  -      -
-   -- --  --  - - -    -  -    - -     -    -  -- -    -  -        --  -    --  --- --     --     -
- --  -    -         --             - -  -   --   -----  - - - - -   - -   -  -      -  --       - -
-       - -  - --   --        - -       - - -   --  -    -  -  -   -  - - -     ---    -    -     --
- - -      -    -        -      - -  --- --  - -          ---- --   - --   -    - - -      -   -   -
--  - -- -  --      -     -   - -   --          -   -   -  -     - --     -     -   -    -  ---  - -
-   --- -   -     - -        - -  - - -  -- -  - ---         -- - -   - - - -        ---- -- -     -
-   -       -  - -          -   - -  - -  -         ---- - -  ---    - -  - - - - -  -          -  -
- -  -     -  -    -  -   -   -       -  -- --     - -  --    --    -    --     -   - -     ---  - -
- -      -   -  -   - --- - -      -   -  - --     -      -  ---   -   -      - - -       -----  - -
----------------------------------------------------------------------------------------------------
