100
100
----------------------------------------------------------------------------------------------------
-        -      -   -   -           --                --    -    -      - -            - --  -     -
--- -      - -     -    - -   -  -   -    - -    - -      -   -    -- -   -- - --    ----   -     --
- -  -  -      --- - - -     -     - - -      -    - - - -       -  --  - --- -           - --- - --
--  -  --       -     --  - ---   -       -     -   -   - --  ---    -  -    ---   --  -   -   -  --
- - - -   -   --        -         -- -   --  -    --      --     -- -   - -           -  -    - -  -
- - -  -   - -  --      -- -  - -    - ---    -  - - --     -  -          --   -  -  --  --   -- ---
- -           -         -  -   -   -     - - -    -     - --   - -- - -   -  - - -- -           -  -
-- -- -     -   -  --- --   -- -       -     --   --- -     -        -- -   -    -     -  --  -    -
-  -        - -   -   -       -       -     --  -   -    -    -    -     -     -  --       -- - -  -
-    -      --    -  - -    -        -- -  -  -  - - -    - -- -      - -    -   -     --  - - --  -
-    - - - -  -     --   --- -   -      -  ---        -- - -  - -   --  ----  --   - - -  - --  -- -
-     -     --          --  --   - - ---  -        -      --   - --       -- -  --  -    -  - -   --
- - -   - -         - -  -   - -- -  -- - - -    - -- - --          ----          -- - -- -  - -   -
-     -      -- - -- -  --   -  -    -   -        - -      -   --- -       - - ---  -   --         -
-  -  - ---  - --     - -    ---  -  --  - -  -  --   - - - --          -     --- - -   - -  -- - --
-   -   -       -   -      -  -- - -  -    -   -    -  - - -   ---  -- -  ---  -      -     -  -   -
- -     --   ---  -  -  -       -   -    --       - - --- --        - - -- --   -- -     - -   -- --
- --- -       - -  -  -- --     -- -- ---- -   -   -- --  -  - - -- -    --  ---- - - -  --  - --  -
- -  - -  -     --         ---   -   -         -     -   -- --       -        - -     -     ---    -
-- -  -     -  -     ---  --  ---  -- -  -  - -- - --  -  - -      -   - -   -    -  -  -      -   -
- - -  -         - - -         ---  --   --      --     -  --            - --    -  - -  - ----  - -
- - - --      -          -  -      - -     -  -    -   -- -   ---  -  ---- - -      - - - -  -     -
- ----   - --   -  - -  -    -      -     -   ----   -    - -      -       -      -   -        - - -
-        -  -   -      -   -  - -  --- - -  --    -  -    - - - --- --   - - --   -  -  -    - --  -
- -   - -    -   --    -  -- -      - -    - -    -- -  - -     - --       ---  - --- -  -   -    --
- - ---  -     -- -          -    - --   -  - - -  --         -      -- -     -- - -  -    ---    --
-  -        - --- -   -      -     -  ---- - -          --- -  --  -    -    - - -- --  -  -      --
-   -  - -      -        -   -   -            -   -  -            --           -   -   -- -   -    -
- -           --- -  -      - -    --  ---     -  - -- ----- ---- -- -  -  - - -- -  -   -- -     --
-   -  --      -  - -- - -    -   -  -  -- -- --- --  --       - -- --  - -  - -  -   - --   --    -
- --     - --   - - --   ---- - -  -   -      -  -   -  -  -   -     -     - -     --  --    -  -  -
-   --  -      --  -    -    ---    -- -- -  -      -  -  --      -      --  - ---   - - --- --- - -
-   - -  - -     -       -- -   ---        - -- -   - -  -       - - - -     -     - -      -- -   -
-    -  - - -  ---   - -        -   - --  -  -    -  -   -       - -      -       ---   - --     - -
- - ---   -     -    -      -    ---  -           --   - -    -- - - - - -  - -   -  --- - ---- -  -
--         -     - -    -    -  -     -- -- --   - --    -       -  -  - -     -              - -- -
-   -    - -           -   -  -   - -  -         - -   -               -    - -    ------  - -  -  -
-  - -   -       - --          --- - --   ---  -  -   -      - -   --   - -- -       -    -  -     -
- -   -  -- -  -    --  - ---   - --  -  - - -     - -          - -  --      -  --- ---  -  -  -  --
-   -  -   -  -  -      --      -    -    - --   - -   -   -   -   --       - -  - -- -- -      -  -
-    - --   --  -    --  - -- -    ---  - -     --   - - --   --  -   -  --   -      -        -  - -
- ---- -   --   -  - ----   - -    -   -- -- ---      - -  -   - -   -   -  -  -    -   -      - - -
--    -       - -- -     -  --  --- -  -----    -    --   -    -  -      -     -  - -   -  ---  - --
-       -  --  -     - -       -     - -          - -       -     -    -    -   -- - -  -   -      -
----- -  --  ---  - -    -  ---      -     -   - --   - - --   - - --  - -- - -- -  -  -      - - --
-  -- ---        - -        -  --- - -- --- -   -    -  -      -        -  --  -- -   -   -- -  -- -
-      -       -  - -  --     -            - -          -  -       -      - --    ---  ---     -   -
--   -    -- - -     ---   -  - -  -  -  -      -   --    --   - - -- -   - -    - -  - -   --  -  -
-   -  -    -       -          -      -    -         -    --     -  -   -   -       -              -
----      --    --   ---   -- -  -   -- --- -   -    - -    - --  ---   - -   - -  --  ----      - -
- - --  - -  --   -       -  -  - -  -       -   -   -  - --     - -  - -- -   -       -           -
-  -    -    -  -       -      -       ----        ---   -   ---- -  -  - -  ----  -    - -     - --
- -       -- --   -   -  - - - -     -  - --  -- -       -       -   -- - - --- - - -    -   - -   -
-   -  -- -    --- -- - - - - - -  -  -  -  -  -    - -     -      - --          -      - -        -
-  -    ---     - - -   - -  ----   -  --     - -   - ---- -  - -  -- -   --   -     -  -   -  - - -
-- -  -      - --   -    -       - ---  -  --   - -  - -  -    -      - -        -    - - --- --   -
-     -  --   - - -   -- --  - -- -    - -        - -    -   -- -   --  -- -         -  --   -     -
- -    -  --  -                -  -   -       -      --  -  - -  -- -  --   -   -    - -   - - - - -
-   -- -        -    -  --    -  -   -    -  - -  - -      -      -  --          - -- -- --- --    -
-  -  --   -----   -  -  --  - --         -      - --    - -   - -     ---  -  - --   -       -   --
--   -   -          - -  -   -        -   -    - -       -   -  - -      --      -  - -- - -   -  --
-          - --  -    -   - -   -    --- --       -   -- -- -     - -     --   -   -  -     -      -
- -   -- - -  ---    --     - - - - -        -  -  - -           - - --             -  -- ---   -  -
---     -   --    -   -   --  -- --   --- - - - -     - -   -- --  - ---  --       -             - -
-   -   -- -  -     - -        --        - -- --    -       - - -  - -         -     ----- - - --  -
----          -   -  -       -   -  -   -    -    - -    - --  - - -  --   --- -  -    -  --     ---
-   --     -        -    - - - --         --- -  -- --           - -    -        - --       -      -
---              - --- -       --     -      -   - -  -   -  -    - -      -- ---      -   -  -    -
-    -   ---- - --        - - -   -    --   - -   -  -    --    -    --     --      -  ---     --  -
--    --    -  -   --   --          - -  -- - -   -             -    -     - -  ---   -- - --      -
-    - --  -  - -    -   - --    - -   - -  --        ----- - --   -    -      -- --     -- -    - -
-     - --   -   -   - --  - ---  - ---   --    --- - --              -    -     -  - - - - --    --
-  - - -  -  ----     -  - - -    - - -   -    -   -  -    -   -    --   ---  ---      -      - -  -
- ----     -      --  - -   - -      -        -       --     -   -- -  ---  -     - -   -     ---  -
- -- -  -  - -  - ---- -  - --           - - -  --        -  -  -      -  -  --    -    --  -    - -
--      - --     -     - -   - - -    --        - -        - - --    - - -        -       - - --   -
-   ---  -  -  -  ---  - - - -------    ---  -   -     - -    - - -     - --  -       -      -- -  -
-  - --        --       -       -- - --   -          -  --   -- -----        - -       -       -   -
- --             -    -- - -  --  --  - - -  - - ----  -             ---       -- -   -          ---
- -    --      -   -- - -- -   - -      - -      --    -   -   -- -       -- -  -   - --           -
-     -     -   -    ---                --    -     --  - -       - -- -       -- --     --     -  -
-- --      -  - -   -       -        -    -      -     -    - -    - -      -- -      - -          -
-    -- -   -    - -- -        -   ------ -    - -  -  ---   -     -         -  -  -   -   -     - -
--  - - - --- -   - - -    -  -   -      -           - -      -    -  - --   --  - -     -   --    -
-  - -           - -  -  - -    -  - -    - --  -  -     -   -    - -       - -    --    - -    -  -
----    -   -- -       -- - - -    -   - -  -    -  --    -- - - -    -  -  - -  --   -  -    -    -
-           - --  - -     -  -  --     ----  -  -  -    -   --   - -    --  -  --     -     -   -- -
- -   - --           - - -  -  --           - -  -  -- - --   ---- - --        - -- -- -  -    --  -
-           --  -   -  -  -     - --  --  -  - - -    -   -         -- -  ---  -         - - -- -  -
- - -   --       -- -   -  - - - --- -               -    - -      -     -         -  -  -    -    -
--  -   -  -     -      -  -  - -  -          - -  -  -   -     -   -    -        -  -  -- -  -  - -
-    -  -  --  --  --      -      -        -         - -  --- -- -        -  - -        - -  -  -  -
--  -  -  --   -- - -   -     - - -   - - -      -   -      -   -      - --  -    - ---- -        --
-   -     - -  - --   -  - - -  -   --    ----    --   -  - -- -   -       -    -     -  -- --     -
- -   -       -    --    -- - -   -   -   -          --    -    -       --           -  --   - --  -
-        -- -     - -   --   -  - - --  - -  ---      -  -   -   --  -     --   --  -     --       -
--  -   -  -  -     -       -  --      --     -      - -  -  -     -  --  -      -  - -   -    - - -
-   - - -    -  -      -- -           - -    - -   -       -                    -              - - -
----------------------------------------------------------------------------------------------------
