100
100
----------------------------------------------------------------------------------------------------
-        -  -    -   - --  -  - -   --   -- -  ---         -  - --  - -- -    --  - -  --    - -   -
-  -      --    -   --  --   -   - -  -      --     -     -  -   - -      ----     -  -  ---     - -
-  -    - --   -  - - -    -  --        -  -      -    - --  - -   - -  -   - -   - -  -    -      -
-        -   -  -- - - ---   - -      -     --   -   -  --  --    - -  -  -    -   - --- -  ---  - -
-  -                -      - --        - - -       --   - -        ----  --- - -  -            -   -
- -       --  -  - - -- --       -     -       -    - - -      --    -      ---        - -- - - - --
--- -- ---- - -    -           -  ---  - -       --- --   -     - -  - - ---    - ----  --    - -  -
-    --   -   -   --       -  -  -   -    - - - -   -  --    - - ---  - --        -  - -    -    - -
-   -  -  -- -    - -   --         - - - -    - --     - -  --  - -       - --        -- --      - -
-  -  - -     - -     -  --   -   --   -    --  --        -     -     -          - -       - - --  -
- --      -        -   - - - -  -     -      - - --    - -       -           - - -  -         -   --
- -     -      -   - - -  -  -  -----  -         -  -           - -- --   - ---     - - -          -
--   - -- --   - -          -  - -    -    -    - --   --   -  -       -   -   -      - -- -- - ----
- - --   - - -    -    - -  --- - --       -  - - - -  --       --   --  -   - --  -  -   - -  -   -
- -    - - ---  - --   -        - -  -  ---      -    -   -    -   - - -         - -      -  -- -- -
-   -   -       - -   ---    -        - ----    --     - -          -    -              - --       -
-      - -   - -         ----  --- - --      -     --           --- --        - --  -  --   ---  ---
-    -  - -- - - -     -   - -- -     --     -    - -     -  - ----     -- -           --  -       -
- - - -        - -     - - ---        ---      -         -   -       -       -- -        -     -   -
--  --  - - -- -- -  -  -- -- - -  --   - -  - -        -   -  --  - -    -- -  -- -  ---          -
-- -- -      -            -  --         -- -     -   -       -  -    -     -      -  - - --     -  -
-      -        - -- -   -- -  --  --      -     -     -  - -  -  -- - -      -  --       - -      -
-  - - -               -   -  -  --  - --  -  -  - -     -   -   - - -     -  -     --     -----   -
--  -      -       ---   -   -  --    -    --  - -  -- -      -  -        -- - -          -  -     -
-     - --     -         -- -    -       -  -- -  - -     -   --  -   -   -      - --  --- -   --- -
-    - - --     -    - - - -  --   -  -- -- - -      - -   -    --  --  -   -- --   ---  --  - -   -
--   - -   -      -  - - -    -  -- -   ----      -- -     -  -- - - ---  --        -  - -       - -
-  - -      -- -     -  -    -         -  - ---    ---     -   --         --- -- - - - - - -     - -
-- -   -  - --  --             - -     -     - -- - - - -- -- -  -- -      -          -          - -
--   -   -   --  -  - - - - -   - --        -       -   -         -         -     -      -  -  - - -
-- -     --    -  -                 -          -  -  -- - - -       - - -     -     -- - - -  -    -
-    -       --     ---         --    --      - - -     - - -   --      - -   -   --      - -      -
- -    -  - -  -  -   -     -   --     -  -  -        -  -     -   -  -      --     -  -- - - -   --
- --      -  ---  --    -  -     ---          -    -  -- --     -      --  --   -  -    -    -     -
--  -- --  --   -   ----           - - -  ----   - -      --    -       -  -        -  -      -  ---
-  -   -- -  --  --- -    - - -  --  -         - - -- -----  -  -- -  -          --     -  -  -- ---
-   - -    -- -      -    - -  -   -  -- --      - - -       -  --     - -- - -       - -      -  --
- -         - -   -  -  --    -     - -    -- -   -  - -   -   -    -   --   --  --  -    -  -   ---
- -    -   -      - -  - -   -- -  -   -   - ---- --    -    -       --         -     --    -  -   -
-    -  -   -   --  -    - -         -    -      - --    -  -  -       --- -  --- -  --- -  --  ----
----     - -- --    -  - -       - -  - --    --   -     - --  -  -  ---           -     -    -- - -
- -- --  -  -- - -  -   -  - - - - - -- -     -     -  -      - -  -   - - - -   - -  -   -        -
-       - --   - -         - -     -      - --   - -   - -      -   -      --  -   -    -  -   -   -
-- ----   -   -  -- -  ---    - ---      -   -      -      - -  -   -    - - -- -  -        --     -
-      -   ----   -  - -    -- -      -   - --     - ---    -   -- -        -  -  - -    -     - - -
-  - -- -     -          -  - -  ----       -  ----  -  - - -   -      -       -  - ---     -- -- --
-   -  -- - -- -    - -   - -  -          -     -          -  - - ---      - -     -  --  -  -     -
-  -     -  ---    - -  -         -   -       -- -   -  -- -     - -   --  - - -              ---- -
--       -     --   -           -               --- - -  -   -   -  -       -- - -  -----         --
-       -   --- -- --     -    -   -   - - - --- - -    - --   -   -   - -   - -  -   -     --  -- -
-         -     - - --  -- - -    -- -    -    - -   -    -    - - - - --       - --               -
--- -         -   -      -  -    -  --    -  -- -      -   -- -  - -    -   -   -    -  ----     - -
-  -     -   - --  ---       --    -       -     -   -   -   -  -- ----      --         -      -- --
-     -  - -      - -- - - - -     - - - -   --      ---  -    -     - -   --   --     -  -       --
-            -    --     --  -  -  -         -  -  ---       -- -          -- - -         -   -  - -
-   ---  - -     -       -- --- --    --- -   - -     -- --      -       --     - - -       --  -  -
-     -     -  -   -      -- -       -  -     --            --   -   - - --- --    ------    - -   -
-   - -          -- -  --   - -  -  --   -      -  -    ---  -      ---        ---  -        --    -
-   -     -    -         -    - - -   ---      - -  - ---  -     - - --   - --   --    -  -  -  -  -
-   - ---    --  -       - --- -  -    -  -     -        -    -    -    --- --  - -   --           -
---  - - -   - - - ---        - --     ---   -    - --- -      --- - -    - - -   -  -   -  - -   --
- --  - --- -      -     -  -   -  - - - -   -    -     --     - --- --  -  --     -   - -- -  -   -
-               -  -  -     - -       -    -- -    --   -   -  - -      -    - --- -- - -    -    --
- - -  -     ---     - -    -  --   --    - - -   -  ---- --     - -      -    --   -       - -  - -
-    - -  -   - -   -    -     --  -    ---  --     -   -   -  - -       - - -              - --- --
-          --- -  - - --- -    - -            -   - - - - -   - - -      -- -          -     -     -
-- -   - -   -   -   -       - -- -  -   ---  -     - -   - -    -       ---  -     - -      - --  -
- -    -  -      - ----- - -- -      - -- -  -  - -  - -    -  - -   - -  - -    ---        -     --
-- - -     - - - -  -       -        --       -  -             - -     -   - -  -  --         -    -
--   - - - -      - -  - - -    -     -  --  -   - - -        -   - ---    - -  --      -- --   -  -
- -  -- -      - - - --   --   - -   -      - -   -    --    -    -   - - --  - -  -         --    -
--      --   -  --  -- ---   - -   ---- - -  - -   -    - ---  -     -  -  - -     -   --   --     -
--   -  -   -         - - --    - - -  -     ---     -  -  -  -      - -    - -  -    -    -      --
- ---     -  --   --- -   -- - -  - - -       - - -     --  -   -- -    -        -   --      -     -
- -        -  -     -    - -  --  -   -  - --      - --   -          -  - -- -          -- --   - --
- -         -     - --  --   - --  -           -   -- - -    - ---      - - -  - - -  - - -       --
- -- -- - -- -- -  -- -  -- -         --     -   -   -       -      -    ----  --- -  ------  -    -
- -      --   -     --  - - -- --  --  --            - -   -   -- -    -- - - --  -    -    -      -
-   --  -  -  - - --        -- - -  - -  -  - -- - --   -     -  -          - --  - - - --      -- -
--- - -- -    - - - -  --  - - -     - --   -  - - --    -     -  - -   -  -  - -    -- -   -    - -
-       - --- -  -   -     -   - --    -         -      -  ---    --   -     --  - -               -
--       -        -  --  - -  -   - ---    -- -      -         -   -       --- --      -     -  -  -
-     - ---- -  - -  -       --   - -  --  - - -- -         --      -    -      ---       -      - -
-  - - -    - -     - - - --   - --   -  -   -           -- ---  -    -   ----     -       -  -  ---
- -     -      - -- --- -     -- - --   - ---- - - -   -   -     ----    -    - --       -         -
-  - -     ---   --   -  -  --   -     --     -  -   -           -  -     -- - --  -- -  - ----   --
-      -   - -     - -    -    - - -  -    -- -    - -  -  -  -- - - --              -  - --   -----
-  -    -  --    -   - - -     -        - --   ---- -      --     -      -   ---  ---    -  -      -
-   --  -  -  -    -      - - --   -   -   - -    -    ----   -  -                      - --      --
-   -   -  -   ---      ---- -- --   -  -  - ---    -      --  - - -   --   --- -  -    - ---     --
-  -    -   -   -      -         - -    - ---     -     --  -- -- --  -      -       -   --  - - - -
- -  -   - - -       - - -   - -    - -     -   - - -     -   -  -   - -- ----   - -  --   --  - - -
-   -- -    - - -     -- -   --   -    - - -  -  - -- ----  - -      - -   -  -        --     --- --
-      -  -   -- - -- - -   -      -  -         - - - -   -      - --     -   -- --      - - - -- --
-    --       -- -         -----  -- - -- -  --  - -   --    ----    ----   -  - ---               -
- --   --   -- -  -   -       -  -        --      - -   -- -     - -- -     -       --       -- -  -
--   -  -  -- - -     --    -- --  -    -  -  -  --            - -   - -  - -- -   - -        - -- -
- - -    -     -  -     -               - - -      - -  --  -     -     -- -   - --   -            -
----------------------------------------------------------------------------------------------------
