100
100
----------------------------------------------------------------------------------------------------
-   -  -      -   - --  -        - -   - -  --  - - --   -- -     -  - -- -      -     -   -  - -- -
- -            - -  - --    ---- -              -          -  -  - - -    --     - - --  --   -    -
-      - --  -  -    -   -                -   - -  -    - - -  - - -  -   -   -  - -  -  -- -- -   -
-  -     - -      -  -- - ----    - -  - --  -       -- -    -- -- -   - -      -   - -    -  ---  -
- --  -  -      -      -  - -- --    -            -  - -- - -    -       -  - -- - -    -   --     -
- - -   --     -  -    -           -- -- -    - -  ---         -   -- --  -    - --   -  --      - -
-     -  -              - -    - --     -  - -        -    - -             -  -  -- --- --  --- -  -
---  -    - ---            -    -     - - -  -   - - -  - --  -   -      -          -   - -        -
-   -         -  -  -  -  -   -   -     -  --   --    -      - --   --   -    --     --    - --  - -
-   - - - -   -   -- -  - -  --   -   - - -      - -    --     -       -  - - - - --- -  -      -  -
- - -     - ---     - - --      -  -    - -- -           -        -    -    -      --     -- -     -
-          --     -   --        -   -     -   -  -  -    -   --     - -  --         -   - - -   -- -
- -   -        - -       --  --   - -  -  -- -  --  - -    -     -- -  -- - - --  --  -            -
--  -- --  -- --- -     -    -      -----    - -  -----      -- -               -   - -     -  --  -
-     -  -  --     --    -    -    --       -    -    -   -   -   - - ---- -    - --     -  -     --
-         -    -   -   - -  - ----   -- - -              - -    -  -  -    - --  -    --       - - -
---     -      -- -       --- -    --   -     -   -   --- -       -    - -  -  - - - -  -- -  - -- -
-   - --     -  - - -     -  - -        --  - -  - - -        -   -    - - -              - -    ---
-   -   - -       -- --  --    - -- -- -   --  - --         --                   -    -    - -- -  -
-   - -   --  --   --  ---   - - -   -    -  -   --   -       - -   - -   -  --  - --  --      - - -
- -       -   -       -        ---   -     -  -     - -   -   -   - - - -   - --     -        -    -
-    - -        ----   - -- -    -        -- - -   -   -- - -     -    ---  -   --     --  -   -  --
-               -  - - -       -- -  --       -      --  -   -  -     - - --- -     -- -  -   -    -
--    - - -     -  ---    ----  -   - -  ---     -  -   -   -  -- -  --  -  --  - -  - - -  -  -   -
-   -       -- -       --    -  -           --- ---- -      -    -     --     --    -     -        -
-- -        -      -   -  --  -   -  -  -   -  -   -   -    -  -   -- -  - ----   --- -  ---   - ---
-       ----   ---  --  - - -- -  -   -   -        - - ---    --- -    --     - -- --    -    -    -
-    -     -       -    -  -- -  -     - -  -   - -  - -  --       -       - --  -    -    -  - -  -
--  - - - -  -  -      - - - - -  --      -   - -        -    --         -      -   ---  -- - -    -
- -     -   - -    --   -        -   - --   -  -      -- -    -   --  -   - --  - -     -          -
- -      -    - -   - - ---       - --   --- --    -- -      - - --      -- -   ---  - -- -  --    -
- -   -   -- - --      -  -     -  -    - - -  --  - -  -              - -   - -  -   - -   -  -   -
- -- -- - - - - -    --      -  --   -    - -           - --    -   -  -- --   ---        -  -   - -
- -   - -  -  -        ----- ---  ---  -   - -    - -  -   -  -   - - -     -  -            - - -- -
- - - ----   -- -    - -- --   --  - -     -- -          --  --     -  - ---  -   - -  -- --       -
------    -    -    - -     - -    ---   -   -   -- --    -  --   - -  -   ----      - -  ---  --  -
--    -  --  -- -     ---    - ----    - -- --  - -    - --     -    -     -  - - ---   -     -    -
-  - -  -  -        --       ------ --    - -    -   -           -  --- - - - -  - -     --  - --  -
-    --   -  --- - --      -  -    - - ---   --  - - -----                 - - --  -- - --      -- -
- -  --   -  -    - - - - -    -      - ---    --   -      - --- -  -  -- -    -     --   -     - --
-- -       -   -        - - --            -  --  ---- -    -   -- -       -- - -      -- -  - --   -
-  -- -        -      --- -    ---- - -     -        --   - - -      -     -- - -  --            - -
- -   --   -    -- - - -       --  -         -  -      -- -   -    --   -  -  -  -       -  -    - -
-  -    --    -- - ---    -       --   - -   -   - -- -  -   -  -   - - - - -     --  - --         -
-  -  - --       -      -      --- - -   - -- ----- -  -- -         - -  --     -  - -- -- -    -- -
--     -   -   --        - - - - -   - --   --    -   - -    -         -- - -       -   - -   -    -
-- -   -   - - - - -       -     -- ---    -    --   -    -    -- ---          - -  -   --      -  -
-  ----    -   -         --   -        - --     - --   -- -            ----   -     -- - -  -- -   -
- - - -       ---  -   -  ----         -      -   --          --- -- -   -  -  -     -    ---  - - -
-    -   -   -       -  -   -   --  - -   --   --- --     - - -   -       -     - - ---        --  -
- -- -     -- - - -     - --  -   -    --     - -- - - -   -  - -  -- -        -   - - -  -       --
-         --  -     - - -   - - -- --       -      - -    -  -         -- -  --    - --- -  -      -
--           -- - - ---    - - -                    -     -    - -       --       - - - -   --- -  -
- --   - - -  -    - -  -       ---    ---    - - -  --   - -- - - ------    - --       - - -    - -
--   - -   --- -     -   -  -    -   -- -  -    -  --- -     -       - -    -  - - -     -    -    -
-  -   - -    -  -     -  -  --      --     -  - -   ---- ----   --       -- - -    --        -- - -
- - -         -    -         - -   -    - -        -  -  -          -- -  -  -    -    -    -  -  --
---           - - -  --           -  -   - -  -   -    -      -                 -  - - -  ----- -  -
-  -   -   -    -   -           -  -  -  -   - -  --- - -   -     -     -----   -          -      --
--- --    -   - - -  -  --- -  --    - -    -- - -  -  --  - - - --  --     -     --- -  - --  -   -
-   - - -  -  -  --- - - - -            -  -  -   -   - --   -  -   ---  -  - -      - -   -      --
--- -      -         - --     -          --  - - -  -   -              --  - ---   -      - - -    -
-       -  - -    -     -          -   - - -  -    -  --    -  - -  - - - -  -  -  --  -      -    -
--  -   -    -  -- -   -  -- -  -- -  - -  -- -    -         -    -  -- - - -  -      - -   -  - - -
- -  --  -  --- -    - -     --   -   - - - -        -   --  --  - -   --         --  - -- -  -    -
-- -               - -      -          -     - - -  --   -  -   - -   -       - -    -   -    -    -
-  - -        -     -  -  -   -  -  -        - -- -       - -  -  --   - -    -    --      -       -
-     --  - --    --    -   -  - --        -   - - -   -  - -             -       - - -       - - --
-   - - - --   -   -   - -   --  -   ---- -  - -   - -    --   -- -    --             -    --      -
-  --      -  - -   -    -       - -  -   -  - - -   ---  -  - -  -    -   - - ---   --    - --- ---
- -  -       --    -   - -  -  - -  - -      - ---  -  -   -    -- -  - -  - -- -  -  - -       -  -
-- - -   -  -  - --    -  --  -  - -            - -   -   -    - -- -            -   ---  -      - -
-    -  -    -    -  - - - ----     --      - -- -  - -    -    - -  ---- - - --  - -  ---  -      -
-- -   - -     -   -      -     -     - ---   -         -         -    -----    --     -  - -   -  -
-   --  --   -  -     -  -   --    -- -     -  -   - ---    -    -          ---        -     - -   -
-    -   --      -    -     --   -        -    --       - - - -  -  -   -  -  - -   -   - ---      -
-     -   -   -   -   --- -     - --        - -- -  - - -- - -   --  -        ---    -     -  -    -
--  -   --        --   -           -   - -    - --    -  -  -   -  -   --                - -  --  --
-       -    - -     -     --  -    --       -   -     -  -- ------  --  -    - -     -   -  -  ----
- -- -     - ---   -   -   -     --- --  - --    -     -      -  - -  -   - -     -- -    -    - - -
--             -     -  -      -      -    - -    -- -   -  --  -   - -    -   --      --    -    --
- -  -  -   -  -   -  -    -  ----- -- -     --     -   - --  - - -   - -    -     --- -         - -
--      -   -- -  - -- -  - -    -      - - - - - --  - - - - -- -       -   - -          -  -     -
-   --   -     -      ---  -  -      - -    -       -   -   --  -  --- - - -    -   -   - - -    - -
- -    - -- -         -   -- -   -  -   - ---  -  -    --     -  -    -    ---  -  -     - - -   - -
-    - - --   --   -    --   - -  --       - - -- --- -   - - --    --    --    - -      -  -  -   -
-  -         -   -   -  -  --    -   -- ----       --      -  - -  -         -   -  -  - - - --  ---
--   --       -  -- - -  - -  --  -- -   -    -  -   - -       -   ----   - -- -     -      -- --  -
-       -       - - -   - - -          -- -    - -       --     ---  -    -      ---  -  -    - -- -
-        --- -  -- -  -  --    -  - - -- --    --  --  - -  -        -  --   ----  -     --- --  - -
-    ----       -  -  - - --    --     --      -   -     -       - --    -- -  -     --      ---   -
- -    -  -  --     - - - -     --  -  -  - -   -   - --- --   --   -  -  --  --   - ----    -     -
-     -    -      - -  -  - - --           -   -- -  -          - -  --   - -        - -  -        -
-    -       -- -   - -       -    -    ---  -  -- - - -   -           -    -      --   -     -   --
- - --    -- -  --     -  -   --- -  -    - ---        -  ---   -     -  --   -- -       - -- --  --
-- - ----             - - ---       -- --  -       - -     - -- -   - -  - -   -     -   - -       -
-  -     ----- -   - - --     -    -  - -        -  -   ---       -  -   - --     -  - -       -   -
-  ---             -        -        -                   - - - -- -    -  -             -  - --    -
----------------------------------------------------------------------------------------------------
