100
100
----------------------------------------------------------------------------------------------------
-       -  -   -                   - --        -  -    --       - -- - --  - -  -     -      ---   -
-   -  - -    -  - --  -- - --  - -   --     - -  -     - - -  -  -     -    - - -- - --           -
--   -- -  -  - -     -- -  -   -   -   --        - --      -    -       - - - -   - -   -         -
--      -    -    -   - --    --      -   - -- -                -- - -   --   - -  -- - ---- - -- --
- - - -- -  - -  - --- -    --   -  --          -    -- ---   - - -      -  -- -- -     -   -      -
- --    -  - - -    -  - -- -   -- --      - --    -      - -   -               -   - - -- -   -   -
-      -  -     -    -      - -       -- -    - -- - ------       -----  -  -    - -    -   --  -  -
-                   - --     -     -   -    -  - -     --     - --      -- -  --     - -- -        -
-  - -        - -- -- -    -   --- --     --  -- - - -  --    -     - -          -  ----    --  - --
-   -     -      --   ---    --  -  ---      -    - --  -       - --   - -- -  --- -     -  -- -   -
-  -  -    - -    - -     - - --   -      --- -  - -  --   -- ----  -             --   -  -- -  -- -
- --  -   ---           --  -     --    -                          -  - -- -  -     -  - ---    -  -
---- -       - - -      - - - --         --    -    --  -  -   --  - ---      -- - --  -    - -    -
---    --  -- -  -  -        --- - ----  --   -   -  -    - - - - -       -   -- -    -   -    --  -
-    --   --     -- -- -    -   -               - --   -  - - -   -  - -   -   -  -    -- - --  -  -
- -   - -  -      -     -     - -  ---- - -   -    -- --      -  -    --    - -   - --        --  --
--    --  -- -  - -   -   - - -   -  -      -- - -        -  -  -   -  -  -- --  -  -    - - -   - -
--  -    -  - -   ----    -     --  -   -  - -        --      -   -  -  -         -  -   - -    - --
--    - -    --    - - -           --   -- -  -  --         -- -- -   -   - --   -  ---- -     -  --
- -  -- -       - -         -   -    -      - -   -   -----  -   -  - -- ---  -  -   -    -- ---   -
-  -    -     - -- --  -- -  -  ----   --    --- -  -  - -  - -   - - -       --   --         -  - -
- --- - --   - -  -       -     -    -- -     - -  - -     - -- -- -   -   -- -  -   -     - - --- -
-   -        - -       -   -     - -    -     -           -   - -   -  -    -- - ---   -- -    -   -
-    - -   - -  - --  -  - -  ---    -   -----   -     -             -     - -  -    --  -  ---    -
- -- -   -         - - -- - -   - -     -      - -     - -  - -        ---  ---   - -      - - --  -
-  - - -- --   -   -   -     --   - -   ---        ---   -        --    -  -   -    --  --      -  -
-   -  -- -          - -            -     - -  - --      -- --- -     - --  --     -      -   - ----
--     -     -      - -   - -     -  -     -   -    -   -     -   -  - -   -       --    -  -- --- -
--  --        -     - ---  - -  - -  ---  --   - -   - -   - --       - --     -         ---  -    -
-       -    - - -  -- -       --  -  -  -      -     --  -    --       -   -  - --          -    --
- - - -   --     --  - - -   -   - - -    - --   -  -       --    -     -    -     ----- -   -- -  -
-     --    -   -  -   --            -  ---    -     -  -    -    -  ---    -  ---  -      -       -
-   --  --    -- - -        -    -    ---    -     -    - -       -  -- --  -  - - -   ---   -   - -
-  -     - -- --           -  -   --     -  -    - -   -      -  - -      -   - - --          -    -
-- ---- --       --   -   - -   --    -       -      -  -   -     --- --  - -   -      -- -- - -   -
-         - - - - - -  --       --    - - --     -   --   -    -      -          - -         -  -  -
-    - -  -    -     -  -  -    -  -    --  --  - --   -    -  - -      - -   - -- - - -    --- -  -
--     --         -     -       - - - --     - -    --    --      -  --- -  --     - -  -  -      --
-  --     -  - -   -   -    - - --  - - -  - -  -       -    -     -   --  -       - --     ---    -
---     -  -- -  - -    -- --    - --- - -      - -   --   - -        -  - -  -    - -- - - -      -
--    -      -  -  - -   - -   -  -   ---  -  -       -- - -     - --- -  ---  -  - -  -       - ---
- - -       -       -         - ---    --   ----  -  -    - - - -    -        --- -      -- -- -- --
-   -   - -   -     -   - -- - -  -   -  - -  --    - - - - - - -- -   --   -           -  -   --  -
-     - -        - -            -      --- -         -  - -  -            -  - - --  - -         - -
-  - -        ----  -   -  -     -   - - --  - -     -    -   -- --  -  ---      -    --   - -     -
- --    - -      -   -    - -     -      -      -  -         -  ---   -        --  - -   -- - --   -
-- -   -    -  --  - -  -  - -- -  - -      - -   -       - --  - -  - ----       -- -         - ---
- -     -     -- - - --   - - --    -  -- -       --  -  -    -               --  --- --  -        -
- - -   -  -  - --      -     -    - - -- --  --      -    -  --       -  --        -    - --      -
--    ---   -  -    -    --- -  - -   -- --     --- ---         -  - -  -  - -    -  --- -  -    - -
-   --  -  -   - - - -  -  -   -  -- - - -   -   - -       --  -    -- - ----   -         -       --
- -    --    -  - -   -  ---    --   - - - -         - -   -              -   - -   -    --    -- --
-         --   - -    - --       -   --  -  - -  - -   - - --   --- - --    -   -     --    -   -  -
-    -   -   -   - -      -   -    -  -      -   -    --        -  -    -    -     - -   -  -- --  -
-       - -    --  -  -                   -      -   -  -- -  --  -  - -          -- -- --    -    -
-  -                 -  - -     -    -- --- - -    -  -  -- -  - - -    --   --      -     -   --  -
-    --     - - - - -   --      -     -       -  -  -  -    -       -     - -   ----   - -       - -
-  -     -   -    - --    - -    -  -- -     -      -    -  -      -  - - - -         -- -   -  -  -
-   -     --  -  - -  --      - --           -    -  - -       - -         -   ------   - - - -  - -
--  - ---    -   - - -                   - - -   -   - -   -    - -    -  -          --   -    -- --
--      -  --    - - ---   - -  - - -  -   - ---     ----   - - -  -         --            - --- - -
- -- -        -  --  -  --       --   -  - -     - -  -  ---        - -           -     -      - - -
-  - - -  - - -  - -  -- --    -   -  - -  -   -- - -     - - - - -- -     -    -  - -       -- -- -
-        -   -      -    - -    - -  - --  -        - - -   - -   -  -   -          --  - - -    - -
-      - --  -    - -   --- - - --- -   -  -     -  -   --   -  -  -- -   --- -     -     --  -  ---
-    -     -- -- - - --   --   -   ---   - -       - --        -  -      -   -     - -          -  -
-      -         - --   - --  -  - - -  -        --    -  -  -- -  -     -  - --     --  -  -  -   -
-   -- - - --    -  -   -- -  -  - -   -   - ---         - -   -  -   - -- -- -    - -      -     --
-  - - --    -   --   -         -  --       ---- -- --  - -     ---     -  --   --     -  -   -   --
- -    --- - -  -   ----                 -   -      --            -  - -  - -     -   -     --- - --
-     -   -        -     -- -  ---            -    -        - -    -  -    -        -  ---         -
- -   - ----      -  - --    -     -   -     - - -   ---- - -    -   - -   - -     -   -    -  -   -
--     -   - -    - - -    -- --  --- -     -  - -      -    --   -- -   - -   - -  -- --   --     -
-  -  --      ----  -    -   - - -  -   -  - -- - -  ---    - ---     ---   --   -    -   - -  --  -
-   --   -         - -    - --        -            -       -    -  -  -  -    - - - - - -          -
--     - -  ---  - - -  - -  - --   ---    -            ----          -         -        -     -- --
- -      -      -        - - -    - - -  --     ----     - - -  - --- -- -    --  -   -       -   --
- -- -- - -         -     - --    -        -- -      --  - -         -  --  -      --  -  -- --    -
-- --  -- - -  -     -     -  -   -  - --   ---    --  -   - -     --  -  - -   --   -     -       -
-      -  -       -     -   --    - -    -   - -  -  -   --      -   - -    -  -  - -- - -     - - -
----   -   -  --   - --      - - -   - --      -  -      -      -  --   --     --    --    ---  -  -
-   ----    -       - -  --  -    - - --  -- -- -  ---  -     - - -   - ---          -    -       --
-  -    - -   -  --  - -  - - -- --   -  --   - --          - -- -  -- -  --  --    -   - --      --
-     -          -  -   --         - - -- - - -    - -  -  -- - - -  -   -  -   -  -  - -   -     --
-      -      - - -  --  - -   --   -- - -- -   - - - -     -     --- - -- - - -      - ---- -   - -
-  -   -   ---   -  - -  - - - -  -    -  -       -   -  - -    - -  -- -- -- - -- - -   -   -  - --
-    -- - -      -   - - -    - --  - -    - ----   -    -  -      --     -  -   - - ---         - -
-     -    - --  -   - --    -       - -- -    -   - --  -    -   -    -  -  -      -  - - -     - -
----     -     - -  -- ---    -    --  - - --  -     -- - -  - -     - -  - -  -      -      -  -- -
-     --            -  -   -  - -     --     - -     -         -   - -  -   -  -- --   - -     -   -
-    -- -       --    - -- -             -           -  --- -   -       -     -  --   - -  - -  -  -
-         --   -        ---      - ----    -  -- -  --   -       - -    -   -       -  -   -      --
- - --- ---   --      -    -   - - - -  -     - -  -- --  - -  --       --- -       -       -      -
- -     --  -     -    --- - -   --    -  - - --  -    -      - ----- -- - -  - -   -    - -- --   -
--   -   --  --  -  -           -            --  ---        -  -     -      -  -              -    -
-    -  -       - --  -       --  -- -  -   - -  - - -     -- - -  -            -   -- ---     -- --
-  -    - -   -    -   - ----   -     -        -   -  -- -- --   -- -- -- --  --  --  -    ---   - -
- -  - -  - - -      -          -      --  -        - -        - - -   - -  -        -       ---   -
----------------------------------------------------------------------------------------------------
