100
100
----------------------------------------------------------------------------------------------------
-  - - -     -          -  -   - -   - - -  - -  -       - --              - - -   -           -   -
- -   - -      -   -  -   - -        -   -     - -  - -  -   --  --  -    ---  - -    --- -    -   -
-  -   -  ---- --  - -   - --  --  ---  -  - -  - - -      -    -       -- - -     -         - --  -
- - -  ---      --- -  - - -- -  -   -    -  ---  -- -  --  -- -        --   -   -  ----         - -
-- - -- --  - -    ---  -    -   - -  -     -   -   -          -       -   -   - -     -  -  ---   -
--     - -    -     -  ----    -- ---      -       ---   --     -    --    -- - -   -      --  -   -
-  -   -   -     -  -   -       -    -  --  -       -  - -   ---     --     -  -   --      -      --
-   -   -   --      -     --  -    --  -  --  -         -      ---   --    -  -      ---  - -      -
-  - ---  -        - -  -  - -   -  - -    - - -   --     -- -- - -  -  -   -  -   - -        - - --
-           - -   -  -   -  -  --  -- --   - -  - -  - --     -   -        - --  -              -  -
---   -   -     -   --     - -  --      -    -    --    -  -    -  -  - --           -- - -  -   - -
- -  --     - -       -   --  -- - - -  - - - -   - --  - -  -   -- --    -     - - --    -  -     -
-  -  - -  - - ----  -    -- -   -  -   -   --    - -- -  - - ---      -   -   -  -       - -      -
-      -  - -   --    -   - -  - -  -    ---   --      -        -   -    -      -  -  --   -- -- - -
----       -              -  - - - -          - -   - -       -    - -       --  -- -    -    - ----
- -   -   -       -         - -  --   -  -- -      - --     -  --          -   --      -  -        -
-  -   -  - -      -       -     -  - -       -- -- -     --     - --  -  --  -   -     - -  -  -  -
-  - --   - - -  - -  - - -   -     --  - -          -   -   -  -   -  --     --- -- --     - --   -
-- -    -- -      -      -   - - - -   -  -     -  -    -    -        - - -       -     -  - -     -
-  -    -    -- -  --  -  --     -      -   -  --   -- -  -        ---  -   --- --- - -     -  - ---
- -  -  -       -    -  -    --   -          --- -   -     - -  --      -        - -   -           -
-  -    -- - -   - - -      -    -  -  - - --            -  -    ---- --  -   --   - -- - -- -     -
-- - --    --   - -    ---  -   --  - -     --   -- -    -  - - - -   ---- -     -     -    - -    -
- -  --        --    -- -  --  -   -     --   -  - -----    - --- ---    -     ----  -  -- - -  ----
-- -  -     -  --- -   - -  --   -   -   - - - -                 -        -     -   -         --   -
-   - -    -- -   -- -  - -   -       - -- -    - -   -  -       -    - - -   --   -    -     --  --
-  -  - - -     -        -  ---    -  --  -  -    -           - -     -  - -    -    - -     -    --
----   - --   - - -  - ---  -  -   -       -       -  --  --  -- -  - -      -- - ---     -----    -
- -- -     -      -   - -- -   -    -  -       - -  -  -   -  - - - ---    -- -  -  -- - -       ---
--  -- -    - - -   -      -- - --  -    -  -  -       -   -   --      - - -  - - -- -     ---- -  -
-      -- -- -     - --   - -        -- --    -    -- -   -     --   -    -  -  - -   -  -   - - ---
- -      -     - -   -- -    -    -      -       -    -   - -  -   -   -   -    --  - --  - -- - ---
-      - -   -    -    --   - - - - - --  -   -     - --- -         - - - --   -- - - ---   -- --  -
--- --        -   - --- --  -    - -   -  - -      -- - -   -- --   -      -            -          -
-   - -  --     --    - -  --   - -      -    -        -  --   - -     -  - -     -    -  -    -   -
- -- --    -   - -    - -   -    -    - - - --    --     -     --      -   -  --  -      -   -   - -
-        -  -- - -       --- -  -   -   -    -  - --     -   -     - - -  -  -      - --        -  -
- ---    -- - ---   --        - --  - --- -  - - -   -  -   - --     - -    - ---   -          -   -
--       - - -- - --   --   --   -   -- -       - -- - -  --         -- --     -- --     -         -
--   --- -  -     -  -      - -  -      - -   - -   -  -  - - -        - - - - - -- - - -        - -
---      - --       - ---  - - -        - -  -  - --- - ---   -    - ----    - - -  -    - ----    -
-    --- -     -  -     -  - -    -     -  -   - -  --  -    -       -           ---      -   - -  -
- -   -  -        - --  --     --  -   -   -  -  -    - - ---     -    - --- -    - -   --  -  -   -
- -  -      -  - -   -    -     -- -   --- --   -  - - --  - --    -              - - -  --      - -
-- --- - ---  -      - -  - -- -     -  -    -     ---     -- --    --  -   --     -    -  --  -  --
-  - -  ---- -  -  - - - -- -    -  - -  --       -  -  - ---    ---    - -     -   --       -   ---
-  - -   -       -     -              -  -   -   - -- -       --  -  - -     - --           ---    -
--    -      - - -- -  - ---   ----   --  -- -           --  -- - -  --- - -  -    - - - -  - -   --
--  -   -     -  -  - -   -- - - - ---  ---    -     -      -  --  -  -        -           - -   - -
-   - -    - -  -    - -    --        -  -- --    - - -  -    -    -  -  -  ---    -  - -        ---
-  --   - -  - - -  -     --       -- --  - - - -    -- -- - - -       --       -          - - -   -
-- - - -   ----   - - - -    -  -    -       - --- -   - -    -     --   -         -  -  --     ----
-  -  - ---       -  -       -     - - -   -  - -  - -    -- -  -    -      -    - -    -  --- -   -
----       - -  -     --  -  - - -      -  - -- --   -    - - -  ---  - -  -  -      -    -   -  - -
-    -  --  -- - ---       --  -     ---    -  - -  -   - ---  -  --    -      -  --- -     -  -   -
-     -- --   ---    - -- -- - --   - -   -     -     --  -      --- - -  - ---      -  - -  -   - -
- -   - -   --  ---- -       -    -       - -    -  - -  -  -     --     -- -- -  --       -       -
-   --   --  --       --         --   -    -- --     -- -- -- - -   -    -       - - -  -    - -  --
-   -  -        --- --     -       -  - -- -     --   - - -  --  -    ---   -      -  -  -   - - - -
-- - -  ----- -   -    -       --- -    -  -- -  -          -   - ----  -  - -       -     --  -- --
-- - --       -  - - --   - -    -    --  -  - -   -      -      --   - -   -    - - -  -          -
-  -    - - -    -        -      -   -     --      -  -      ---      -  - ---- - -  -- -  -    -  -
- --  --- - -- -   --  --  -- - -- -   --       --  - - - --     -- - -           - -    --      - -
-   - -       - ----    -       - --       -       -   -  -- -      -    -  --  -       -  -  - -  -
-    - --  - -       --  -  -      -   -  --    -    -    --      --   -  -  -- - -  -   --- -   - -
-  -- --  -     -      ---   -           -   -- -   -- --  -- -     -    - --  -  - -   -         --
-  - -         -   -   - - -      -  -   - -- --       -   -   -      -         --  ---      --   --
- -- - --   -   -     --- -    --   -   - - -        -  -  ---- - --      -  --         -     -    -
--       - - -   - -        -     -  --     -      - -     --  ---  - - -    - ---   -          -- -
- -- -  - - -  - - -   - ---     -- --   -   --    -  --   -     -     - -          - -      -     -
- --    - - -- -    - -     -    -  -    -      -        --    - -  -- -  - - --   -    -    -     -
--  --    - -         -     --   --  -     --- - -    - -     -   - --      - -  --     -     -    -
-  --  -   --- -     -- -  -          - -       -     -  --     - -   - ---  - - - -    - - - -- - -
--  --     --   - --    --- --  --  -- -     -  - -   --   - -   -   -      -       - -   - - -  - -
---  -   -     - -- -- -   -      -  -      -  -    - - -    -  -       -  -      --   -   -- --   -
- - -  -    --        -   - --  -      -  --   -  - --  -  -   -   - --     -- -   -        -   -  -
-    -- -   -          -       -   - -- -- -           -  -      - -           -  -   - - - --   - -
--            -      -      -  - -   - -         -          -  -  -  --  -       - -     -         -
--         -    --  - ---  --   --          -   ---- -       -  -  -        -- -   -     --- -  - --
-  -- - -  -- -  -   -       - -  - -     - - -   - - - - ---    - - --    -     -      --   -     -
--     -  -   - - --   -  -  -  - -             --  -    -       -  -            -      - --     - -
--  --- ---   -   --  -   -    --     --     -    ---  -   -  - -- --- -    - -      - - - - --- - -
- - -  -   --    -   -    - --   --  -  -  -    -- -  -        -       ---   -  -  -   ---         -
--  --  - -    - ----        -    -- -   --             - --  - -   -     -    - -  -    --        -
-   - -  - -    -   -      -               -       - -   -   -  - -- - -  - - - - -    -      -    -
-- -  - - -    - -       - -        - --       -- -  -- -  -   - - -    -     - - - - --         ---
-   -- - - -   --    --   -      -     --     -     --   - - -        --    - -  - -       -   -   -
----     -    -    -       - -       -   - -   --  - - ----  - -     - -    - - -  --     - --     -
-   -    - ----  -   -  -   -     -    - -     -  --- - -   -     --  -- -     -    - --   -  - -- -
--   ----   -  - - - -  -    -   - -    --             -   -    -    - - --- -   -- - -   - --     -
-   -     - -  ---- -     --   - -  --   -  - - -     - - -  -   -           ---  -  -   -       - -
--       --       -   -   -- - --      -    - -      --  -  -- -- -   -  --    -       - - - -   ---
-  -    - -    - - -   -    - -   -     -    -   -- --   - -     -     -   -   -   --  -         - -
-        -    -   ---    -      -  -  -   -               --   - - - --- -       --    --- -- - -  -
- - -  --- -    --     -- - -- -  -          ---       -   -      -        - - -     --      - - - -
-  - -    --   -   --    -         - -         - -       -    -   -   -  -    -    -      --       -
- -    ---    -              -  - --      -  -- -   --        -    -  ---      -                 - -
-    -    -    -- - -          -  - -  -  -        -   -  -    -    -  --  - -           -  - -  - -
----------------------------------------------------------------------------------------------------
