100
100
----------------------------------------------------------------------------------------------------
-           - -  - -   -   -            - -      -        -  -      - -- ------- - -  -    -- - -  -
--      -  -   --        --  - --      -  -  - -   -    -   -    ---       --  - -- --  -    -  - --
-  -       -- -     --  -  -  -  - -       -      - -   -     -- -   --   -  -      -- - - --  -- --
-  -         - ---   - - --    -- -     -     ---    -  -   --  - -     -      -  -    -      - -- -
-   -         -       -      ---  -  -- --  -   - - -      -- ---       -      -   -  - - --  -  - -
-   - -     --  ---- -  --   -             - -- -   -   -    -      -   - --   -        -   -    - -
- - - -- - - - -   -     --    -    -- -----  -      -  -    ---   -   -   -         - - ----      -
--    -  -   -    -   - --   - -- - - -     -  --    - - -  -  -     - -  - -    --  -        -    -
- -- - -     --   -         --   -   ----  --    - - -    -        -  -    -  --  -   --          --
- - -     -  --   -   - - - - ---      -    -  -   -  - -  ---   - - - - -    --      - -      -   -
-- -     --  -  --  -  - -- -        --      -  ----           --  -- -  --  --   - - --     -     -
-- - --   -   -  -- - ---    -   - -       -- -    ---     --     - --     -  -       -    -   --- -
- -    - --   -    -  -  -   -    -  -- -    -     -         -- -    -  -         -  - - -  ---  ---
- -  -  - -  - - --    - --     -- - --        - -  -     ---    --   -     - -  -      - -   -    -
- - - --     --       -      -  -       --    - -  - --- --   -  -  -    -        - ---  -    -    -
- - - -  -  -  - --- - -- -- -    - - --   - -- -           -- - -- - --- -         -    -    -    -
-       - -           - -          - -  -  -- -  -   -  -      --   -   -  -    --   - -  - -     --
-     -          - -- -- - -     -     -- -    -  - - -      --   -     -   -   ---    - -   -  - --
-   - -    --  -   -   - - -  - -     -     - -  -        -    -   - -  -   --  - - - -    - -   - -
--   -  -    - - - -  -   - -      - - -   -- --   -    - -  -  -    -- - --  -     - - - - - - -  -
-  -     - -  - -     - - - -   --  --       -         -   -    -- - -- - -- -   -  - - -     -    -
---   - -  - --     -            ---   - -   -      - - -      --    - - -     - -   - - -  --  ----
-- -- ---   - --    - --            --      -  -  -  - - - - -  -  -- -      -    -  - -  -    --  -
-     -    - -      - -       --     -- --         --  -                   - - - - ---   ---- - -  -
-   ---   -  --      -  - -    - -- - -   - - -     --- -        -  - -     -       -     - -   -  -
-  -        - --   -    - --  -       -     -   -  -   -   -  -     --              -       -- -   -
-    - -  --- -  --   -     --  --     -      - -   - -- -      - -   -      -  -    ---  -   - -  -
- ---      -     - -  - -  ---     - - -  -  -   -  --    ---        -   -    -         - -- ---- --
-  --  - --    -  - - -  -  --- - -     -   --    -    --  - -              -     -  -   - -       -
- -   -    - -    - ---     ---    -- - - --  -- -- -      -     -       - -      - - -       --  --
-   --- - -    - - -       - -- - -       -  --     -       -- --     --    - --  - - --        -  -
-     - -- - -  -  -  --  -                     -   -     --        -- -  --- - -    - -      - -- -
-  --  - - -   --      -    ----  -    - -   - -   -  -       --  -   -     -   - ---- -   - - - - -
-       -    -- -      --  - -  -   -  ---  -     -   - --       - - - ---    -- -         - --    -
-   -     -    -   - -   ---  -   -       -   - -  - -     -    -    --  -- -    -- -    -   - --  -
-   -      -        --- --   -   - --    - - ---       -  -  - -   --  - -  -- -  -  -      - -  - -
---  - -  -  - - ---   - - -      - - -    -   -    --     - -     -  -   - -          -  -  -    --
-   -- - -       -  --      ----  - - -       -- ---- - --  -  - -         -  -   -- -    -   - -- -
-    -      -- --  - -- - --  - -   - -- - -     -  - - - -   ----- -      --   --  -    - ---     -
-  -    -   ---  --  -      -       ---    - -- -    -                  - -- -     -   ---         -
- - -  --  --- --    --    -  -- -                -    -    - -- -  -- -      -   -  - --  --      -
-   - -   -             - - -               -   - --- - - -      -       -         -   - -    -    -
-      -- ---   -    --   -       --      -     --    -       - - -  -   -     - -- -      -  -  - -
---   ---- ---  - ---    -     -  -     - --     -    -     -  -     - -  -     -    -  -    -     -
-     --   -      -   -   -         -   --   - - - -   - -    -      -   ------     -     -   --   -
- -     ---  -- -     -- -    -   --   - -      -- - - -  - --  - - -    -   ---     -    -  -     -
-     -- -   - -   ------       --  - -  -    - -   --     -- -         -  -  -    -- - -       -  -
- -      - -- - -       - -  -- -         - -   --    --        - --  -      -    - -  -  -      ---
---     -       --  -    - -   -  - - -   -    -----  --   -  -- - -   -- - --            - -      -
-  -  - --     -  -         - -  --    - -   -         --       -         -  -  -    -   --        -
- - -             - - -   --        - - - - - -  - - - - -- --  -- --  --  -   -  -- -       ---   -
-    -  -- -   --  --  -    -  -- --       - ---     - --         - -    - -              - -      -
-     - -      -- -- -   -     -      - -- ---     -- -   -  -   - - ------ -- -----   -   -      --
- -    -    --     - - -- ---  - - -          - --  - - - - --       -  -    -   -   -- ---- - -   -
- -  ---            -   -     ---  - --- -    -      -      --       -       - -  --  --   -    -- -
-       -   --    -    ---   -   -           - -- -             - -   -    -  -  -  ---      - -  --
- -     --   - -  -- - --   -   --  -  -        -        -     - -  --  -- -       -    -- - -  -  -
- -    --   ---   - -         -   - ---      ---- --    ---   -  -  - -    -   - -  -   - -      - -
-        ---  - -   - - -      - - -   --  --       - ---   -- - - -- -   -   - -   ---- -       - -
-    ----    ---  -     -- -      -  -      -   -    -     - -  -- - -    -              -----   - -
-   -      - --- -      -   - -- -    -   ---      -- -  -     -       - - -  -       - -          -
---   --- -  --- --     ---  - -   -  - -    - - -      -  --    --  -  -       -      -- - - -  ---
-- - -- -  -  --   - -     -   - -    - -   -- --  ---  --        --  - - -   - --    -  -         -
- -       -     - -  -----  - -   -  -  -  -  -         -- ------ -     ---  -       -  ---  -     -
-   -   ---  - -- - -   -  -     -  - -    ---  -    - -    ---     - --   -  ---  --  -- - - -   --
-           - --    -   -- -   -   -  - - -             -- -   -   -    -  -      -        --  --  -
-    --  -       -              - --- -     --     -    -    - -     ---   -           -           -
-   -  -        - -    --    -  - -      -    - -   - --    -    -    - -  -  -- --    - -     --  -
-    - - - -      -        -  -  -  -       -       -- --      --     - -  -   -   -  - ---   -    -
-  -   - -  -- - -   -    - -  -- -      -     -- - -   -            -    -    --  ---  - -  -- -  -
-    -- -   --             - - --      -   -   -- - -  -           -  ---  -   -  - -  -       -   -
-  -     - -- -  -  -----    -    -   -     -         --   - -   -           - --            -     -
-    -        -  - -   -  -    - -       -      -   --    - - -   - -   --  -            - - -     -
- -       - -      - -- - ---- - -- - --    -    -  - -    --    --            -- - - --   --      -
-- -               --  --  --         - - -  - -    -     -   -       -- - - -  - --           -   -
-- - -  -- ---  -  - -    -   - -- - -  -   --          -  -- -    -      -           --   -- - - --
-     --- - -           -        -- ---  -      ---  --    -      -  - ---    - - --  -       --   -
- - -      -  -  -    -                   ---       -  -  - ---    -- --    -   --  - -  -   --  - -
-   -   -  --           -   - -  - -   ---      -  -  -        -     -     - --   -- -   - -      --
-  --  -      -            -   -  -   -   - -- -  ---       -   - -  -   -   -     --   - -   -- - -
-  -- -    -        -            -    - -                -    -- --      - - -   - -   --  -      --
- -    - --     -   -     -- -   -  -   -  -      ---   - --   -    -- - -   - - - - - -    ---    -
-  --   - -     - - - - - - -  ---  - --   -    --    -- -     --     - -  -- - -     ----   - --- -
-- - -  - - --   -  -       -  -  -  -  --  --- -  ---   -     -  ----  -       -     -   - -   -  -
--   -      -   -  -  -  --  -      ---   -  -  --   - -       -  -   - -- - ---    --   -- --- -  -
-  -   ---  -          -      --        -    -    -     ---  -     ---   - -    -  - -   - -     - -
- -  -     -       --   --   - - --   -         - ---   - -- - -  -   -      -- - -     --  -   -  -
-    --- - -  -    - --   --   - --  -   - -  - -    ---   - -  -   -         -   ----       - --  -
--- --      - -       -       --        -  -      -- -- ---  --            --  --  -   - - ---     -
-      -   -   -   --   -  -          -  -   -  -      --   -  --  ---  -    -      - - - ---   -- -
-   -    --     -     - -    -   -   -    - -      - --       -     -- -   -- -  -           --    -
- - --     -- -    -- -   - -  - - -  -   -     --- --   - --   - - - -      -   -   -     --    ---
-   -  -       -     - -  -     ---           - -   - -  -      --- -   -   -- -  -      -  -  -   -
- -  -- - --    - -   -       - -            -- -   -  -   --  -  -   --  --    -  -- -- -     - - -
-     -  - -   -- ---- ----   -- -   --   -   -      -- -     -  - --    -  - - -        -  -    - -
- -     -  ---   -  - - - -  -- -- -             - -  -     --      -      -  -        -        -- -
-     -       -  --     -- -     ---  -   -- - -    - - -   - - - -  - --       -    --      - -   -
- - -  -     -           - -             -  -              -  -     -    --   -              -  -- -
----------------------------------------------------------------------------------------------------
