100
100
----------------------------------------------------------------------------------------------------
-  -        -                 - -  -        -        -  - -       -     - -  --   - -   -  -   -   -
--  - -  - -   - ---          - -   -  - -  -- -      - - -         -        -                - -  -
-  -   -         -    --- -    -      - - - -     - -- --  -   - --  -    --  --  -   -        -   -
---      ---       -     -   ---    -      - --            - -  --     -  -  --      -       -     -
--   - --      -  --     -          -   -   -      -  -   - --    -  --      -  -   --  - ---   -  -
-  -  - -- --    -    -- -   -  - ---- - ---     -  - - -  -  --   -   --      - -   - -       - - -
- -  -- -     -  --   -       --        -   -    -   -      --     --      -- --     -  -  ---  -  -
-  -       -  -        -- -  - --   -      - -     - -  -      - --  -  -  - -                 -  --
- - - ---   -  --    -    - ---     -- - - - -- ---    - -  - -     - - -   - -     -   - - --  -  -
- --   --  - -   --  - - -  -    - - -    -- -  --   -    ---    -  -     - -      -  - -- -    -  -
-     -- -     -- -  -  ---  --     - -    --   - -   - -    -     -    -      ---  -  - -       ---
- --      --   -   - --  -- -         -     -- -  - -      ---- ---        -  -   -- - ---         -
- -- - -    -    -  -  -       --         -  -- -  -   - ---   -        -     --- -  - -  ---     --
---  -   - - -          -  - --  -  - -      -    -     - -  --    ----            -  -    ----    -
-  --   --   --    -     -            -     --  --  --      -  - -             -  -  -    -     -- -
--   --   --   -     -  - -  -    - -     --    -    -----   -         - -- -   --     -  - - -    -
- - -- -       -  -  ----     -  -   - --- - -    -  -   - -  --      -  -   -        -      - -   -
- - - -   -     -   -     -    ---    - - - - - --   ---   - -      ---   -   -   -    -  -    --- -
-  -         -   - --   --  -   -     - - --     --       --  -   - - --        - -  --  -         -
----  --  - -  -    --    - - -     -   -    -  -      -    -     - - - ----  --  --   -  --   - ---
-  -   - -    -  - -- - -  -- - - -   - -- -  --- -   - -       -   --     - -   - --   -          -
---       -  -  -         -   -  -   -     --    -  -- - - - -   -    -        -- -- -   -- -      -
- -     -    ---   -------      -  --   -  -  -      -   --    -   -      -     -   --         -- --
-  --         --  -          -    -- -  ---  - -    -  - -   --  - -  - ---- -- - ---  -   --    - -
--    - -   -    - -      - ---    -     --         -   --    --     -    - -                --    -
-   -- -      - -   - -         ----            -     - -  -  - -   -  -      - -   -       -   - --
- - -- -     - -    -     - -  -     -    -  -   -  - - --           --  - -       -  - --   - - ---
--                    --               - -    -    -    -  - --  -       -     - -   -  --     --  -
--  - -   -    -    -     - -    -       -  ----           --   - --  -  -         -  -- -   -     -
-       -     --  -- -      - -    -   -        -- - - -- -  - -   -      - - -      -         - - -
- -      -  -  -  --- -   -  - - -    - - -         --       - -    - -  --   -  - - -    - -----  -
- -- -- --- -- -   - --   -   - -- - -   -  -     -     - - - -     -        -          ---  - - ---
-- -  --    -  -   -    - - - - - - - -    -   -  -  --     - -       - -  -   -    -    - -   -   -
-  - --   -  -- --   -- --  --    - -- -   - -       -     -  -    -   - -   -    -    - --     -  -
- --      - -- --    -    - -  --       - -      - -  - -  -  - -     -     -  -   --  - - - - -- --
- --        --   --- -  -  - - - -      --  -    - -  -   -   - - ----   -  --   -- -     --- -  ---
--  - --       -       -  -- -   -   -  - -   - - --- -  -         -     ---  -       - --     --- -
-         --- -      - --            - - ----   -  -  -   --  -       - -  -- -  -        - - - - --
- -  ---  -  -   -   -    --    -    -               -- ---    - -   -- -   -        -    -- -   - -
- -    -- -  ---  -      -  - -    - - -    -      -     - -   -   - -      -   - --   - -    --   -
- - ---   - -  - - - - -       -- --- -- --     - - -     -        -  ----    - --- - -   -  -    --
---      -     - - -    ---    -    -        ---   --   -- --   -  ---     - -   - -    --   -- -  -
-   -         -  - -  -          - - - -   -         -   ---        -- -        - --- --  ---      -
---   - -    -   - - - - -  -  -        - -    -- ---    -  -   -  -          -- - -    --   --- - -
-  --   -     --  -          --    -      - -     -  ---        ---     --       -- - -  - -       -
- -  - - - ---   -   -- - -     - - - - - - - -- - -- --       -   -  -      --      - - -   -     -
-   --   -   ---   - -  -        -     -   -- -       -         --- -   - -      --   --  -        -
-- -     -  -   -  -     ---- -- - --  -    -  -        -  -  -    - -   -  -  - -  -        - --  -
-     -     - -   -       -    - -        - -           --      -   - - -    --    -   - ---   -  --
--  - -  --        - -   -     --         -   -    ---   -   - -  -   -  -- -   -  - -- -    -    --
-    -          - - - --  -  --  -        -       -        - -  -  -           -   - --  - --  --- -
- -- -    -     -  -      --       - ---       ---  -   - - - - -    --  - -   -- -       -  -   - -
-    --      - -    --  --       -      -  -- -    - ---  - -      -     - -  - --     -  ---   -- -
---  --  - - - -  -   --      -    ---- - -                  ---     - -   - -     -      -  --    -
- ---   -  -         - -  - - -   -      -  -   -  -       --- - -     --  - -- -- --   -  -    -- -
- -  - -    -  -   -     -- -  -  -   -----   -   -  -        -         -  ---  -          -       -
-      - -- -- - - -      -  - -    -  -  - -  - - - ----- ---   --  -- --     -  -     - - - -    -
- --      -   --  -- -    - --    -- -  -  --             -          --   --       -        --  - --
- --    -            -  -         - -   -   -       -  -- -    -- ---       ----                   -
-    - -  -        - -  -  -  - -    -  -- - -      -   -  - -   - -  -   -- -  - -  -     - ---   -
-   ---  --   -    -- -        -     - --   -    -- -   --  -   -  -   --  -             -  -    - -
-   - - -     -  -- - - ----    -  --      -- -       -- - - --      - -  -- -   -   - --    ---   -
- --     -- -- - -    - -    --  -   --  -        -  -            -  - --            -      -      -
--    - - -  ----       -    ---      -   -  -- -      -    - --           - ----      -        -  -
- --   --  -     --- -             -     - --   - -  - -   -  - --   ---       - -         -    -  -
--  --   --    -   --  -- ---       --     -           -   -    --   -      -      --  -- -   - -- -
-    --  --    - -   --  -  -   - -  -    -       --  - -    -  -- -    --   -    - -       -- --- -
- -   -     - --   -- - -    -- --  -  - - -          -  -        - -    -  - --- -   - ---- --   --
-    -    -     -     - -    -     -     --    --    -  -  -    --      --     - --  -- --         -
- --- --    --        -  - --   - -  -     --    --  - ---- -- -  - - -  -   --   -   - -     -  - -
- -      -  -  - -          - -       - --- - -   - - -     -- --  -           ---- ---  - -   -   -
-     -    --    -  -       --- --  - --   -    --         - -  - -  - --          -- - --  --     -
-   -    -   - -       -        -- - - -  -  -   - - --  - --- -      -         ---   -    -  -    -
- - - - -    ---    --- -- -   -  -    - -       -          -     -    - --     -  -  - -  - - -   -
---  - -    --    - -        -  - - --   -  - -     -    - -       ----         -- - - - - -  - -- -
-- -     -   - -      - ----         -  - -   - - - -  -   -    --    --  --- -             -    - -
- -- - -      - -   -         -  --  - -       -      - - -  -  - - -  - -     - -  -   --  --- -  -
- ----  -   - - - --     -- - - -- - -   -  -- -- -          - - --    -     --    -          -   --
-  -  -           -     -- -  -- -     -  -     -       -- --          -   -- - ---    - -  -   -  -
- -   -  ----  -        -   - --- --        -    --  -   - ---   -   -   -    - -  - -    -  - -   -
- -    --     -  -  -       -- - -      -   -   - -   --     -   -    -- - -      - - ---      -   -
- -     -    -   --  --     -   -- - - -      -   -- -         -  --          --      --  -   -    -
- -   -   --   -  - -      - - - -       --    --    --     -  -    -  -  - - -  -  - ---  --  -   -
-     -  -  -      - -          - -  -     -  -    - --      --   - - -  -     - -     - -- --  -  -
-   - -   -        -- ---- - - -    - - ---  --         -  -    --  -     - -  --    -       -    --
- -   - --  -   - -     -     -     -        -- - --        -    -           -     -- -  -     -  --
-    --   -- -   - -  - - - -  -   --  -       -       - - -   -  --    - -     - -- - --  - - -   -
-   -   -        -  -     -          - -       -    - -  - -- -  -   - -       -    -      -    -  -
- - -- - --      --  - - -- - - - -   --   -   -   - - -        - - --  - -  -   - -  ---    -     -
-       -   --    - -  -    -   - -- - - --    -       -  -        -- -  - - -- -  -   - -- ---  - -
-   --- - -    - --  -   -    -    - -  -     --  -       - - ---     -  - -  -    --    - --     --
-    -   --     -          - --  -  -   -   - -   -  ---    -  -  ----  -     --       --  - --    -
- - ---        - -  --- -- - - - --- -     - -      -   - -      - --   - - -    -  -  --   -   -- -
- -    ----    - -         -  -- -    --- -       - - -  --  --    - -- -   -  - -     --   -  -  --
-    -  -  -   - -      -    -   -  -      - -- --   - ---  --  ---   -       -                    -
-  - --      - - -     -  - -     --   ---    -    - -- -     -   ---     -  -   - -    -  -      --
-- --    - -   -  -   - -    -   - - - - -- -   -- --     - -  - -               -  -   --  -- - - -
-                 -  -      - - - -   --   - - --  ---   -       -   -    - - - -  --      -  -  - -
----------------------------------------------------------------------------------------------------
