100
100
----------------------------------------------------------------------------------------------------
-                    -   -     -   --  -- -  - --   - -     - -     ----      - - - - - -    -  -- -
-   - ---------  - -- -    -- --- -      -             --   - -  -                  --     -    -  -
-  - -  -   -  - --      -    -      -  -    -   -   -    -        --- --  -     ---  --    -  -  --
- -       -   -  - -  -      -  - -     --   - -  -  -    --          -  -     --    -     -  -    -
-       -     ---  - -  ---  -- - -  ------            --        -- --   -  -  -    --     - -   - -
-  -        -    -      -   -        -     --  -  -    -  - --  - -   --     -  --  - - - -    -   -
-    -   -   - - -   -            -    -  --   -- - --  -    - - -- -    -- -        -     -    - --
-      -    --     - -  --    -                     -   -   -   - - --     -    -  -- - - - -    - -
- -   - -      - --   --      -- - -- ---    -- -         -  -  - --  -     ---  -  --    -     -- -
-  -  --  -    -          - - - -- - - -   -    -  -   - -----    -   ---- --- - -- -  -      -    -
-   -     -   - - - -     - - -      -   - -- - -  -- -      - --- -           -       -  -   - -  -
-     -   - --   -     -   -   - -  -- -  -  - -- -- - -     -   ------ - ---  - - - -- -- -       -
- - -   --     -   --   -   - -   -- - -  - - -   - -- - --   -   -   -  -   -   --     -      -   -
--    - -- --    -  -  -    -    - -     -        --     - -   --    - -    -- -     - -  -      ---
-- - -        ---   -- -          -  - --   -     - - --   - -      -          -  -          -     -
---   -  -   -  -- -   - -   -  -        -     -          -      -  -     ---   - - - - ---- --    -
-  -    -      -   -       -      -  --   -       --      - -- -- - --   -    - -      -    - -  - -
- --    -    -  --  - -- ---   --  -     -  --  -         -            -    -  --     ----  -     --
-         - -  -        -    - -        -  - -   - -    - -  -   - - -         --  -       -- ---  -
---    --   -    - -   -  ----  -            ----  -      --- -   -     - -  -   ---   ----  -     -
-         -- -         --     - ---  --     -   -   -  ---    -     - --  --  ---   ----   -- - -  -
- -    - --    -  --    - -  ---       -     -- -- -  -  -            -      -   - --   - -        -
--     --  -- -   -  - - -       - -  -    -     -  -  -- ---- --      -   -   - --   - -    - -   -
- -   -- -- -  -  --   ---  --- -  --  - -   - ---    -  -   -- -  - -     --  -    -- -  -      ---
-       - -    -   -  - -      -        -   --  -  - --   -    -       -   - - --     -- - - - -   -
--     --      -    - --  - -  ---   - -- -      - - - -     - ---          ---         -     --   -
- -   - - -- -  --       -  -     -     - -    ---- -    --  -   -      -        -  -       - -- - -
----      -- --   - -   - -  ---  -       -- - - -  - --         - - - -   -     - -  -  - ---     -
--  --    - -   --    -  -   - -   - - ---      -   - - - - -    - --    -  --- -           -   -  -
-      -   -  -  --  - -    -       -       -- -  -   --       -   - - - -  -  -    - -   -       --
- - -    - -   --     - -   -   -  --- -          -      -      -- - - -----  -        - -     -   -
--  ---   -    - -- -  --    --             -- --     -  -  -       --  -   -  - - --   -  -   - - -
-           -      - -    - -- - - -- ---  -   - -       -   --- -  - -  ---  -       -  -  - -- - -
-    - --     - -- -       -  -  -  - - --  --   -- --  -- -    - -    -   --       --  - -  -     -
-     -      --- - --    -     -  -   --  -  - - -- -  -           - - - -     -- -  - -   --  --  -
--  -  --  - --- -   --              -- - -- - -- -   ---      -  - -- --   - -     -   -----     --
-    --    --  - --     -   ---        -   -      ---  --  --      -  - - -  --- -     --    - --- -
-- -      -- - -    ---    - -            -        - -- -   -      - - --  --    -  --     ---  -  -
--  -  --    - - --      -      - - - - -   -- --  -     --  --              -          - --  --   -
- -   - - -   -- - --     - -     -  --  - -   --      - -    - -  -   - ----  -  --        -    - -
-     -   -  - -     - -    --  -           -    -- -- - --    - --- ----    -  -       -- - -     -
-   --  -      - - -  -  - -    ----       - ----  --    --   -            -           -  --   -   -
-     - -   ---      ---     -     -   --     - - - -   -     -        --      -       ---  - -  - -
-     -    -  - - -   - -                -         - -   - -    - - -       -  -   -  -  -----  -- -
-           -    -     - - -- ---   ---  -    -    -         --  -     --    -    -  -  - -  --    -
-          -    - - --  -   -   - -    -  - - -          --     -  -      - -       - - -  --      -
- -      -- -    --       -     - - - -  -   -    - - -       -     -        --      -    -    - - -
-    --  --       - -    -  - - - -   - -    -       -   --  -    - -              -         -     -
-        -   -   - --    -   -    -     --  -      -     -  - -    -      --- --      -       - -- -
-  - ---   ---- ----  -    --- -      -       -  -        --  -  - -  -   -  -  --   - -     --  - -
--- - -- --  -  --    ---  - -        - -- - - -   - -- -    -   - -  -    - -      -  - ---   - ---
- -      -     -     - - --     - -   ----  -    --- - -   -    -            - -   -  - -   - -    -
-- - - -       ---  -- --   -  -   -         -  -  -       -         -    --  -  -  -- - -- -     --
-   -  ---  -  -  -  -   -  -     --- ---  -     --- --   -    -  -     -- ----    -  --    ---    -
- -  -        - - -     -   - - -      -     -   -   -- - -  -    -        -  - --  -   -      -  --
- -     --  -     -      -  -     -  --- -    --   -     -- -  -        -- - -    -    -  -  - - - -
-  - --  ---     -- -   --       ---    - -- - -    ------ --     - -  -- -- -  -      - - -   -  --
--     -     --- -- - --   - -       -        -           -  - -   -       -- -  -      -- - - -   -
- -- --  - -  ---  - -     -      --   -  -    -- -  -     - -    -  ---  -  -  -- -- -  - --  --- -
-- -     --  -      - ---       -      - -   --  -         -  -   - -   -  -    -  -  --      -    -
- - -- --      -        - --- - -     -      -  --  --        -    - --        -  - -   - ----  -  -
-     - ---  -  - -  -  - ---   - - - - - --   ---   -  - - --         -   -   -  -      -    - -  -
-    -    -   - -  -       - ----       - -        -      -  -  -  -      -  - -    -   - -   - -  -
-      ---    - -      -   -    -  --   - -  - ---  -        --   -  -- -- -  - -         -   -   --
-   ---   - - ----    -- -  - - --  - -     - -   - --  -      -    - --    --- -- -  -         - --
---      ---     - -    --  - -       -   -     -- ---  -       -  -        - -- -- --             -
-  -  ------ -- -     -  -  -   ---       -  -- -     -  -     -- - -     -  -   -    -  -  -     --
-   -  -    -           ---   -   -  ---   -   -     -  -  --- - -  -   -  -    -     -   -   -    -
-       -  -   - -  -      - -   --         - -     -  -        --   - - -- -    -     - -  -      -
--  -          -    - ---- - - -       -   -   --  -  - -  --  - -  - -       --   -   --  - ---   -
-  -    -- -   - -    -   -   --    -   -  - -      -    -  -      -  -  --       -     --- -  -  --
-- - -  -    -     - -   ---    --   - -   ---- -  -   -     -   -      -   -    - --      -  - - --
-    -      - -      -    --       ---    - -  -    -      --   -  -      --   -        -   --- -  -
-          - --   - - -   - -  - - --  - -         -   -    -  - - -             -- -- -     -  - --
--   -     - - - -   -   -  -  -  -      - -- -- -  --   --   --  -    -----   -               --  -
-   --  -  - - --  --    - -  -   -    - -     -  ---- -  ---  --  -         -- -- - --   -    -   -
-      ----       -      - -  -  -            - -   -   - -  -- -    --  -    - -   -    - -     - -
- --            - -  --  -       -    - -      -     --     -         -    --   - -   - -      - - -
--  -- -          - -  -             -    -   - -        - - --    - --  - - -    - -- -  - -  -   -
- --       - -- --    --  - - --     --    --  -  -  -  -                  -     -  - - --  -- -   -
- -    - --          --  -    -   - - - -    - --     -- -  -  --   --  -         - -   -   -  -  --
-  - -  -   -    -     -       -    -    - -- -   --- --   -  -     -    -       -       -   --   --
-- - - -          -  - -   -   - -- -   -  --  --          --- -   -           - - -   -       --  -
- -  ---           -    -- ---  - --  - --       -       -   -  -   -   - -  -      -- -     -- -- -
-         -    - - - --   -          ---   - -- -  - - -   -   -     --     ----   - --     -      -
-    -  -    -       - --      - - -   - - -     -  ----      -   -- -   -    -           -  -   - -
- --   -   - --    - -         -      --   - -   -- - - - -- - -   - -           -   -      -      -
-   --- -   -  - -  - --      -  -    - --  -   -    - --   -   --   ---  -   -  -    - -- - - -  --
- -       -    -    -  --- - ---  --    -    -        - -    --- - -     ---      -     -  - -  -  -
- - -   -- --      -  -     -   - - - - -   - -   --- -      -  -  -- -     -  --     -    - - - - -
-        -  - - - -  --- -   -   -  -  -                  -  --    -  - --  -    -  - ---       -  -
- --         -    -           -- -- - - -   ---  - -      -  - ----    -  --      - - - -   -    - -
--     - -- -    -    -    - -  -     -    - -   -        -   -  - -    -- -   - --- - -    -   -  -
-  - - -   -  -    -  -       -   -   -      - --   ---   -     -  -- -       - -    --  -     --- -
-    - - - - --   - -    --   - - -  -   - ---      -      --     - - - -   -  -    - --- -        -
- -      --   -     -  -     -   - - - -    - --    -- --     -       - - -  --  -  -        -     -
- - - -        -  - --     - -    - - --  --   - ---      --       - -         - -   -- -  -      --
- -     -   -     -      -     -- -   -   - ---  -    -     -  --- - -    -                 - --   -
----------------------------------------------------------------------------------------------------
