100
100
----------------------------------------------------------------------------------------------------
-   -- - - -    ---  -     --      -           -    - -    -                  -    -   -   -       -
-      -    -----  -   -          - -        - -  --    - - ---      -  --       --          ----  -
-  - -  -        -  --   -  -    - -      -  -        - -- --       -  -   -         -             -
--    -  - - -   -   - --     --  ----    -    -       -     -- -     -   -      --    -- --  -- - -
-    -  - -   - -     ----    - -    - -  -      -      -  -- - -  - -  --   -      - -  --  - -- --
- --  - -       - - - -   ---    --  -  -   -  -   - --  -    -    - -   -----     - ----- -- -- ---
- -  -  -          -    - -   -   --- - - -   -   -         - --  - - - ---   - - --  -   --     - -
-- --   - - -  -      - --    -   - -  -   - -   - - -  ---     -   --      -           --   --    -
-  -      ----     --              - ---     ------  -  --    - --  --- - - --  - -     -    -     -
- ---        ---    --- -    - - -  -   - -- -     -  -  -   -  -   -  -   -    -       ----- --   -
--  -  -  - -     - - --  -- --  -  -- -- - - -- --     -     - - -- --  --  -   --    -       - ---
-- -         -      -- - --      -        --      - - -     -- --            -   - - -  --  -      -
-     - -  - -        -     -     --     -   --   --   --  - --     - -   -       ----     - --  - -
-  -   - -- -       - -   -  -               - -         - -   -    -- - -     -  -             -  -
- -            - -      ----     - --      -   -    -  -  -  -      - -            - - -     --    -
--  - - -  -   -  - --   - - -   - -   ---  -   - -    -      - --    -   -   --     -   -      - --
-          --- ---    -    -     -- --   --        -      -  -       -    -  -   -  - - -  - ---   -
- -   -  -        - -      - - - -   --  -  -   ----     -  --- - --   - -  -     ---      -       -
---- -   --   -  -    -  ---   --    - - -  - -      --   -       --      -    - -    -- -   -   - -
-      --  - - - -  -  --  - - - -    -   - ---   - -    - - -- -     --  ---      -   --  -   -   -
-- --  -   - --    -    -        --      --  - ---- -  - -  -   - -  - -  - -- -  -  - - -    -  ---
-  ---  - -        - --- -- --  --      -      -    -                   -  - -  -  - -   -         -
-      - -     -      -  - - -    ---      - - - -     ---  -       -- - - - --   --   -           -
-   ---- -   - -   -  -         --       -     - --      --   -      - -        -   - -  - - --    -
-  - --     -   --  -   -  -   -  --   -  -        - -  ---       ---         -- - -   --  -- - -  -
--        - -    --   ---  -   --     - -- -        -  -- --- -- --  -                    -        -
--  --  -  --   - --   -         - - - -  -- -  -----      -   -       -  - -   -        ---       -
- --  -    -  ---       -  - -  - - -  -     --   -    - --     -  -   -        -  --  -     -     -
--  - - -   -    - --    -   --  - - - -   -- -    - -   - -  - - - -   -       -      - -- -     --
-  -   -      --      -- -    -      -    -     - -   --          - --   -  --   - -       -     - -
-         -- -   -   -  -   --        - -   ---  -   -  -  -     - - --   -     -    -  --- -  -   -
-  - - - - - ---  -- -       -  -   -- -  -       - -   -         -- -  -    - -----       - -   - -
--      - -  -  - -   -----  -     -  -   -     - -      -  -   - - --    -        -    --  -   - --
- -   -   --- - -   -     -  -  -    --   -  -     -    - - - -   -       - ----  - --  -   -  -  --
-    -       --      -       --  -       -  - -  -  -    ------   ---  --    -  --        -- ----  -
-    - --  --- - - -  -- -  - --     --    -  - -        --    - --   -   - - -  --  - - - -   -  --
-    -  - - -  --  -    -  -      -    -   - --      --    - -     -  ------   --    - -  -        -
-  -   --  - - -        - ----   -- -     - -  - -       - - -       -  -   --    --     -         -
-  - -- --  -    -    -  --  - -    -  -- - - -        --         -        - -   --          - --  -
--    - -      - -   - -   ---     - -  -          - --- ---   -  -  -      -  - - --  -- --     - -
-     --   -  -     -     -  -      - -    -    -   -        -   - --- - ---   - -  -  ---  - -    -
-  --         - - - -- -  ---      -       ---- --    ---  -  --  -      -      -       -- -       -
- -  ----       -  - -     -          --      -       - -    -    -          - -  -     --   -- -  -
-   - - --    -   - - -   -   -     -     - - - -      -  -   -          -       -- --           - -
-- - - --  -- -    -   -- - --    - -    -- -  -    - -  -  -   - --- -   -        -               -
-  -                   - -   ---          -        -- -       --         - -    -  -- - -   - -    -
-  -    -    -- -  - -   -  -       --  -   -  -  -     --- -    --   - - -      ---   -   -  - -- -
- --  -  -- -- -  --- -      -    - -   - -- --- -    - -          - --  -               -        --
-- - - -  -   --  ---   -- --- -    -  -- -- -   --   -     --  ---   --  - - - -    - -   -  ---  -
--   -    -  -      -   -    - --  -   --- -  -     --   --  -- -  -       -        -    - - - -   -
- -  -   -     -  -        - --    -          - -- -  -  - -  - ----   - --   ---      -   -       -
-  -     -  -- -  -  -  -  - ---     -      -- -     --  -  --     -    ----      -  -   ----    - -
-      - ---     -  - -  -    -  -   -    - -   ---- - -   -  - - --    -   --  -  -  ----    - -  -
-   --  --- -----         -  -   --    -  - -  -    - -- -      --- -    - -   -   - -    --  -    -
-  -- -  -   - -       --       - --  -    ---   -  -    -    --  - -- - --     --   - -   -  - -- -
-      -   -      -     ---- -  -       -   -  -     -      -   ---   -- - -   -   -- --   ---  -  -
-  -  -            - - -     - -- -  -    -      -   - -  -- -       --    -  -       -   - - - - --
-  -  - -     -   -- -          - -   -- -  -        -  --   -  - -    - ---  -   -    - -- - - -- -
- -            - -    -      -       -- - - --    -- - -           - --  - -  ----   -   --  - --  -
--- -   -  -          ---     -- -   -- --- -       - - - - --   -     --- ---  --  -  -- ----- -  -
-   --     -- - -   -    -  -  - ---          - -- -   - - - - -  -   - -     -   -          -     -
-   -    -    -  -      --  -   - -- - -   -        ---         -  -      -     - - - --   --   -- -
-  --      ---  -  -- -          -  ----     --   -     -  --  --       - --- -  --    -  - - -   --
-  - - - - -   --     - -    - -- --    - --      --   --  -       ---   - -     --- -     -    -- -
--  -     -     - - -  -        -    ---    -    -            ----      - - --- -      -     --    -
-  ---    -----  - -      - -   - ----- - -         -   - --      - - -        - - -   - --        -
-  --  --           -- --- -- - -  --       -         - --    -          ---  -    -   -          --
-  -- -     -- - -- - -  - -   - -   --    -     --- --- - -   --    - -   --    ---   ---      -  -
-  -      - - -     --        - -- -- -      -         -    -   -- - - -  -   -  -  --   -   -   - -
-           - - -- -   -  -   - - -      - -   -  - - -   -  -    -    -    -   - - --  -  --      -
-  -   - ----  -     - - --    --  -          -  -  - - - -   -- - --     -   --   -               -
--    -      -       --  -     -   ---    --        -    -    -      -  -  -   --  -   - - - ----- -
--           --     -      -   -  -   - -    - -       -   - -  --   --    -    ---  -- - -     -  -
-   - --      - -      --    ---  - -            --    - -   -   --- -- -     -   --   - - -       -
-          -     - -   - - --- -         -    -  - -       --  --  - --    -   -  -   -  -   -     -
-   - -  --  - -               -      --  -- -- -    -   -     - - -- -          -  -   -  --     --
- --       -     -- - -    -  - - - -  --  -   -   -      -         -        - --   -  -  -   -   --
--                   -   --       -         - -   -- -     -- -----    -  -    -      - -- -  -- - -
-  -      - - ---       -   -     -  --   -     -- -    - - -  - - -    ---  - -      -  -       - -
--     --    --  --      -    -       - ---  -       -    -  -- - -    -       - - - -  - --  - -  -
-  -  -  -   -     -     -    --- -         -  -      -              -- -  - - -  --- -  -  ---- - -
--   -- -    -  --  -    -   - - -  -  - --        -     -      - -     --  - --     -   - -   --  -
-     - -      -   - --- -   --    - ---       -   --  -- - - -  -  --  - -    -     - -  -      ---
-     --    -     -  -      -      - -   -  - - - - -    -- -   -  -    -      - -       -   -     -
-   -   -----   -  -        -- -  -     --- - --     ---  - -  ----  -- --  --  ------ - -  -   -- -
- -- -   - - -     -         -         -       -        --   -  -   -  -       --   -         --   -
- -         - - -          -  -   ---         - --      --  -  -   -    ----      -    -    -    - -
--     -      --     - - -  -  --      -    -- -        --- - - --    -    - - - -   --  - -- -   --
-               - - -      - -  - ---  -        ---   --     --    -    --  -   --  - -  --    --- -
-   -     -   -   --       -   -- -   -  -   - - -    - --   - --  - --      -  - --   -  -   -    -
-            -     - - - - --- - -    - --    -    -  ----    -     -    - -       -   -   -  -  - -
- - -- --    --- --    -  -     -  - -       -   -   - -       -- -  -         --  - -    - -  -  --
- --      -   - - - -  -    -      - - -  -   -   -  -- - --- -    -    - -  -      -     -        -
- - - -  -     -  -     -    -  ---  ---     - -  - -     -      - - -                         -   -
-          --  ----  - - --    -           - -         -       ---       - --  --           -    ---
-   -   -  -    ----  -    --   - - ---  - - -- - -  -    -  -    -  --     -  -- --  -   - --  -  -
- -  - -   -    -- -  -     -    ----  -    -   -   -   -     ----      -  -  -  -         -  --   -
- -- - - - - -    -  -     -- -       - -  - -        -  - -       -   -     -           - --   -  -
----------------------------------------------------------------------------------------------------
