100
100
----------------------------------------------------------------------------------------------------
-    -   -    -     -   -- -  --     - - -     - -    -     -      -      -        -    -       -  -
- --- -   ---   ---    -   --           -     -     --  -      - - - -  -   --   --    -   -- -    -
-  -  - -     -     - -     -  - --     -     -   -    - --  --     -   -- -   --      - -     - ---
-      --  ---  - - -- -  --   --  -   -   -     -    - -      - - -    -   -  -   -  - -  --    - -
-       -  -           - -   -    - -- - -- - -   - -   ---      -   - -- --  -    -    - - -   -  -
-         - -  - -  --  -                 -      -    -        -                - -  -- --  -    ---
--- --- --  - -    -        -     -  -- --    -  -  - -     - - - -    -  - -  -- - --     - -   - -
-     - - --     --     - --  - -     - - --        -              -  -    -    -    -      -   -- -
-  -          --     --- - -   -    -          ---  - - --  -       -  - -    ---      -  -  -     -
-  -  -         -   - -  -         - -- --      -        -- - ----  -  -    -   ----  - -   - --   -
-    -   --    - - - -    --- -  --- -  -  -    -   -- -   -- -      -    - - --    - -  --  - -   -
-  -   -   -  --  - -  -             - -  -   -- -    -   - -   --        --      - - - -    -    --
- - -  - --   - ---        -        - -  -        - --   -     -        -- -  -     - - - -     -  -
- -        -- -         --  - -  --  -     - -  -   - -   -  --     -    -- -    - --  --      -  --
-                --  -          -       - ---  -   -  - --             - - -       -  -     -  -- --
--  -   - -         -    -   -- -    -  -        -  -   -         - -      -   -        -   --     -
-  -   - --  -   -    ---  -    -   - --   -----     -       - - -      --- - -  - --   -      -- --
--   -     -    -  -     - - - ---      -       - -   -     ---        -- -       - -   -   - -   --
-  -  -   - -    --       -        --   -    -  --- --   --     -   --       -     - -  -    -- -- -
-   ---      --     -  -- -  -  --    - -    - -      -   - --    - -    -       -  -      --  -   -
-                 --    -  -  -        --- --     --- -   - - -     -      -    - -    - -  - -- - -
- -        --   -    ---- -          -       -     -    - -   - --  - -- -    -- -  -      --   -  -
---   - - -      - -         -   -      -- --  --   - -   -- - -    -       -  -     - -       - - -
-- -   - - -  -   --  - -  -  -    -  -     --- - -   ---  --  -     -  - --   -- -  - -  -   -    -
-- --    -   -  - -     -   -    --     - -    -- -   - -    -   --- - -     - -      - - --    - --
-  ---     -- --    -- -  -  -       - -   -  -   -   - -          - - -   - - -     --   - - - -- -
- ---       - - - --  -   - -- -      -        -   -    - -    --    -    -  - -      -          - -
- -   - --    -      -   -  -  - --  - --  --  ---  ---      -  --  -      --    - -    -  -- -    -
-  - ----  --  - - -  -   ---  --   -                   -  - -   -- ---  - -   - -           -- -- -
-        -  -  -    -  -  -  --    - - -  --    -- -        -  -  - - - --   -- -- ----   -  - - - -
-- - -  -     -  --- -  -- -    -- -  -       - -   - ---        -   - - - -   -  - -- -   - - -- --
-      -----   - --   -     ---    -   --    - --  --- -- -  - - -  -    - ---   --   -- -- -- -   -
-   -  ----      -  -     -  -  --  --  - -   - -         -  - --   -- -   -  -      - -    -- --- -
- -   -     - -   -    -  -    -  -   -   - -    -     -   - --- - - -  - -      ---  -   --  - -- -
- -  -   --       - -     - -   - - -  -  - - -  -    -     -- - - -  -    - - -    -  - -   - -   -
- -   -  -  --- - - - ---      ---  --  --  -  -    ---       --    -   -- -   - - ---   -  ---    -
-    - --  --  - -    -   - -      - - -   -     --    --    - -   -     -  -       --       -     -
-  - -   -      -   -      - -   -- --  -           ---- ------ -       -  -  - -  - - - -  -      -
---   -  - -  ---- ---    -- -   --     - - -     ---  -  -     -----  --   --    --    - -  -------
-       --   - -  -          - ---  - --    -    --     -  -- -    - -- ----   - --  -  --     -----
-- --  -  -        --  -- -  -   --   -   --- --- -  - --      - -- -        - -   - - -  - -  - - -
-   --   -  --     - - - -         -    -   --     - -  -  --  -- - -   --  -     -  --  -   -     -
-  ---    - --  --   -- -  - -  -      -  -        -  -  -- - -  -     -  - -    -        --     - -
-- -  - --   -     -  --  -      - -  -      --- -   - -         -       -    -   -  - - -  ---    -
-   -  -  --  -  - -   -  - -       - - --- - -     -- -   -      --- -- - --    -- -    -- - -    -
-   --  -                  -    - -  - - - - -   -- -      -     -  --    --    -     --      -    -
- -  -    - -    -   -- --   --       -   - -----       -        --- - --- - -  -     - ---  -  - --
- - -   - - -   -  --     -  -  --          - -  -   - -    -- -   --     -           -     -      -
-  - - -  ---      -  - - --        -  -- -- -   -  -            -     -- - --- -  ---     - -- - --
--  -          -       --- -   ---      -  -   -  - -     --  --   -- -   --   -  - -  --   -      -
-   -   --- -    -   -       -    -  - - - - --        -     - -     --    - - -    - -  -- - - - --
-  -  -  ---   -       - -         - -                 -- -  - -    - -- -    - -     --  -   - -- -
--   --  -       -    -  - --   -      -   - -    ---     - - - -     -  - - -- - -  - --          -
- - -  -- - -  --- -  -  --     -   --  -    -  -    --    -      - - --  -  -  -   - ---        - -
-  - ---     - -    -  - -   --                -   -    -  -    - -  -  - - -   - --  --    -   -  -
- -    - - -- ----  - ---  -    - -          -- -- -  - -   -    --  -      -- - - -      -  -     -
-   --- -         --    - -  -    - -       --          --  - -  -     -   -  -         --    - -  -
-    -    -  -  -    ---     -  -         -   -- -  -    - -  -   -  -  -------- --- -  ----  - - --
--   -  -   ---- -        -- -       -   -  -- -  -- - - - ---        -  -   -   -      -   -  - - -
--  -  -   - --   --  -  -  - -    -  -     -- -             - -   -   -  -- -    -  --   -        -
-       -      -         -       -        -  --      -    --  -  - -     -   -  --  - -    --  --  -
-         -    -  --      --   --  -   - --    -     - - -   -  --     -   -- -   -    - -   -     -
--- -   -  -    ---    -   -- -       -   - -        -- -     -      ---  -      - -- -    -   -   -
-     -        -    -  -        --- - --- -    -  -   - --     -         - -  - -        -   --  - -
--  -   ---    -         -   -   - - -   -- -           - --      -  -  -            --   -  - -   -
-      -           -- -  -  --        --  -  --  -- ------  --      - -    -  --- -     -  -    ----
-   -    --  --- -       - -  -- - -  - --   - --  - -    -        --  -   -        - -- -     -   -
-- -   -- - - - -  -- -   -- -     --- - -       - -   - -         - -  --   -  --     -- -       --
--  -   - - -        -    --  - ---    - --    -   --      -       -          -  -- - -   - - -    -
- -  -    - -  -      -  --   - -- -  -    - -  - -   -       ----   -   -  ---   -     - -  - --  -
-     --  -   -- --  -   - -  - - - -     -  -      -    ----     -   - - -   -  - -- -     -      -
- -  -  -   -   -    - - --  -  -- - - -   -    --- - -       - -   -   --  -- --     -  -  --  -- -
- - -    -   -  - -- -  -    -- -   -   --  -              - -  -  -- - - --           -- - -  --- -
--  - -   -     -     --                -    --    -  - --  - - -    - -  - ---     - - -          -
---  -  --      ---  --- -      -       - - - -      -   -  -      -           --  --       --  -- -
-   -  - -  - -     -   -- -     - -  - -  --             -- --  --  - - - -- -      - -     --  - -
-  -- -  -            -- -     ---- -          - -  -  -    -    - - - -    -- --   --      -     --
- -           -    -   -- - --              - -      -    -  - -  -      -      -    -          -- -
- -      - --   - -  -  -   -  -   -     --   - -   - ---   - - -- -  -     - -  - --      - - - - -
--    --   - --  - -       --  - - -       --   - -   -   -         - --       -    --  --      -  -
-    - --   -  -    -           -- -- - ---   --      -   --  --     --  -   --  --      - - -   - -
- -  - -    -     -  -       ---  -          - -- -    -   -   -   -    - - -- -          - -- -   -
--           --   -      - - -   - -- - - --              -    - -   - ---        - -- - --    --  -
-     -   -   - -    - - - -    - -   - - - - --   -   -       ---  --    - --  - -  - -    - --  --
- -  -  -   -  ---     -    --   -   -   ---  -  - -  -     -    --   -- --  -- - -    - - ---   - -
- -   -         -   -    --   - --  - - -  - -    -        -        --     -          - -   -  -   -
--   -    -       - -     -  -  -     - - --    -- --      -    - -     -   -  --- --       - --   -
-  -  --         --- -   -   --     -  --     -- -     - -  - --    -        -  -                  -
- -  --   -  -    -   -  -       - -- -  --  -  -            -  --   --   -- ---    -- --        - -
--  -    -  -  - -    -              -  -      - -  --  ---- -   ---   -      -      - - -    -    -
-    -      --  - -    - -    ----  -- -  ----  -- --   -  -    -                  -   - ---- -- - -
-   -- - -     -      -- --  -  -       -     -           - --   - -  -  -    - -   - -  ---  -   --
-      -  - - - - - --   -    -  - -   -  --    -      -  -  --  -        -  - -  -  -        -    -
- -  -   --       -     -  -   -    -        -     - - -    -     -         --  - -  --     -   -- -
-   -   -                -      - --    -   -      -- --     -  --  -- -    -    -    -  - -       -
-  -        -  - -- ---     -     -     --  - -    -   -              - - - ----  -- --  -  -      -
-  -   -            -- - -  -- -   -  - -  -  - -    --  -          --   -----   -    - -       -  -
- -     -        --      -        -                    -      -       -      -  - -       -   -    -
----------------------------------------------------------------------------------------------------
