100
100
----------------------------------------------------------------------------------------------------
-   -   -   -   ---         - -         -    --- -  -           -   -      - --       -       -    -
----   -    -  -   -  -        -     -     - -   - -       -  - -      - -   -        -  - -   --- -
-   -   --  - -              --   - - - -  -   - --    --- -  -  --      - -  --  --  -     -    - -
- --            -         ---     - - -  -  -- -   -- -        - -- --  - --    -     - -      -  --
-     -   -     -  --    -   - --  --   -  -                   -   -  - -  - -- --      - - -    - -
-- -- -     -  -      - -  -  -- --  -  - -     -  -- - - -   - - ---   --   - -    --    -    -  --
--     -     - -   -    --       -  -   --     -- - -   -- -  - -    -- -   -- - -   - --        - -
-   - -      -   -- -   - -  -   -    -   - -  - ---   -  -  ---  --   -    - -   --  -   ---  -   -
- - -  -  - - -   -  - --- --       -    -   -   -   --- - -   -  -    -   -  - -    -      - ---- -
-     -  -  - - -                       -  --  -  -       -  --       - -- ---      --    - --     -
- -   -      -       - -   -    -    --  - --  - -- - -       -  --    -      -  ----       - ---- -
-  ----   - -         -  -         - - - - - --    -      - -      - ---  --           - -      -- -
---  -       - - -   -  - -  - --   --  - -   -        -      --        --      ----       -   - - -
-            --   --  - -- ---     - -        - - --   -  ---      -    - - -       ---        - - -
--   - -   ---- -   -       --            -    --    -       - -  --   -  -- -  --   -    -       --
-  - ---       -  -    -      -  -   - - -  --     --  -  -     -    -            --    - - -    - -
---   -  - -      - -   -   -        - -     ----- -    -   --    -    -  - - -             --   - -
-   - -  - --  - ---  -- -   --           -- - - -  -  -    - -    -  - -  - - -   -- - --  ----   -
-  - - --  -  - -           ---       -     -    --- -        --  -  --    --  - -     -   -       -
-- --  -          -    -- --   -      -       - -      -   -  - -- -  -    - -    ---         -    -
-      - --  -            -   - -      - -        -      -   -  --  -   - -- -    -  ---   -    - --
--    - --       -       - --   -       - --   --    - -       -     -  - -    - -   -   - -   - - -
-    -          -  -  -        -   -   --    -    -  - - ---    - -  -- -  -    -  -  -   - -     --
-- -- - - -     - -     -    -  -     -  -      -  - ------ -   - -   - --   -    - -   - - -  -   -
-   - -    -   -  - - -    --      --   -  --   - -          -   -   - -     -   -- -- --- --   -- -
-   -   -   - -    -     -  - - -       -  -          -----   -- -     --         -- -   -  -     --
-                -    -- -    - --   --          -    -- -        -    -- -   --    - -----      ---
- -   -      -   - --      -  -        -   --    - -  --    - - --    -    -      -    --   ----   -
--    -- - -  -- - - -  -    -    --   --     --      - -  - -   ---- -     --      -    - - -     -
-   - - -    - -     -  -     - -   - -   - -  - -- -      -  -             -- -     -            --
- -   - - -    -   -  - -      -       ---      -  --- -    -    ---- --  -      ---  --    -   -  -
-  -     - -         -  --  ---  -  ----   - - - --      - --  --      -  -  -                ---  -
--   -  -    - - --- --    -  --         - --  -  ---        -    --  -  --   --  -  -- --  - - -  -
-- ---  - -             -     - - -    -         -  -  -   - -                   ---- -   -- - -   -
- --  -   - -- --- -  - --      -    - - - -  --         - -- - -        --  - --    -     -    -  -
-- -  -   ----   - --  - -   - -       -   - - -- -  -       -  -- - - - -   - --   -- - - -     - -
--        -    --  -      -  --       -  - - -  - -       ---  -    -  -   - -           -    ---  -
-- -  ---    -  -  -   - -    - -  - -  -     - -    - - - --- ---        -- --   --  --    - --   -
-    -  ---  - -     - - - -     - -   -   - -     - -   --   -   - -- -    -   - ---          -- --
-  -- -  -  - -   -   -    - - ---   -    -       -       ---    -  -  -  - -   -    - -  - -   -- -
-       --             -    -      -- - --  -  -   -      -    -   -- --     - - - --  --   - -  - -
-   - - -  - ----  -   -  --- -   - - -        - - -    -      --    -   - - -   -   -    --   -   -
- - --      -  -- - -  -- -       -     -       ---  - --  --         ---    -  -    -     --- - - -
--    --   -  - - -       --        ---    -      - -   --   -      - --    --  -- -- - -    -  -  -
- --         -         -  ------           --   - -- -    --  -  --- -  - - ---   -     -   -      -
--  --     -   - -                    -- -  -   -- --   -    ----     -  -  -    -   -       --    -
- --      -  -  - -    - -  - -         -  --        -       - - -  -  -                 -    --   -
- - --  -    -      ---  --         -    -  - -- -  ---  -- - -          -  -  -         -- -   -- -
- -   --   - -   -   - - -   - - -    -    -         -      -                -  - - - - - -  - --  -
-   -   --          -         - ---    --  - -   - - - -- -   -         - - -         -- -- -  - - -
-           -   - -  -      - - -   --     -  ---  -      - -  - - - --  -  -      -      -  -     -
- ---         - -      -- -    -- -  -           -   -  --      - -  -               --- - - --  - -
-  -  - - --  -  -            -     -    -  -  -   -  -      -        --   -      --    -  -     - -
--- - -  -  -   -  -- - - -  -  -    -   -       -- --- --- -- -       -     - -    --   -  --     -
- - -   - --    --      -  -- - -   --  - -   -           -      -   --  - - -   --        ----    -
-   -- --       --- -    -         - -- -- -- -  --    -- - --    -  -- --   --      - - -      -  -
-- --      -    -- -  ----   ----  -           -    - - - -        -   -- -     -    - -        ----
-   -  -----   -    -     --   -  -   - --   -   - -   -      -- -  --- -     -   --    - -  --    -
- -- -     -         - -     --     - -   -     -      -   -     -   -  -    -  - - ---  -      - --
-  -  -  - -  -         --                -  -     - -  -   -    -- -- -    - --  - - -    -   -- --
---  -  -         - -      -- - - - - -      -   -   - -   -      -   -  -   -  -         -  --  - -
-   - -  -- ----      - -     -     -    - -     - -     -   -  - - -- -  -    -     --     -- - - -
-- -   -- --  -   -        -  - -  -- -    -  -  --  -   -      - -- --  -   --  -        -    -   -
-    -    - -  -   -- - ---  - - -  -  - --   -      --       --   -       --     -          -  -  -
- -   -   --    -     - -        ---  -  -    - -- --- -        ---  - -   --     - -     -      ---
- -   - --  -    -       -  - --     -- -  -  --  -       -      -       -  -   -    -    -        -
- - - -  -      - -  ---  --    - --  -  -  -               ---   -    -       -- --   -- -- - -   -
--        -- -  -- -  - --    -     -   --         -     -      - -   -  -       -           --  - -
- --    -   ----    -   - --  -  -   -   - --- --    -  -- --    -  --   - -       -      -     -  -
-   -  -  -     --   - -- -  -- -      -     --   - - -  -- -- -    -    -        -        -      --
- - -      --      -    -      -- -- --- - -   -   --  -     - - -       -    - -   -  --         --
-- -     - --  - - ---       ---    -  -          - - -  -   - - --    --      -    - - -       -  -
--  -- - - -    -- -      - - -      -      - ----     -  ---    --        - -    - -  -    --- ----
- - -         --  -    - -  -     -    - -- -    -- --   -    -       -   -- -     --- - -     --  -
-- -       -     -   ---  -  - -   - - -     - -         -  --  -     - - -         -   -   --   - -
--   ---     -      --  -- --           -- -       -    ---- ---   -  -    -   - ----       -  -  --
-- -   -    - -           - - -- --- --     - -- --   -            --- ---    --    -- -- - - -    -
--  - - -   -      ---    -               - -   -   -   -  -      -     --     -  --  -  --     -  -
- -     - -       -   -   - -  ---  -  -      -- ---   - -   -      -- -     -  -    -  -  - - - ---
- -   -  - -- -     - -  - -    -  -    -    -  -      -     ---       ---  -     --   -     - -   -
-    -  -   -   -- --   -    -  --      --  - -  - - - -- -   - -- --      -  --   -    -    - -   -
--- ----  - - -  - --      -  - -- ---    -      - - -  - -  -  -      ---   -   -- - -   -  - -   -
- ----- -              --       -   -      - -     - -             --  - -      -     -  -    -  - -
--    -   -  -      -- -- - - - -             -  -  - - -   -          -  --  --  -- -  -   - ---  -
-  --- - - -     --  -     -      -   - - -  -  -- -  - -   -     - -  - - - -      -       - --  --
--    -    -    -       --- ------   -- --        - -       -  -- ----- -  --  -   ---- - -- --    -
-  --  ---   -- -  -        -      - -  -   - ----     - --- -     -   -  -  -        -- -     - - -
---  - - --- -   - - --   -     -      - - -   -    ---     - - -    ---      -- - --    -      - --
-   -  - -   -           -    - - -   -  - -  -      ---  -            -     -   -       --      - -
- --     -- -  - -- - --       -  -  -        -          - --  -- -   - --  -  - - -- -     -     --
-   - --   -    -       - -- ---  ---- -- -      - --     -       -     -- -   - -               - -
- -   -   -   -      - --   - - -       --  - -   - - -  - --   ---   -   --    - ----      --   - -
-  --   -    -   --      --    -- ---    - -   --   --     - --     - ---   - -   - -        --    -
- -      -  -  -    -  -   -        - - -  --  -       -       -   - --- ----    --  -----    - -- -
-         -      -- ---     -     -- --  -- -   - - -  --    - -  -   - -  -  - -  -    -  - -- -- -
- - -- - -    ---    --  - -    -  -        -   -  -   -  -   -      -  -  --   -     -  ---   - - -
-     --    -     - - --    ---  - -       - --  -    -     -   - -- - -   -     - --    -   --    -
-     -  -  --   -       - -         -      - -   -   -    --           - -  -   -  ---    -       -
----------------------------------------------------------------------------------------------------
