100
100
----------------------------------------------------------------------------------------------------
-     -- -- --       --           -  -     - - -                - -   -     -  -     -  -  - --    -
--  -        -  --   -  - -    -  --  ---   - -    -     -  --   -      -- - -- --   ---    -- -   -
-     - -   -  -                         -  --           -----    - -          -   --  - -  -   -- -
--    -  -      ------    -    - - --          -- -  -  --         - -- - -  - -  -   - -    -   - -
-    ---             - --- --   -- -     -   -    - -     -      --- - -  -  - --    -   -- -  -  --
- - -       ---    --            - -    -  - --- -       -        -       -  -             -      --
- --      --   -       -  -   - -        -  --  -      -    ---   - -       -     - - -    -  -    -
-   -- -  - -   -      -- -  -  - -  -   -       -       --    -  - ---  -     -    - - - -      - -
- -      -  -   -   -   -        - -           ---  --   - -- - -      --- --        - -     -  -  -
-   -  - -   -     -  - -   --  -  -   - -   -    -- - -     - -      -   - - --   ----  -  -  - - -
--  -      --   -   - -   -   - - - -  --  -        -- --    - -        --    -     -- --    - --  -
-   -        ---    - --  -   - -   - -  ---    --  - -     - - -   -       -   - -- ---    - --   -
-    -     ---  -   --     -         ----    -         -   - -- -   -- -      -    ---   --  -    --
-    -    -   -         --     --  -- - --   - -    -                   - -   - --     - -    -    -
-   -    -  -     -- -  -  -       -  -  --   -       - --- -  - -      --  - -    --        -     -
-   -- -- - --    --  -   - - --- --   -   -    -  -          -     -          --     - -  ---     -
-  -                --  -     - -  -   -     -  -   -- -    -   -   -        - - - -  - -      - - -
-   -    -- ---  - -    -  - -    ---      -   -      - - -  --  - - -    --    ----  -- -- -- -   -
-   -                                -   -- - -   -----  -      - - ---  - -   --       -        - -
-     -       - - -- ---    -    -     -   --  -   -   --           -  -         --     -     - -  -
--  -   - -   - - - -   - --  --     -    -      -       - -- -    - ---    -  -  --    -          -
- - - --           - - -     -   - -   -         --- --       -- - -    - -  -- -     -  -   - -   -
-     - -   - - -   - -      ----- - -  ----     -           -- ---  --           - --   -  -    - -
--  -  -     -    -   --      -      --   --    -    -     - --        -         -  - -     - --   -
-     -  - - - -  -  -  --  --  -- -  -    - -    -  - -  --  - -  - -    - -  -   -  - -  - -     -
- --   -  -   - - -   -- - -     -  -- -     --       --    -  -  -  - -- -     - ----          -- -
- --   -     -    -- - -     - -   --     - - -         -   -   --    -- -   -   -  - -     -- -  --
--   -- -       -       --     - ---   - -  - -  -    -  --     -  - - -- --    -    -  -   - -  - -
-  --  - - ---     -      -    - ------ -  -  --  -  -   -      -   --   - -      -     - -  -   - -
--  ---  --  -      -     -   -- - -       -         --- -      - -    ----- -  --- --      - -  - -
- -   --   -  -    -- -- -              -    - -   -    -   - -     --      -   - -      -         -
-    -     -        -   -  - --  - ----   --    -  -  -  -     --  ---   -  -      -- --    - --   -
-     -     -   -- - - -      -    -  - ---        - - -- -  -    --  -               - --    - -  -
- - - -    -  - -- -    - - -  -  -   -    - --        - -   - -- -   -    ----           --  -- - -
- --- -     - - -  --  -  ---   -  -    -----  -- --   - -             -   - -  -     ---      -   -
--    - --           - --            --   -  - -         -- -  - ---     -   -   - -      - --   - -
- - --  - -      --- --      -  --   -   - --   ---  -  --           - -      -       -   - - --   -
--- --   -      -    - - -    --  ---            -- - -     -     - - -    --     -   -  -  -  -   -
-      - --      -  -- -         - -    -  -  -    --     -      - - -  ---  --    - - --- -- -  - -
-----      -- - -      - -   -    -  --       -  -   --- - -  ----    -       - - - -     --- ---  -
---   - -         ---   --   ---  -   - ---     -  -    - -           - -  -       -- - ---- --    -
-    - --  - --      -   --    -- -   -          ---- -      - --   -   -       - --  -     -    - -
----  -    -   -        -  -   --  -  --   -           -  -        --      - -        -   - - - -  -
----     - --    - -  -  --  -    -  - ---- ---   --      -     - --  --     - - -    -     - -    -
---       - -   - -- ------ -      --- -  -         -   -- -          -  -       -  -    -  - - -  -
---         -               - -  -  -   -   -- -   --  -    - --- --  - - - - --      -- -   -     -
--   - -  --   --   -  --     -   -       - - - - -  -  - -     - -  -   --   - - -- -   ---  --   -
-     - ----   -    - - --  --  -- -  --   -  - -- - -    -            -   -    -  ---    - -   -- -
- -  -       -         -    - -    --  --      --- -    -- - ---  -   -   -   -  -   -     -  --   -
-   --- - - -   -    ---      --  - - - -    -       --        - -  -    --    - --   -       -    -
- -         -    --  --   -- -       -    --- --  - - -  --       -  - --   - - -  -    - - - - -  -
-       -  - - - -     ---     --  - -     --   - -  -   - --  -   -      ---    -          --   - -
-      - -    -  - -   -   -  -     --        -    - - -        -    --- -  -            -  -      -
-      -- -- -    - -   --   - - - -  --    - - -   -   -  --  -          -      -    --       -  --
-   -     -             -   -   -  ---- -  ---  -  - ---     ---   -   --             -     - - -  -
-  - --   -     -  -   -  - ---- -     ---  -    - -   -  -    -- -     -     - - - -   ----  - - --
--  -- -   -    -  --  -  -  - --  --      -    -  -    - -  -    -      - --    - - -- --  --  -  -
- --     -    -   -  - -        -   - -     -   - --  -        - -     -   -   --- -    -     -    -
--   ---    -   -     -    -     - -   - -  -- -    -----   -  - -   -    -   - - -      --    - - -
-  - -- --  -  -  -  -       -   - - -- ---     -         -  -  -    -  -     - -   -  -    -- - - -
--  -  -  - -   - -   -    -      -  -  -   -- -       -- - -- -    -  - -  -    -  -            - -
-     -     -  -- --   - - - ----       -- -  ---     -  -     - - -  -    - ---       -     - - - -
- -- -  -  - - -  -- -  -       -  - --  - - - - - --    -       - - -  -  -  -      -  -   -      -
-    -  - -- - - -    ---- ----  -     --    -       ---  -      - ---        -    -  - -  -   --  -
- ---   --     -  -- -    -     -        --    --    -   ---  --      - - --       - - -   - -   - -
- -     -    - -   - - - - -  -       -  --    -  - -  - -       -  -  -  - - -  -  -  - -    - -  -
-     -  - --  --    -    -        -- -    ----     -        --      --  - -     --  - - -   -   - -
--  -  -  - -     - -    --  - -   - - ---  -- -         --     - --      - -          - -     -   -
-       ---      -   -    -  - -       -           -- -  - --  --- -     -      ----     -   -  ----
-           - -  -    -   - - -   -   -  --     -       - -  -   -      -   - --- - -    --   - -- -
-   -  -    --  - -  -  - -    - -  - ---    --  --- ------ --  - - ---   --       ---- -   --   - -
-    -    ---  --     -   -   -      -       - - - -   --        -         ---    -      -      -  -
- - - ----   - -  --- --      - ----    - ----  - -  -      -   - -- - -- -  -     - -  -  - -  -  -
-     -  - -    -    -    -    -- -      -     - -  -  --    ---- --     - -- -     -     -      - -
- -  -   -          -   -   -          -  -   - --  -  -   ---  - - -  -  - -     --  -         -  -
- - ---    -   -  -   -  -- - -- -     -- - - -- -    -   -  -   - --         --    -       -      -
- - -  -  -  -  -  - -          ---    -     -  - - --   - --  -      -        -  --    -   - ---  -
-             -   - - -      -  -              -  -     -          --      -     -     ---   - -   -
-  -    - -  -   -  -            - ---  -- - --    -   -  --  -     -     - -  -   --   - ---   -  -
-   --        -- - - -    --   -      -     --  -    -  --     -- - - -  -- -- -- - - -         -  -
- -     -     - -      ---   --    --- -   - - - --          -          ----     - -  -- -     -   -
-    -  -    -- - -  -- -  - -   -          -  --  - - --       - - --       - - -   -- -        - -
- -  - -          --     -  -  - ---     --- --- - --- --   ----  -     -- -  -   -   --  --      --
-   -    - -  -        - --  --         -  -    -  -  -  -          -  -        -  ---- - -       --
-   - - --    -      -  -        -       - -   - -    - -   ---   - -  - -                -  -   - -
-      - - -  -    -    - -    -  - -  - -   -  --  - - -       --  - ---- -   - -    -- - --  - - -
-                   -  -     --  -       -   -      -- -    -  -   - -         - -- -    -- -    ---
- ---     -   -    - -    -- -     -- --- --- -            -  -       -  ---  - -   -- -- -    -   -
-- - -  - - - - ---- ----   -      -     -  --      -   --- -  -- -  ---          -- -- - --       -
- -- --  -  --- -   -      - -  --   -          - -     -          -    - -     - - -           -  -
- -            --- --    - -   - --      --  - -      - - -   -- --    -  -   -    - -  -    ---   -
-        - ---    --- -   - - -    -      --     -- --   -  -- - - -- -  -  -            -    - -- -
-       - -  -     -   -    -     --- -- --   - -   -        -   -  -    - ---  --       -  - --   -
- --  -  - --     - -        - -    -   - - -   --   -   -        -   -   - -  - -- -  -  -        -
-             -   -- -           - -    - - -     -  - - -   -  - - -  - --- ---- - - -   -      - -
- -     --         ---    - -   -   -       -- ---     -   -     - -      -      - - --- -- - --   -
-   -- -  -    -    -     -  -  - -  - -- ---        ---   - - -     -- - -  -  --        -     -- -
- - -    -    -      - --      -  - -    -  - -- - --   -     - -    - - -    -      --  - -- -    -
----------------------------------------------------------------------------------------------------
