100
100
----------------------------------------------------------------------------------------------------
-   -  -   -    - -     - - --    --   -- ---  - -    -            -    -    --   -       -        -
-        --    -    -- - -  -  - -    -     -   - - - -  --   - -   - --  -     -          --   -  -
-- -- - - --  -- --          -- -  --     -           -  - -      --  - --      -  - -- - -- -     -
- - -       -  -       ---    --     -   - --      - -      -- -     -    -    -    -    -  -  -   -
-   -   -   - -  -        -- -     -   - -  -- --   -         - -      -     -      -  -         - -
--    --  -   -        --  -  - -   - -     -- --          - - -   - -    -- -    -    -   -     - -
- -          -     - -   - - - -     -    ----- -- -    -         --      ---    -   --     - -   --
- -    --- --- --  -- - --       --   -    -      -         -  ---   - - -  -  - - -    --     -   -
-  --    --- --     -            --    -  - -- --    -      -- - -    - -  - -   -- -  -       -  --
-            -    - -       - - - -- -       -  -  --- - -      -   -     --    - -  -  - -  -  -  -
-- - -  -   - ---    -   -- ----  -   -- -   -          - -   --- - -   --   --  -  -  -    - -   --
-   -            -   -   -     -    -    ----  ---  - -   - --     -- --       -- - - -   -  -  -  -
-  -  -     -            ----      -              -   -    --- -  -   -       -         -       - --
--  --   -    -  --    -  - - - -      - -   - - - -  - --- --- -   -  - -  --  -   -  -  -  -     -
-   -   - -      - -     - -- -   -  --  -- -  -     - --        - ---  -        -  -- --  -  -- - -
-    --                  ---    --   - - - -  - - -- -    - - --  -     --   - -  -   -   - --- -  -
- -          - --- -  -   - - - -  -    -  -   -      -     - -   --        -  -   --  -          --
-      -  -      --    -- - -  -   -  -  -             -  -           -  ---    -    -   -         -
-- - -     --   ---   - -- -       -  - - -  - - -  -   - --  -- -  - -   ---  --   - --  - -   - --
- -     -  - -  - -- --  -  -    -  -        -   -    -   -        -    -    - -   - --   --   - - -
-    -         --  -- -  - -       --- -    -  -    -  -      -  -  - -- -  - -             - - - --
- -                 -  -  -    --     -   - -    -   ---  -   - -  -  -  - - - ---  -     -     -  -
- - - - -        -  -     ----     -   - - -   - -  -   -  --- -  -  - -          -   - -  --      -
-  -     -   -       -   -  -  -     - - --    -  -- -  -  -    --- - -- --   - - -   -  -      -  -
- --    -           -   --  - --  -   --  --      - -         - -  - --    -    -  -   -           -
-   -           -     -   -     - -  -  -     -    ---        -    -  -   ----  ---- -   --    - - -
- - -    -   ---- - -         --   --   --  - ---- -  --  - --      -  -           - -  -  -----   -
- -        - - --     -- -    - -   -     - -    - -        - -- ---    - - - -   ----- -   -  -   -
- -  -  --     - - ---          - ---- -- -   - --  -  -     - --    --  -     - --   -   -   -    -
-  -  --  - - --    ---   -            -    --   -          -     ---        --      -   - -  -  ---
-   - -- -  -     --   --        --   - -   - -  - -  -- -  - - --  - - - -  -  -   -  ---  - -    -
- - -  --- -- -   -- -      -            -  -    -- -    - -    ----  - -      -    ---   - -   -- -
-   - -    -  -  -         -  -- ---   - --    --   - --  - - -  -  -  -- -  - -   -  -  -   -     -
--      - -  - -     -- - -     -- --   -    -   - ---- -  -   -   - --          ----  -  --- - -  -
-- - - -    -        - -              -      -        -     - -  ---  --  -- -   -    --      -    -
-     - --- --  -         --   -  -     - -       - --  - --  -     -  - -        ---      -  -    -
-  --  - -   -      -   -      --  --    -  -  -     -  -    -    -         --            - -  - - -
- - -     -- -   - - --     -          ---   -- -     -    -   -- - - - --- ---   -  -  -- ----- - -
- -- -  -  -   -        -  - -    - --    -    -   - - -    -- - --   -  -      -  ----   -    -  --
- -   -  -               -  -  -     - --- - -     -  - -   - -- -- -    -    -   -  -    -      - -
-  --- -  - -  --    -- ---  -     --   -   - --    -    -- --        --   --   -    -      -   - --
--   - -   -- -   -      - -         --   -     - -  -- -         -       - -   -      -     -- -- -
-- - -  -       -  ------       - -   -      - -    - ------ -     --        -      -   ---   - -  -
- -       - -   -          - -  - --- -   -    -  -      -       -      ----          -    -       -
--      -  --     --- - -    -- - --  -  -  -    -    -   -- -   - -- - -  - -     -    - -        -
- -   -   -  - -- -     -       -  --   - -  -    - -  -      --  --  -    -    -    --    -      --
--     ----        -- -- -       -- -  -   -    -- - - - - -- - -- - -  ---      -   -    - - -- ---
-       -  --   --       -  ---      -         -   -      - -  --     -  -  -     - -   --  -  - - -
--      - -  -    -     -- - - - ----  - - -     -  -    - -    - -  -  -   -  - -        --    -  -
--  -     -  -  - -      -- -    -       --    -- - --   - -    - - -    -       -  -  -      -  - -
-   -  -   -   -       - -     -   - -    -    - -- -  --   -            - - - -     - - -     -   -
-    -   -  -- -      --  - ---  -   ----   --    - - - -   --  - - - - -- - - ---          - -- ---
---        -       - - - -            -  -       - -   - --   - -   -    -       -- - --  -  -  -  -
--   -- - --  -  --     -   -- --  - -     --    -  ---  - --     -- -      --      - - -   ---    -
-           - -   - ---       -    - -    -  -     -      - --      -  -      -  -- --     -  --   -
- - -   --    -  --    - -  -   -- -        - -        --   - - - --- -   -  -    -  - -     - - - -
-     -       -  - ----- -  -         -     -- - -  -   -- - -   - -        -     --    -      - - -
--  -      -     -      -     -  -     --  -- -         --  -              -  --- -     -     - -- -
--  - --  --  -      ---   -   --  - --     -  -- --- - - - - -      --   -  - -- -  -  -   -  --  -
-- --       - - -  -  -  - - --  -      --   --      -    -   - -     -    --       -      -  - -  -
--  -   -  - -- -  -      -     - -- -   - -  - -   -----     --    -  -       --  -- --   - --    -
- -  -- -  -     - -       -    --    --    -    -    -   -      -           -  -  -       - -  - --
--- --    - - -  --  --       -    ---- - -    -- --- -  -  ----   --  - --    -     -  ---     -  -
-    -- ---        - -  -   -  -  -  - -    - - - -- --  -   -  - - -- -  -      -  -  -    - - - --
-  --   -  -     -    --  -  -   - --     -     -  -    -   --  - --        - --  ---   --   -     -
--  - -- - -   -     -        -         -      - -- -  -  --  -    -  - - - -  -         - - - - - -
-  --   -    -    -   -    -   - --   -   -   -   -      -  --  -  -  -      -  -        - -     ---
-    ---            -    - -  - -      -   --    - --  --    - ---      -    -  -    -   -        --
-           - -     -  --   -   -- - - --- -         -     - - -               - ---  -  -   --  - -
-   -  -  -    -               -    -   -  -     -    - -    -    -  -            -        -  - -  -
---- - - -    - -     - --    --  -   --  - -  - -    -  - -- -  ---    -    ---  - --     -       -
- -  -    ---  --    -   - -   - -- - -  -- -- -    -  -      - -  -               - --      --  - -
-   -   -    -  --    -     - -     -    -  ---  -    -     - ---      --    -  ---    -  - - -    -
-    -  - -  -   -   -        -     --  - -          -  -     --  - - --  - -     --      - -      -
--  -  - - -  -  -      ----- -    - - -  --   -  -     -   --- -   -               -- -  -  -   - -
-   - - -  - -  -- --  -  - -    -    -   -    -   --      -     -  - -      ---  - -      - -     -
-  --   -  ---- - -   -   - -       --   --     -   ---  --   -  -   --  -  -   -    -      - -  ---
- -      -- ---            -      ---  -   -  -      -  -     -   ----    -    ---  -  -  -      - -
-      -    -  -- -  ---      -  - ---         -- - -- ---- -    - -    - -        - - - -         -
- -     ---   --   - -     - --    -  ----   -   -       - -    -        -    -  - -         --   --
-   --- --  - -    - - -   - -   -  -    -          -   - - -     - --       --  - -- -- -- -      -
- -  -     - --     -            -     --   -    -  ---  -     -           -     - --   - ---      -
- - -   --   -   --- - -   - -  -        --     -- ----     -- -   -   - --- -- -        -    -  - -
--   -   -   - --     - -     -  ---- --           -    - -     -  --       -   - -   - -  -    - --
-      - -  -  ----   --  - -    -     -- -    --      -   -   -      -     --    - -    -- --- -  -
--- -- -   -  - -- -   -    -  -    -     --         --  --- -      --     -   - -- -     - -- - - -
-   -   --       --  - -     - --  -  -      ---   - -   -  - -   - -  - --   -  -- -      - -     -
- -    -       - -- - -  -   -     -  - --  - - - -  -   -        -   -        -  - --  -  --      -
- -     -    -    -  -  - -  - - - -      - -       -    --  -  -    -  -----    -   -- --     -   -
-- --  -  -         -     - -   -  - --    ---      --    ---  --       -    - - - -- - - - --    --
-- -- -      -- -      -  -     ---- - --     -        - -   -- -  - -        - --  -   -- -  - -  -
- -- -- - ---  --       --- - -    -     - -  -      - -- --  --                - --- -    -- -  - -
-   --  -      - -- -  --  -       - - -- -  -  -   -   - -  -        -       -   - -    -    -    -
-      - - -  - - -- -   ---  -          - - -       - -    -- -    - -       -  -- - ---   -  -- --
- -    -  - - -  --   --   - --- -  - -          ---   -- -    -- --    -            -     -     - -
-  -  -  -   -      - - --    --   ---  -- -       - - -    ---   - -   --    --       -      ---  -
-        - -    -         -        -     -     -            -     -             --       - ---    --
-   ---  -          -    -  - - - -       -    -  -      -  -    -   -  -   -- -       --     -- - -
----------------------------------------------------------------------------------------------------
