100
100
----------------------------------------------------------------------------------------------------
- -          -       -  - - -- --     -- --   -  -  -  - -- -  -                ----   - -  -  -   -
-        - -- -  - -  - - -   -    --    - --     -    -    - - - -          --       -   -- -- -  -
-  -         -  -   ---  -   - --  - --       -  -    - -- -  - - -   ---  -    - --- --    -    - -
--     -    -       -  -  - -      -    -   --  -     -   - -   - --     - -  -----  -         --  -
- -        -- -    -     - -   -    - -- --  -      -    - --  -- -   ---     -    --      -       -
-   -  --     ---      -    --- -  -           ---   -    -   -- -  -  --      - -   -    -   --  --
-     -       -    --  --  --      ---     - ---   -- - -     - -   -   -   -     -        - -   ---
--      -           --  --    ---       -- -           -  ---   - --  -       - -  -- - --    -  - -
-   ---  --  -     - -   - -   --  -- - -  -    -   -  -- -     -    - -    ---   -      --      - -
-       - -  --   - -      -  -  - -        - ----  -  -     - -- - - -  -        - -       -  -   -
-   - -   - -  -- -  --   -   -       - -- --      -  -   ---      -  -  -   -  -  - -   - -       -
-    -  -   - -   ---      - -   --         -- -      -  -- - -    -      --   -- - - --    ---   --
- -    -  - -- -     -   -         -  -   -  - - ---   --   -   ----   -- -  -    -  - --         --
- - -----    - ---   -   -     -  - -  -- -     -  - -    - -              -   --  --- -   - -  -  -
--      - -        -  - -      --      --    - - -- -   -      - -   -- -  -              ----     -
-- --   - -       -    - -     -     -      --- -    ---   - - - -   -  -       -- --  --  -  -  - -
-  -     --- -  - -         -          --   -  -     -  - -  -- -  ---    -      -            --  --
- --    -    -  - -   -     --    -  -        ----  - -- ---    --    ---    -  -   -  -         - -
-   - - -  -    -    - - --   -     - -- -        -  --- --- -     -      - --  -   -      -  - -  -
-  -  --    - -   - -  - -  -- -     -   -      -  --            -  -        - -  -- -  --    -- - -
-  -    - - -     ---    -      ----  ---   --    - - - -- -     - -    -   --     -   - -   - -   -
-    -  - -  -   -      -   -        -  -      -----     -  --  -     - --  -   --  -  -  -    - ---
-            ----  - --- -   -    -    -    -       --    -  -   ----    - -  -     -    -  -    ---
--   -  -  - ---- -     - -   - - - -   -  -       - -       -       - -- - -     -  -   --  -  -- -
-    -   - - ---   --   -      -   --   - -    -   - - - ---  --  -   --     - -   - -    - - --   -
- -   -  - -  -- - - - -   ---   -   -    - -  - - --        -- -    -   --        -    -- - - -   -
-  - -    - - - -  -    - - -       -   --  --  -    -  -  - -   -    -- -    --             --    -
-   -  - -          ---   -- -  - -               - -   -   -- -        ---     -   -  --   -  -  --
-- - -        -  - - -       -    ----   - -     - - - -  -    -   -      -  -   --  -      -- -  --
-    -  --   -  -- - - -     -     -  -    -           -   - -     -    -             --  -     -  -
-      -  -   - -- -  --    -- --       ---- -      -      -   -  -  -- -   -      - -      -    ---
- -  - ---- -  -      -  -    - -     -        -   - -    - --   --     -  -  -     - -   -    -   -
-- -   -    ---  -- -- -  -   - -   - -    -   - -   -     -        -          -   -  - --  -  --  -
-- - --  -     -    --  -   - - -       -  -   -  - - -     - -  -    - - - -     - -  -       --  -
- -    -   -- - -  -    -  -   -  -    - ---- -      -- - - -     -       -  -      --  -   -  -  --
- -  -   -    -  - -   - --             -     - - - - -     ----   - - -     - - ---  --      -   --
- --   -   --    - ---  -   --- -      -  - -  - - -    - -  -    - -     --          -  -- -- -- --
- - -  -  --    -   -    --     - -  -  -  ---     - -     -  -   --    -  -  -- - -  -- -         -
-    - -      -  -    -   -           -        - - -      - -  --- -   -  -      --- - -    -  -   -
---         -     -  - -- -         --     ---             - --      -    - -- - -  -   --         -
-  -    -- - - -    -- - - - -   -   - - -    -     -   - -  - ---    -       --    -   -  -       -
- - - -  -     - -    -     -   --    -   - -       - -- - -  -    -         - - ---  - -        - -
-   -  -    -- - -   -     - -     --   - - -    --     -- -    -  --  ----    -   -        -  -   -
- --   -  -   -   --   --  -- -      -  --- - ---  ---        --   - --- -      - - ---   -  - - ---
--         ----  -    -     ---        -  -  - --      - ---    - -      -  ---  -     -   -       -
---  --  -  -      -  -  -       - - - -  - -    -- --     -- - - -  --       -      -- ------ - - -
- -- -  -     -  -   --- -   - -         --   -    -   -  - - -          -  - -     -   - -  - - - -
-    --  -   -     --    -   - -  -- -     -    - -      --    - - -  --      -   - -     - - - -  -
--  -   -       -     -   ---     -    -  -     --    --  - -      - -    -- -    --   - --  ---   -
- -   -    -  -   - -   -  -  -  - -  -    - -- - -  -  -  -   - ----  -  -                 --   - -
-     -     -  -    -    -    - ---  -       --   --- - -     -   -   -    - -  - -     - -      - -
-   -      - -    -    -     -     -  - - -  -- - -    -       - -- -- - --   ----    -   -  -  -  -
--  - - --  - - -- ---  ----       --    -    - - - -  -  -               ----     --  -  -     ----
- - -   -   -      --  --    -  - -  -   -      -      - -  - -  -  - -- -     -    -- --  -   --  -
--  - --     -- -     - - -   -    - -  -    --     - -   - -     - -- - --    -   - --    --     --
-         --        -      --  -    -    -- - -         --        -       -  -   --     -       -  -
- - - -   ---    -     -    -- -- -   --        -            - -   -  ----    -     - -    - --  - -
-  --  --- -   -       - ---    - - -    -    - - -      -   - -  -        -        - - -  -    -- -
-          - ---- -----  - --  -  -     --- -    -   - - --          -     -  -     -        -  - --
-- --     - -  -       --      -   -   -  --      -   -- -    -   - ---   -  -  -  - - - -  --   - -
- --   - -     -   -  -   -      - --      - -      -  - --  -   --  -   --  ---  -  - -  -   -- - -
--         -   - -- -     - -  -       - -     - - - -  -    --- -     -   -   -   -        --    --
- --  -      -      - -      -  - -    -       -   -  -    - --   --     --  -   -     - -      -  -
-- -      --     --   -   ---   - -   -   - -      --  - -- -    -   - - - --   - - - -  - -    -  -
- -  --   -       - --     -  -  -    - ------      -   - --        --           - - -           ---
---   -     -- -   ---  - - -  -  --- - ------       --  -         - -   -  -  --    -      - - -  -
-   - -   - -   -       -  -    -   -      ---    -       -  - --   -  -   - -    -    -           -
- -     -                -  --    --           -   -      -      -          -  -  -  -   -   --  ---
--     - -   -- --  --      - -     --       -- -   -     - -   - -  --                 -    -    --
-     -   -- - ---- -        - --    -    - -     -     --   -  -  -  - -       - -- - -   - -  -- -
- -        - - -      -  --  ---     - -    --  - -       -  -          ----          -   -  -  -  -
-- --  -- -     --   -  -    -  -  -- - ---   -      - -  --         -     -      - -   - -  -  - --
-       -   --            - - -   -   --  ---- --             -  -- -   --    --  -     -     - -- -
- -  --- --       -  -- -    -  -     -     -  --  -   ---  - --    - -  - - -       - ----  --   --
- -      - - --    -  -  -  -  - -    - --       -  -   -  -                ---- - -- - --    -  - -
--     -  -    -     - -   -         -- --   --  -   -    -   -- - -- ---      -      --  --  -    -
--       -  ---  -        -  -   -   -    -    --  --  - -       -        - -- -    --  -    --    -
-  -     -  -    --  - -- ---   - -   -- - - -  --- -        --- -      -     -  --   --  -       --
- -     -               --  - - -    -    -   - -  -  -    -      --   -    -- -- -- - - -  -      -
-   --  -  -    - --   -  --       --   -  -              ---  -     -   -  --      -- -  -    --- -
-  - - -- -  -  -   -     - - - -    -     - - -  ---  -   --           -  -  --       - -   --    -
-     ---      - -- - --- - -   - - -- --      -     --      -  -       -   --     -  - -    - --- -
- -  -  - -     -       -    -  -    -       -    ---     -- - -  ---  - - -- -      -- -  -  -   --
- - -----   -   -       -    - -  -    -- ----  -     - - --     -      -   --   ---     -        --
--     -  --    ---- -   - -    --- - -  -     -  - -    -      - -       -   -       -- - - - --- -
-  -  -  -    -  - - -     -    -- -   -   -    -  -   -  ---         -  - -  --    -  - - -    - --
--         - --  -   - - - -      -   -  -    - --  ---            -     --   - -   - -     --  -  -
- - - - - -   - -  -  ---   -- -           - - -  --    -- ---- -    - - -  -    -     -- -   --   -
-     - ---      -    -  -  -       - -   -  - -   - -    - -     - -    -     - - -  -       -    -
--   -      -- -  -  --- --    -     -             - -  - -    -   --    - -  - - -    - -  -  --- -
-  -  ------   -       -     -   -  -   --   ---- - - -    - -- -  --   -    - -         -         -
-   -  -   - - - --   - -  -    -         -  - - --    -  -- -  -     - -    - - -   -   --- -    --
-     --  -    - -     -   -- - -- -   -- - -  - -- -      -    -   -   - ---  - -          -  - - -
-  -- - -          - -  --       -    - -  --      -  -   -- ---      - -     -- -   -  --- - -    -
---      -      --    -       -     -        - - --- -  -   --  -   --      -    - ---    - - -    -
-   -      - - -   --  ---  --- -     - - --      -- - --  -  -      -  - -   -   -      -       - -
-   - -    - -  -          -      -- -   -    ---  - -    -    - - -  - -    - -- -  -     -  --   -
-          -- -  -   -  --   - -     -  -  --              -    -   -  ----    -           -       -
----------------------------------------------------------------------------------------------------
