100
100
----------------------------------------------------------------------------------------------------
-                 -       -     --  --  -      --         -   - ---  -   - --     - -    -- -      -
---       -    -    - -            -      -  -- -    --  -    - ---- ----           --        - - --
-            -     -- - - -      -- - ---      -  - -   - -        - - -  - - --       -- -      - -
-- - -   --- --- -  -   ---   -    -   - --   -      -     -      -              -  -  -           -
- -  -- - --      --  -   -    -  -    - -        --  - -       - --   -   -- -  -       - -    - --
- - -    - -  ---       - - -- --  --          -               -             - -  -  - --  -  -  - -
-  -    -    -    --         --  --      -   - - -  - --   - -  --  -       --     - -- - - ----   -
-          --  --   -    -   -   - -       - - - -           -       -  -- - --    - -    -- - - - -
- -           -        --   -       -       - -  ----   -     ------ ---  - -     ---  -         - -
- -- -   - -- -   -  - - -     -      -        --  -  -     - -        -  - -   -      ---         -
-   - - -    -      -     -   - -     -  -  --    - -  - ---   -  --       -   -    -   -     -    -
- - - - - - -    --      -     -- -  -      - -  -    -  -   --       - --   -  -     -  -       - -
--         -   -  -     - - --     - - ---              - --    - - - - - --       -- ----      -  -
- - -    -- --  -  -        -  - --   -- -  - --      -  --  -    -  -      -  - - -     --  ---   -
- -   - -  - ---     --      -  - - -- --  -        -   -  - - - -- -   -         -   --  ---   -  -
- -  -    -     -        -  -- - -  - - - -- -  -  -    -    -    --         ---            -   ----
-            - -  -   -- - -       -   -  -  -- --- --   ---   --     --      - --   - -  -   - -- -
-- -- - --  ---      -    -- ---    -   -- -     -         -   - - -   -  - - - -- -- -   -        -
-  --    ---    -  - -  --  - -        -- -   - - -  -  - - -   - --     ---- - ---  - -       --  -
- - --               -- -  - -- -    -   -       -   - -  -     --- -  -    -- -- - - -  -   -  -  -
- ----  -  --   - - -   -  -   -        --  -  -   -  -   -    - -  - --   -  -      -    - - -    -
--  -  - ---   -    - -      - -- - - -  -- -  -       -    --- -   --    - ---  - --  -  -  -  -  -
-  -  -  - - -    -    -       -       -    --       - --      -  - -    -     -- - - -  - --  -   -
-- - --   -         ---            -- - -    - - -     -  -- -  -- - -    -   -   ----      - -  - -
- --      -  ---       -   -   - - -- - - -       --  -  - - -   -   - --   --  - -     - --    -  -
-    -   - --     --  - -  -       -            -   -           - --  - ---- - - -- -       -----  -
- -   -- -   - -  - -    - --  ----   -    ---    --   - -     -       -  -     -  - -  -    - - - -
-         -  -  --   - - -  --- --  -- - - -    -    -    - -   ---  -- --- - -       -- -     - - -
-     --   - --   -           -  - - - - - --  -----  ---             --   -- -    -         -    --
--   -   -  - -              - -  --  - - -     - -   - - -     -  -    -     -  - -   -    -   -  -
-    -   --    -       -  - -  -       --- -  - -        --   ---           --  -      - - - -  - --
-  -            -      ---  - -  -    -   ----   - -        - - - - --   - -     --  - - ----    - -
-   -     -- -    - - -  -   --    -    --      -     --        --       - --    -     - -  --     -
-  ---   -     --   - -   -      -     -        -  - -- -            - -   - -       --   - -   -  -
-   --       -    --       -  - -     -   -   -    - -   -- --          - -   - -   -- -     - -   -
-     - --     - - -- -     ---    -        - --   --   -        -  --  -- -                  - -- -
-  -- -  -    --     -- - - -- -  -    ---   -   -   -  --        --            --   -     ---     -
-  -      --    -   -- -    - - --    -            -     --     --     -   --  - -   - -  -  - -- --
-- -- -   -    -    -  -  -   -- -   ---- --   -              - -    -- -  -      -    - -- --  -  -
- -  -  - - -  -  - -  -     ---  -       -   -     - -     - --  ---   -   --- - - -    - --      -
- --  -     ---  - -   --   --- -   -- -  - -             --          - -   -  --   -   -          -
- -  ---    - -     --  - -    -  -  --- -  -      - -  --  ---     -    - - --    -- -           --
--   -       ---- --      - -    --  - -   -   -     -   -  -    -       -      --      ---        -
--  - --     -    - - - --- -     - -   - -     - - - - - - -         - -  -  -   --  -   - -      -
-   -   - - -      --  -    -   -  -  --   ------ ---  -         -      -    - -    -  -      - - --
- -     -   -   -- - -  - - --   -    ---      -     -       -  -   - -        -  -       -   -    -
-  - -     -   -  -  - - -- --        -  ---   - --- - - - - -        - ----- - -     -         - --
- -   -  -    -     -  --   - -   -  ---    - --   --         -- -     -        ----   -    -   -  -
--       - ----- -- - -  -   -   -   - -- --   - -- -         -    --   --  --   -- - - ---  -     -
-     -       -         -   -   --      -  -  -     --     --      ---  ----         --- - - -     -
- - - -         --  -        -  -  --  --    -- - -  -   --    -- - - -    -   -- -     -    -  -  -
-  - - -   -        -  ----       -    - --    -  -  -     - --   -      -   -- - --  --  -  ----- -
- -- -  ---   - -  - -  -        ---   -  -           -  --      -   --     -    -     - -    -    -
-  -    -   - - -- -  -- -   -        - -   - -  -  -   -       - -   -       --  --  - - -- - - - -
--- -  - - -  - --- --   -     ----    -   - - -  -      -- -      -       -- -- -  -   -  -       -
-   -    --   --   - --    -   -  -         -      - -  - -  - --    --      -   - -         -    --
-  -   --    -- -- -- -  -   -  -     -     -- - - -   -  -  --  -    - -    - -   --  -     -- -  -
---       -    --     ---         - -    -    --    --     - - --  --   --      - -   -- - - -   - -
-- - - --   --      - -  -   - - -    - -       --   -  --    - -   -     -  -    -         -  -- --
- - - - -  - -  -  --        -  - -     - -- - --    -      - --   -      -     --  -              -
- -   --  -   -  -     -        --  --   - -      --               ---    - -  - -  -    -   ---   -
- -     --   -     - -    --- -   ---    - -       -     - -   --   - -  -- -  -       -  -  ---  --
- -        -- -   - -  - -   - -    - - --- - -     --     - --     -- -  - -     - -           -  -
-  -   ---    -- - -  -   -       - -  -  -   --   - -  --      - -      -   -     -  -   --  -  ---
---         --  -   -        --  - ----         -  --      - -  --  -   -       ----   --- - ---   -
-     --  -    -        -      -      - - - -    -   --    - - -   - - -    - --   - --   - -    - -
- -       - - - --  --  -- - -      - --    --    -    -   -   -      -   --- -      - -    -    - -
-    --        -  -  -     -    -    - - --   -   - --  -     -     -   --           - -  -   -    -
- --  - - -  ----  -   -  - ---   -- -   - -      - -  - - --     --   - --   -   --   --   ---    -
-  -    - -  --        - -  -   -  --  --  -   --       -  - -   - -   -   ---    -    -   --    - -
-   -- - - -      --  - -  -   -    -       --       -   -  --       - -          --   -  - -- -   -
- -  - -     --  -   -    --     -  --  - - --- - --      -  -  --         -  -   -    - -  -   -- -
- --   - -   -   -          -      ---    -  -       - - --    -- - ---     -- -   - - -- - --    --
-  -- -     - -    --  -  --     -      -         -   ---     -  -  - -  -   - -  -   -  -   - -   -
-     -    --- -    -      --- -  - --  - - -  --      - - -  - -          -    -   -           -- -
-  --  -      -   ---      - - -  - -   -   --    -    - --       -      ---  --    -----       -  -
-  -       -- --    - -- - - -    -  --  -- -  - - - -  --  --  - --         -         -   - ---   -
- -   - - -  - --  - - --    -   -    -  -  -- -   - - -  - - - -  - --  -     -  -  --    -  -    -
- - -    -     - - - - -  - -     - -        -  ---       -            - -  --    -    - -  -      -
--  -   - -      --  -----   - -        -     --     -      ---  -  -  -   - - -  - -     -- - -  --
-  - -      -   -  -  -  -   --   -         -    -      -- - -    - -      -  - - --  -      -   - -
-    - -  -          -   -  -            - - --    - --   -      - -  ---  - - -   - -  - -    -   -
---  -  --- -- -- - -- -  -       -     -- - ----       -      --   --  -     - - -        - -  ----
-  -      ----  - --  ---       - -   -   -     --  -  -  -    -   -      - ----   - - -- -- - -  --
-      -  -     -  - -             -  --  -      -  --- - -  -    -     -    -  --  --      -- - ---
-     - -        - - -      -  - - -- -  -          - -   -- --- -  -    - - -          - -  -   ---
-  --   -     --  -  -   - -     -  -   -   -      - -      - -      -  -  - -     -- - -      -----
---   -   ---   -- -- - -    --     -- -  -     -    --   -  -    - --- -        -      - - - -  - -
--  -      -  -   - --- -    - ---     - -         -        -    -  -         --    ---- -- -      -
- - - - - -     -    -     -     - ---- -   - -       --      -       -   - --- -      -- --  -  ---
-    -  -  -  -     -   - -  -- --- -       - -   -   - --  -   --       - - -  ---- -   -   -  - --
-  --- -      -- -   -     -  -  -   - -   --- -     - -  --- --             -      -              -
-  -     -- - -  -        ---- --- --   - -   -         -        --       - -  - - --- --   -      -
--       --      -       -        -      - -    -  -     --- - ---  --     - --          --        -
-  -   -       -         -  -      -              -              -              ---- -  -   -      -
--- - - -  - - -     - -    -- - -  - -  --- -    -   -- - - --       -         -  -    - -     -  -
-     -   ----  -    -             -   - -  -  ---  -    --       -  - --   - - - -  -   -    ---- -
-     - --               --         -         -     -   -   - --    -    - - -             --      -
----------------------------------------------------------------------------------------------------
