100
100
----------------------------------------------------------------------------------------------------
-    -   --       -- ----   - -        - --  -  -     - - - -  -      -   -       -  -     --      -
--- - -  -     --    -   -         -      -- ---         - -  - -  -     -     -- -   -- - -       -
-       -       -  -- - - - -    -         --     - --    -          --    -   - -   -  -   ---    -
--    -       - --    -    - --      -   -   -- -            --   --   - -- -        --- -- -      -
-     -  -       -  - ---- -      ---        -  -       - -- - - --   -     -    ---  -           --
- -  -   -    -     -  --  -  - -  - -   - -   -  - - - -   -    - --- -  -     - -     - -  --   --
-          -  -  ---  -  - - -   -- - -       -             - - -  - -    -  - -  -    -  -  - - ---
-   - -      -- -   -  ---  --   -  - -   --   -    -        --      -    -   -  -- - -      -   - -
--  -     - -         -     -        -                 - -      -- -- --      - -   - -  - -- - -  -
-  -  - --   --        --        - - - -   -  - - ----      - --       - -    -   -     -      -   -
-   -    -             - -   -   -    -- -      -      - --     --   -      --- -  -       - -   - -
-         -    - -  -   -  -  -    - -  - --   -   --    -   -      -    -      -     -   -- - - - -
- - ---   -  - -   - ----       - --     - - -- -   - - -- -- --   --   -  - --  -    - -  --- -   -
- --     -         -    - - --- --  -    -        -      -    --- --  -  -  ----- --     -      - --
-     -        -    ---- -   -     -    --   -      --    - -     -    -- - -   - -         -- - - -
- -    -----     -   -   - -- - --    -   --        -      -   --   -     -  --    - --    - - -   -
-   -         ---   - -   - -         -   - --    - -  -      -  -- -   --- -- --  -- -- -    -    -
--- -   - - - -   -     --  -               --        -  -     --  - --   -      - -  -- - --      -
-    - -       --- - -       --  - - -   -- ---  -    -      -     -   -    -   --   -   -   -     -
- - -- - - -  - -- -     -           -      --- --  -   -  -  - -    -- - --    --        -- - -   -
- -- -    --  --  -  -       --  - - - --- --   -   - -     -   - -     --        - --  --     -- --
- -  -  -        --    -    -  -    --  --       - - -  --  -  -  -- -  - -  - -  -        -     - -
---    --- - --  - -    --  -   -      ---- - -- - -          -  -    -   -     ---    - - --  --  -
-   - - --   -     - -              --- -   --    - -  -  -  -  -    - --  - -  - -  - -- -  -  -  -
- -       -     -     -     --    --           -  --  --  -  - -      - -   -  -  - - -     - - - --
-  -  --   - ---      -   -        -   -   ----  -- -  -    -   - -        -     -   - -  - -   -- -
---  - ---       - -  -    --        -  - -           -- - --  -  -- -  -  -       --    - - - -  --
-         -  - -- - -  - ---- -  -  - -      --- -- --   -  ------   - --- - --   - -  - -- --  - --
- -   - -  - -- -    -  -   -  - -  --   -  -  --  - ----       ----    -    -  --      -    -     -
-   -    - -    - -   -    -- -   - -   -    - - --- - -  -    -   --    --   --      - -- -    -  -
--   - -- - -      - -  -- -  - - -- --   - -  -           -   --      - ---     --    -           -
-  -   -   - - -    -     ----           -    -      -  - -- -- - - - --  -     -     -   -        -
-  ---- --    -  -  -         -      -   ----      - --  --- --        --   - -       -   -  -- ----
-      -   -      -   -  - - --  -     --  --  - - -   -  -  - -  -- -     -      ---    - - - -  --
-   ---  --        -  -       -     -    --   - --    -- -  -  - -   ----     ----    -   -- -  -- -
--   -   -      - -- -    -   -   -      -  - - -         -  -  -- - -   -    --- - --    -        -
-  -     -----      -    -     - --     -  - -       - - -   -- --    -    - - - ---   - -  - - -  -
-- - - -  --  -        -  -  ---         -- --          -      -  -   -- -- --- -  -       - -     -
- --         -  -- -   ----  -    - -   -  -  - -   - --        - - -   -  -  - -      - - - -     -
--  -- -   - -- -  -      -  -             - -- --    - - - --     -- -           --   -- -- -     -
- --      -   -   --  --           - ---    -- - -- --   -     -      -     -      -       - -     -
- -   --     - -     -   -- -     -     -     -- -     -  -- -       -      -  ---        -  -- -  -
-     -  -     - --   -   -    --  -- -  -     - -  -    - --    - -   ---- -- - - -    -    - - ---
--    - -  - --  -   -      -  ----     -     -  --  - -      --   --        -  -     -        -- --
-    - -  --   - --   - -    -    -  -       -- -   - -      --    --  --  --- --  --  -  -    -   -
-  -    -  - - - -          -       --   -  --   -    -- -      -  -     - -      ---   -     - -- -
--        -  -  - - ----  - --  - --       -  - -           -    --     - -    -    -  -       -   -
- --    - - -     -    -      --  -- - ---  --  -     - - -   - -  - -    -       --- - - --  -  ---
-     - -  - ---    -      --  -  -  -    -    --- - -    - -    -    -  - -   - --   --   --  -   -
-     -- -   -- -  -    -   - ---  -  --   -  -   -            -- -- - --  -- --        -  -    -  -
-       --- -   -    -  - --   - -- -        -  -- - -    --     --   ---    -  -                  -
-    - - - -    -            - - -    -  - -  --      -    -  --  - -    - - --      -- -    --  - -
-  -   -   -  - -  ---- -    -   - -              -      -  -    - --  -    -  -  ---  -   -      --
----    - -      -- -           --  --   - --     -     --- -    -  -  -     ---     -   -     -   -
-   - -        -     - - -  -            - -- ---     -  - -      -   -   --    -  - -- -   -    - -
-    -    - -  - --  - -   -    - -----  -     -    -   -    -     -    -   - --  --  -       -    -
-  --   -            -     -- -       -     -- -  -- -    -   - ---      -  ---  - -- -   -        -
- --       - -    -     -    --         -  -  - - --   - -         -     - - -       -  --  - -- ---
-        -   -    --   -    --  -    - --        -    -    -   --     -  ---   -- -     -  -  -    -
- -  -   ---         -     -  -     -     -  -    ---    -- -     -     -   - ---   -       -      -
- -  ---    --       --     --    - -- -        -        --    -    --    -- --  -         -  -   --
-  -  - -      -- --    - -- ----    -     - - ---    --- -       -- -         --  --  -   ----  - -
-    -      - - -  -  -         ---    - -   -    -- - -- -  --     -  -- -  -        --      -  ---
-         -  --   -  - - - --       --      - -    - -    -     - - --  -      -   -  -   - -  --- -
-   -   --          -   - -  -   ---  ---   -  -         ---  -      --      -   - -           --- -
- -  --    -- -      -  - --  ---- ---  --      - --  - - -    - ---    - --   -  -     - --       -
- ---   -- - --  -   --  ---                ---- - -        -          - -   -   -            ---  -
-    --- - -- -       -  -- ----     -    -   - -    -  -     - --    - -                --       --
-- --     -   -  -   -- -- -    -          -    -- - --           -- - -    -   -  - -      ---    -
-    - -    -    --   - -  --     ----     -            -    - -   - -- -       -   ----        - --
-  - --  -     -  - --          -   -     -     - - -     --   - ---  -       -      -  -   --  -  -
- -        - -         - - - -     - -- -    - -   -     -    -        -   -      -   - -  -      --
-        -- - - ---      --  - -- --  -   --   -   - -  -      - --  - --     - - -         -      -
--- - - -   - -  -   -----    --   - -  - ---   --    -     --   ---     --  -----   - - -      -- -
-   -  -       -   --  - - ---     -  --           -   -       - ---  - - - -   --   - - -    - -  -
- -  --   -- -- -- - --  -- --       --  -    -  -          - -           -- --    -  -   - - --  --
-  -- - --      -   --         -         - -     -- --          - - - -  -  --   --   -   -    - - -
- - -  -    - -           -  --     -  --  - - -   -     - --        -  -  -  -  -  -     -  -   - -
- - -      -  -    -  -  - -     -   - -- -      -    --    - --               - -   --      -    --
-   -  - -  - --    - --    --       -  -  --  -      -   -- -  -  -   -- -    -   -         --  - -
-        --        -  -  --- -- ----   -             -  - --  --- -           -  --  ---     -     -
-    -  - - --  - -     -       -      - -- -     -      - -   - -  - -   -  ---- - - --    -- --  -
-           -       -  -  -  ---  -     --   -   -   -   -  -        -   - -    --  - -  -    -  - -
-   -  -- -       - -  - - -- - - -           -      - - -     ---            -    - -  --     -  --
- -   - --  -   - -       - -  - -   -  -   -  - -   -   - --      -      -- -     -        -   -  -
-- -    -      -  - - -- -         --    --    - - -   -       -  ---      - -  --- - --  -      - -
- - - -   -   - - - -         -- - --  -      -   -  --        --    -  -    -  -    -- --  -     --
-  -   -    ---   - - -     -  - - - --  -  -   --          -    --    -- -  - -  - ---   ---- -   -
-      -    -   -  -      -   - -   - --  --       -    --     -  -     - ---          --      -  --
- -   -  -   - --      - -       - -     --      - - - -   --    -- - ---       -  - -   -  -  --  -
-    - -  --  -  -- - -       -        --     -  - -    -  -  -  - --- -  -   -  -        - -   -  -
-   -   --     -  -     ----     -  --      - -- - - - - - --       - -                - --    -  --
- -     -     - --  --- -    -   -  -- -- --      --    ----  -       --   -- - -  -  - -     -  ---
-   -   -   -   -     --   -   -- -     - - - --     -  -   - - -     -        - - --   ---    -  --
---   -- -      - -- -- -   -- -  --   - --     -        --    ---     -   - - - - - -- -    -  -  -
-      ---   --    --  - - -          --  -   --- -  -  -  - -      -  - -  -      -   -  -   -- - -
- -- - -   -- -      -  --- --- -    -    - --   - - -    -  -   -      -      -  -     ---        -
-       --    - -  -  - --   -    -  -- -        -  - -            -                 --    - - --  -
----------------------------------------------------------------------------------------------------
