100
100
----------------------------------------------------------------------------------------------------
-   --     -            - -     -   - -- -    -     -    -   -  - --    -   -    -  - -            -
-       --  -  -     -   -   -  -   -  - -     -    -     - -  -  - -  - -  --    - - -   -- - - - -
-    -    ---  -- - -  --  --  -       -- -- -- -   -  --    -   - --- - -  -    ---   --    -     -
-        -      - -           ---   - -   -     -   -- - - - -   -- -- -  - -   -         -  - - ---
--   - - -    -   - -  -   --   - - - -     -    -  - -  -  -- -    -   --      -    -----  -- - ---
-    -   - - -    -  -   -           -  --   -  -   - -    ---      - - --- - - -   --       -     -
- -   - --       -    -       --      - - ---  -- -  --  -    -    - -  - - -     - -   -  -- - - --
-  -  --  - -  - --   -  - --    - - - -  - - - --     ---   -   -- --    -- - -  -   - - -   -  ---
- -  - - -   -  --        -       -  -   -     -  -      -   - -    -   -          - -----    --   -
- - - -    - - -  --- -  -   - ---  --  -  - -      -   - --- - --   --   -- ---  - --            --
--  -  --   -           -   ---  -    - --   -   - -- -     - -   -   -- -  -        -    -- ----  -
- -- -- -  -  -   -   --   - -      -          --  -  - -   - -    --     - -  --   -- -         - -
-      -  -- -   - -        -- -- - -    -       -             -   -  -  ---   -   -   -    -      -
-   -      - -   -  --  - -   -   - - --- - -- --  --    -- -- ---   -        - ----   -   ----    -
-      - -- - --  - - -   -     -       - -      - -      -- -      -  --- -     -- -- -       -   -
-   --  -   -- -          -- - - -  --- -      -   -       -  - --  -     -       - -   ------   - -
--       -  - -        - - --          - -       -- -   -     - -    -- -     -    -  -        -   -
- - - -  -       -  --            - -    --            -     --      - -    -  -  - - --     ---   -
-      --  - ---  ---   --   - - -   -   -- -      -            - -  -   -       -- --   -  - -    -
- -  - -- -  -    - -      -     - -- -         ---           --- -   - - -        -      -   - -- -
-   -       -   - --      -  -  - - - - -    -- -- --   --- - -  -   - --    --  -  -  -       -   -
- --- -- -  -     -    -    -   --  -        --      -  - - - - --   - -- -- - -- -- -   ---   -   -
-         -    -    - -   ---     -    -- -       -                 - - - --     - -  ----   -     -
-  -          - -  -             -   -      - -- -       ---   --    -- -  --  - -     -    - --  --
-     - --   ---  -     --    -   -            -- - -  --   -   -  -- -    -   -- -   -   -- -  -  -
-   -     -   -  -- - -      - - ----     -  -  -  - -- ---   -  -     -- -    -- -      -        --
-  -   --       --  -  -- --  --                          --     --   -  - -           ----  --  - -
--  -  -     -  -      -   -    - -   -     -  --  ---          -   -  -  - -  -    - -    - -  - --
-    -  - -    -  -   -       -  -    -   - --- -      -      -  -- ---       -  - -  - - - -    - -
- -  --  -     -  -- - --  -   --      - -  -- -  --    -   --  -    -  --- -  ----     --- -   ----
-  -        - -- -     - --   -- -        -   - --   -   -   --  -     -               --  -      --
-   --- -         --    -  --   -  --   -       --     --      -     -      - - -   -     --- -  - -
- -     -  -- -      - -  -   - ---   - -- -      -       ---   - --        -   -   -   --  - - - --
-   -  -  -   --  -- - -  -  -  - --         -  -- - -      -     -  -   -   - - --  -     -   --  -
-  - -        --     -- -  -  -- -  -   -  -    -   -  -  -       -   -  - -  -         -  --  -  --
- -     -         -       -  - --   --   - -    - -     -   -- --    - -       --- -   - --   -   --
- --      -  ---    - - -   --  - - -     -        --      -  -   -     - - -               - --   -
-      - - -          -  - -- ---        -- - -          -    --  - - -- - -   --  -    --     -  --
--         -        -- - - --          - - --    -  -   -    -     -  --  -        ---         - - -
-  - ----  --        -   -   --     -        - -- -       -    - -      -  -  ---  -   - --  -  -- -
-  --      --     ---   -  -    -     - - - -   -  -    - -- - --  -    --         -  --   -  -   --
- -- -  -            - - -    -- - -   -  --  -----   -    -  - -- -  -        -          --     - -
- - -          -- -   -     -   - - -     -        - -- -   --  - -      -   - - -      -- - --   --
--    - - -  -     -       -      -    -  ---    - - -  - --   -   --- - -    -  -            - -  -
- -   -  -   - -   -       --  -  -   - -   - -- --    - -  --  - -  ---  ----   -   - -   -    -  -
--     -  --- --  -     --   -- -       -    - -    -- -  ---   -- ---   -       - -         -   - -
--  -        -   -    -    --     -    -     -  --            -       -   -     -           -      -
-   ----  ---  - -   - -        -  -  ---  -   -  --   - - -   ---   - -  -       -       -  --   --
- -    -   ----  - --  - - -- -  -- -  --    ---- -  -  - - --  -   - - -    ---         ---     - -
-  --      -    - -   --  -     -  - --   -- -       ---   - -        --         -  -   - -  -  -- -
-  -  -   - --          -      -- -   -                 --   -         -     -      -   - -     -  -
-             -- - -         -   -  --  ---      -     - - -  -    - -   -  -   - -        -- --  --
- --  - -   -  -    -    -   -         --    ---- -     - -   - -  - -   -   -   - --     -- -- - --
- -  -  -  -  - -  -  - - -- - -   -     -  ---  ---               --   -     --       --   - -  - -
-- -   --- -           -     -   --      - -   -     - --  - --- -      -   -  -    - -  --     -  -
-  -            -   -   --         -  - ---      -- --    - -        -  -       ---                -
-   - - --           --  -   - -         -      -    - --  -  ---          - --  --     - -     -  -
-        -  -      - -     - -- - -  - -  -  - -    -  -     - -  - -  --  -       -   -    ---  ---
--  -  --  -  --  -     -  -       ----  -      --   -   -  -      -   - -      -----   --     -   -
-   -   -   -   -  -    -  -     -        -  -  -  - -    --  - -  -- -   --  -          -  - -    -
-  - -       -   -    - - -    -  - -  -   - - --  - - -                   -    -   -   - - -  --  -
- -- --   --    - -       -    --  -  - - ---   --      - -   ---      - -   -   - - -- -   -   -  -
-   --- -   -   -  - -  -- ---    - - -    -   -   -     -        --  --   - --  - - --     -   -- -
- - -  -  -   -  -- -- - --      -  -    -   - -- -  - - -  - --    -- - -    -      -  -          -
- -- - -   --     -    --  -  - - --      --   -  -   --     -   -    --- ---   -  - --        --- -
-    -    - - -   -- -   -     -             -    ----    -  -    - -        --  ---    -  -  -    -
--- -  -- - -   - -  -    --    -  - - - - -- -   - -   - -     -  -  - -   -- -    - --  - - --   -
-  - -  -- -- - - - -   -   -   - -   - -   -  -   -  - - - -          - -           - - -      -  -
--- -  --    -  --   - - ---    -        ---   -- -   - - --  --  -    --  - ---- - -  -     -     -
- --        -- -      - -   -     --        ---  - -  -      --        -  --    ---        -   -  --
--       -  --    -  -  ----  -      -  -    -    -     ---        -    -  - - - - - -  - - -   -- -
-  -    -      --            --       -   - - -   --   - -  ---- --  --- -- --        - -- -  --   -
-       - - - -       - --   -      -    -           -   -- - - - -      - -  - -  -        - -    -
-- -  - - - -    - -    - -- - - --  - -    -   --  -- - --       -     -  --  -  --   - -      -  -
-     -      --     -  --        ---   --  -     - -  -----    -           - -  -  -         - --  -
-            -   -    -    -    -   -           - ----      --   - - - -    -     --  -       -  - -
- - --     - --    -  -  -   --        --    -    -  -         -       ----     -    -- -  - -   - -
-  -   --      -  -  ---  - -      ---       -    - -     - --  -             -     --    -   -    -
-  -    --    -  --    -         - -    -  - -      -- - - --      -    - - --           - -       -
-        - -    - -   -    -  -- -  -       -    - -          -   -     -  -  -   -     - - --   - -
-  ---   - - --  --  ---  --      --  - -  - -   -    -  -  -  - -    -- --  - -      -  -  -  -   -
--   -   -- -        -  --    -  -- -- -   - --     -  -    - -      --  --    -     -  -   -    ---
-  -     -    -  -- --         - - -   - -  -   -         -   - -- -   -   - -  - -    -- -  --  - -
- -- -  -          --       - -   - -  -  ---   -   -    - -  - -      - -  - - -  --    - -      --
-- - -   -    --     - ---      -  -  --    -  - -    --  - - -         - -    -    --         -   -
-  ---       - --      --    -   -  -  -     ---  - -     -- -      --    -      --  -    - -- - - -
-  -  - - -   -  - -     - -     --- ---- -       -    -     - -  --  ----   --  -  --  -- --  -  --
-- -  - -       - -- -      - - - --     -  --- -    -- - --  - -  -    - --  -  --- -- -    -  -  -
---     - -   -    -    - -- --  - -    - -     - ---  -    -     -   --      - -   -  -     -   ---
-  - -- - -   -    --   - -    - -    - -  --         - - -    - - ---  -----    --- -- --    --   -
-                            --- -  -    -  --         ---  -                -   - -- ---    - --  -
-     - - -          - ---          -  -  --    ----          -  - -        -    --  --   --- -   --
---  -  - - -    --  - - -   -  - -  -    ---             -  -       -  -   -          -   -- - -  -
-    -  - -       ---    --     - -  -  -  -   ---- - - - -- - -   -   - ---   -- - - --- - -    ---
--       - - -     -  ---    ---  -    -    -  --   -  -    -                -     ---   --  - -   -
- - -  - -  -      -   - -    -    --      -   -  --      -   --     --  --               -       --
- - - - -    --- -  ---- -       - --          --     --     -    -        ---  -  - -  - -   -    -
-    -   - - -          -   ---     -      --   - --   -  -  -           -    -  --       - - -  - -
----------------------------------------------------------------------------------------------------
