100
100
----------------------------------------------------------------------------------------------------
-   -- -    --  - -    -            - -   -  - -      -   -  --       -   -      -  --      -      -
--     -           - --    -  -   -   -  - -   -   - -    --    - ----  -       -   -  ----    --  -
-     -         --    -- -   --       -      --      -  -   -             -    - --   -- -    -   --
--   -  -   - -  -  --   - --  - -      --        ---- -   --  -    -   - - -  --   -      -- -   --
-   --      -   -  - - - - - - ----      -  - -   -     -    -        - --   -         -      - - --
-         -   -   -   -  -      -     -     -    -     -   -- -      ---           --     -    - - -
-  - -   --     -  --   -      --- -- -  -   -- - -  - - -   --  - -     -   -       -----    -  - -
-       -  --  - -   -- -            --            - -         --      -   -    - - -     -- -    --
-   -  - - -             - -    -   -    - -   -- -      - -   -    --  - -- -  - - --   - - --    -
- - --        ---- -- ---   -  - - -   -            ---  -   -     -  -  - --     -       -  --  - -
- --  ---    - - ---- --- -    - -   ---- -  -    -    -          -  - - -   --     -    -  -   -- -
-       - - --   -    --- ---  -   -   - - -  - -  - -     -  - --    --          --  ---       - --
-  -   - -    -   ---         --        -     -   - - -                   -   -           -      - -
-- -      - --   - -- -  - -      - -  -   --  --- - -   - - - --    -   - -- -    -- -      -   - -
-    ---     -   - -  - --      - -   -   - --    -    --   -   - -  - -  --     --    -    -    - -
-  -  -    -      - -  - -       -  -      - -     -      -     -- - -       - - - - ---   -   -   -
--    - - -  --     -  - ----  --   -  -  - -      -   - - -   -- -- -      -  -     - -  -   -  - -
-        - -  -    ---   -   -  - --- -      -  -- ---   -   --    -   - -  - -   - - -- -         -
- -   - -   --  -      -- -      --- -- - - - -        - -  - -        -    -  -    -- - -   -   - -
-    --  -    -   ---          -   - -  - -      -   -   -       -   -       - --- -   ---     --  -
-  -  - --  - -   - - - --  ---  -     --   -    -           -    ------     - -    -      -     ---
- -        ----  -  -     -   -  --  - -      -     -   - - -  -         - -    --  -    -  -      -
- - -        -   -     -   - --        --   -       -      -  -        -  - -   -      - --  -    --
-    ---     -- --   --        -    -  -  -  - -    -     -- -     -    --    -      -  -    --  - -
-   -      - - - - -    -   -    - -  - --        --  -- -  - -   -   --  -- -       ---  - -  - - -
-  - -- -  - - -   -  --- --       ---    - -    - ---  - -     -   -- -    -   --          --  - --
-     -     - ---   -           - -      -    -  -   -  -  -  - -    -  -   - --  -- - - -   - - ---
-- -- -    - -       -  --- --   -   - -  --   -     -   -- -    -  -         - -  - - - - -     - -
-  -  --  -     -- - -  --    -    --    -           -           -    - --- -      -   -     -  -- -
-   -        -  - - -     --    - -       -           ---       --- - -   --  -           -- -     -
---  --- --- - -  -- ---  - - --     - - -  -   - ---- -  -     - - -    -   - - -      -      -  --
--  -  -  - --- - - --     -        - ---    -      -     -  -  -    -   - -   - -    -   ----   - -
- -    -        -- - -  -  --  -  -   - -    -  -    -          -  -- -   -     - -     --       - -
---    -      --         - ---  -   - -    - - -       -- -     -      -- -     -- ---  -   -----  -
-     --       --- -- -       -- -   -  --   -  -  --- -  --  -  -   -   -- - -   -  --   -     -- -
- - -   -     - -   - -- --  -    --  -    --       --          -  -  -       -  -  --    --   -   -
- - - -         - - -       ---- --- - --- -- - -       -         - - -   -- -   -      -   - -    -
-- -  - - -    - ---    --   -   -    - - - - -    - -- -   --     -     -   - - -    -  --      - -
-- --   - - -  -  -  -    -     ----- --  - - - -      ---- - --- -     - --               -  -- - -
--  --      -   - --  - --     - -            -       - -       - -  -- -            -  -    -   ---
--     -  -       -    - - -  -     - --  - -    -      -- -    --    -- -- - - -  --  --   ---    -
-   - -  -     -      --     -   - -    -  -  --    - -  -     - - -----    -- -    --  --        --
-   -    ---       ---    --   -  -  - - --    -  -    -   -      - -  ---   - -  - -         -    -
----    -    - --  -        - -  --    -   -- -   - -     -  -  -  - -  -     -  --  --   - -    - -
-    --- -   -      -      -  --        -   -     --   -   - -   - -      --     -    --           -
-- - --- - -     --       --    -   -      -   - -    -    -       --- --   ---  -  - - --  - -   --
- -  -     -    -    -   -  -----        - -     - -   ---   - -        -    -   --    ---  -    - -
- - - -  --      --    - --- --   -- ---  -   --    --- -        --    --- -  -- - --        - - - -
-   - - -    -     -  -  -      - -- -  - - -    - --  - - --  ---    -     -  --- -   -- --       -
- -  - -     -   -   --  -- -  ---    --    -- --      -        - -- -  --  -      -    --  --     -
- -- -  -    - -             -   - --  --- -  -       -  - - -  -   -          --   -       ---    -
---      -  -      ---     --     ----     - -  --    --       -     - -   --  --         - -  - - -
--   --    --    ---  - - - -  ---     - - - - --    - -      --         - -- - - -    -  -  - -   -
- ---   -  -   --  -   -  - -   -   - -  - - --  --   --     -- -      -   - -   -- - -      - --  -
-    - -    - -  --   -  -    - -      -  ---   -- -  --  - -  -  - -    - -  --- - -   - -       --
-- -- -              -  -        --  --      --      ---    ---     -     -  -    --      -    --  -
- --    -      -  -     - --    -   -  -    -- --    -    -     -   -- -  -     -    - - - -  -  - -
---  -  -  - -     -     -   -     --   --     - -- - - -    -          --   -  -- -- -        - - -
-   - -    - -   - --  -      - - - -  -   -  -           -           --       -    - - -     -  ---
-----    - -- -  -       - --  -   - -  --  --    --  - - - - -- -           -   - - --    - - --  -
-        -- -    -    -  - - -- -     -   -      -          -       -           -    -      - -   --
--     --- -    - -  -   -       -  ----  - -       --   - - -- -    -     --  -  -   --   -     - -
-    -  - -- -  --  -  -      -  -- - - --  --       -   - -    --    - - -  -     -  --         - -
- - --  -  --     - -   --   -        -   --    - -     - -        --       -       --  ---  -     -
--   -    -      - -   -     -  -   ---    -     --       -     -- -  - -   --- - - - -      --  - -
- --   -  ---   - -     -       ---    ---  -  -   -   ----  --   -- -        -- -    -----        -
-  --- --    - - ----    - -        - --      -   -      -     - -  -    ---- - -    -          - --
-   -       -        -  -    -   -   -   --     -- -----   --     -       - - -   -   - --   - --- -
-   - - -  -- - - -            -  -        -   -- --     -  - - -- --         -  -      - - -     --
-  --         - -    -  -     ----     -- - - -  -      -   - ---    --  --- --       - -     - -- -
-    -- -- -      --        - -     - - -       --  -   -        -     --      - -      -  -- -- - -
-  - - -       -- -    -- - - -- -- -    -   --    -  -      - - --   - ---  -- -   -  -       - - -
- - --  - - --          -   -  -     -   -- -  - -         --   --  - - --- -   - - - -  -   -     -
-     -  -    --  -- --  -  -    -  --   -   ---- -                -       - --         -   --     -
-    -   ------- -  -- -    - --      -    -       -   - -   -  --       - -- -    - --            -
---      -    -  -  - -               - -  --- - - --- -     -  - - -          -  ---  --   -  - - -
-   ---   - -     -   ---     - - -  -    - ----- -   -  - -    - -    --     - - -  -         -   -
---  -- - -- - --- - - -    -           - -  --  -  -  -    -  - -  - -  - -     - -     -   - - - -
-      --   -     -- -  --         -- - - -  --- -  - - -        --- --     -       - - - -        -
-       ---      -  --- -  -     -     - - ----      --  -  -     -  -        --        -   -     --
- -   -- -         --  --  -  --  --    - -   -      - -             - -    --     - - --      --  -
---   -     - -  -    -   - -   -    -         --        -        -   -  --- -       --   -- - -   -
-   -- -     - - --   -  -  -      -- -     --      --        --    -          -  -  - -     ---   -
--    --             -     -    -  - - - --   -   --  - -   -    -- - -    -  - --      -          -
-  -- -- --    --- --   --    - -   -  --  ---     - -     - -  -             -   -  -       -     -
- ---  -    - -  -     --   - -   -              -  - -  - -- - - -     -   --- -     - -- - -    --
-         -    - -    -      -   -    --     -  -         -        - -       --    -  -  --  -  -  -
--    - -    - -       - - --     - -- - - --  -    -- -      -   - -    -- -   -      - -     - - -
-  -      --     - -       - -            - -   - - -- -   --   - --    - - -  -   --        - - - -
-  - -    -             -- -    - -   -   --    ---- - -    -   -  - -  -   ---  -   -  - -- - -   -
-- - -  - - -        -  - -  -  - -      -  -  -     -   - -      --  - -      -- -     --        --
-     --      -            -  - - ---  -- - -      -   --  -- -    --    - -  - --   -    --- - - --
-  -   -       -- --  - -- -   --     -  --        - -     - - - -- ---    - -   - --  - -    - -  -
- -  - -   --- --  -   - - - --  -         -       -  -- -  -   -  -   --   -  -      -  -     --  -
-                    -       --  - -   -   -    - -     -- -    -  --  --  --     -  -        -    -
----       ---  -      --       - -         -     -  -  -   -    -   --  - --  --  -- --  -- ----  -
-           - -     - -  -    -- -  --      -   -       -   -   ---    --      -- - - -     -   -- -
-         -   -  -     - - --                  -  -   - -            --      --  -           -     -
----------------------------------------------------------------------------------------------------
