100
100
----------------------------------------------------------------------------------------------------
-        -            -    -       -  -     -     -   - --  - - -   - -- -   --  ----   -          -
-    -  -  -    --  - --      -   -        - -    ----    -   -     --  -     - --   --   -        -
- -     -   -      -  - -     -   -    -  -      -      -- -             -  - - - -   - --     -  --
-  - --- -     --- -   - -  - --        - - - -  - -  -      -  -  -- -    -         -  - --   -   -
-   - -       -                   - - -  -  -   - -  ---   -   -  - -      - - -- -   -  -  --   - -
- -- - -- -     -  -       - --  -  -     -  - -    - -    -   -         -    -  -     -  --      --
-- - -----  - - ---  -   - -  - -  -     --    -     -         - -    -   - -   -     - -    -  -  -
- -   -  -     --   --   --  -  - - - - -    -   -         -  -       - -  -         --         -- -
- ---  -      -   - -        - --   - --  -       --   -- ----- -   -- --- - - -    -  --  --      -
-      -  -     -       --  -  -    --      -  - -      - -    - - - -     -         --      -     -
-  - ---   -         -- -  -          - -     - --- -    -  - -   - -    --  -  -- -     -    -    -
-    - -    -   - -         --- -  -      -      - -  - - -    -- -   -- ---- --    -  -   - -     -
- -         -   - ---  -  ---  -  --  -   -   ---    -    -          - --  - -   - -        -      -
- -  - ----     -      -   -        - - -  -          -       - - -  - -    -           -  -   -  --
-    -             -  -- -- --  - - -    -  - --  - - -   - -     ---   -   -     ---  --    - -  --
-  --  -   -     -  -     -- -  -    -      -- --            -  -    -   -- -  ---  --    --       -
---    ---     -    -- -  -   --                  - -         - --   --               --  - - - -- -
- - -  - -  - - -     -  -  - -  -     - - ---  -  -    --  --- --   -  -- -   - -  -           -  -
-- - --    -  -    -   - --   -  -    - -       - - --    --  -  - -   --  -    -     -  - - -     -
- ---   --  -  -- -               - - -- -   -- -  -  --  - -- -   - - -    -    - -   -      - -  -
-  --        ---     -  - - - -   - - --- - - --    -  -   -   - -   -   -  -      - -  --     - - -
--- --    -   - - -  --- -  - -  - -   - -- -   -  -  -- -  -  -  - --           -         --  -   -
-   - -    --      -    -- -  - -  -   -- -- -     -  -      -   - -  - -  -- -    - -   -  - - - --
----- -- --   -  -    --   --    -   -- -  - -- -      ----  - -     -- -   --     -  -- - --      -
- -  - - -      ----      -  - -  --      -      -  --     -      --    -  -    -      -     -     -
-- - -  -   -        - -  - - --    - ---     -   -      -  -         -  --        -  ----  - -    -
-- -  -  - -  -- -      -     -          ---   --  - -       -  - -       - -- -- - -      -   -----
-   -  -   -        -  -   -       --  -           --  -- -   -   - -   ---  -   ---        -    - -
---- - -   - - --  -  -   -   -- - -     -- -  --           -  -      -- -      -         -        -
- -- - --  ---    --     - -   - - - - - -      - - --  -  -     --          - -- -- - - --    -- --
--   - -     -    - ----  -     --  -- -  -     - -   -  - -   --   --            - --- --   -   - -
- -      ---  - --    -  - --      -   -   -         - -- - -   -- -       -  - -- -    --  -  -   -
- - --  --  -  -    - - - -       - -   - -  -    - - - -      -   --  -  ---       -----   - - -- -
- --  -      - -  --  - -     --  - - -   -        --    -  -       - -    -   -   -   --  - - --  -
--       - -        -     - -    -----   -  -  --   -   -       ----    -      --        - -  - - --
- - - ---   -   -     -     -    - -   -    - - -     -    -   -     -  -- -- -  - - --   - -   -- -
--  - -   --   --   - - -- -          -   -    - - -  --- -  --  --  - - -   -  ---         -  -- --
-            -       -   -  - - --   --  --     - - -- -          -  -   - --  ---    -   --       -
- ---   -   -  -  -   -    -- --    - -      - -- - -   -   --   --               --- -   -- -    --
-   - -  --  -         -     -  --  -   --  -   -- - -     --  --         --   --         -    - - -
- -   - -- -  - -  -   - -  - -     --   -  -  - -   -          -   -- ---      - -- - - -  -- -   -
-- - -   -    -  -           -   --     -  - --                 -  -       -      --   -   -  -   --
-         -  -    - -     - - - -     -   -    - - -  -    -      -- --  - -     -   -  -    - -- --
--   -    -    -  -     -  -  -  - - ---     -  --  - -  -- ---  -        --  -  - -  -     -   -- -
- -- - - - -- - -         -     ---   - -- -  -   -  - -        --   -- --               -   -  - --
-    -    -      -  -- - -    - --  -- - -    -- - -        -  - -   -  -    - -   --  -  - - -    -
- -  --    -  - -    -    -    - -       -  -  - -     --  - -      -  - --- -  - -  -  -- -  -    -
---     ---         -    --- - - - -----  - - -   - - -    -    ---  -  -  -  -  -   -     -  -   --
---            -- -    -        - -     -   -   -    ---- - -   -- -  - -    -  -      -    --  -  -
-    -   -       -    --      -   --    -- -    - ---     - -           -   - -  - - -     -   -   -
-- -                   -  -  --   -  -     - -       - - -    -  -- --     - --  - -- -    -  -   --
--         --   -    -  -   -     - -  - -    - -     - -- -  --  --  -        - - -  -   - -    - -
-   - -  - -   -  -- -   --  -     ---  -  -  - -- -  - ----- - -  - --   - -     --       - -     -
-       --  - - - - -- -   - -       -   ---      -     --   - ----- - -    -    - -            -  -
- - ---  --         - - -   -   -  -     -- --  -  ---        - -         -   -         --  --     -
-      -   ---   -  - -  -    - ---      -    -      --      -  - -   - -   - -  ---       -       -
-       --     - - - --    - -     -  -      -   - - -    --     -     -    ---      -  - --- --   -
-    --  -- -  -- - -   - - - -  --  -   - --      -  -       -      ----        --  - --  -  -- ---
----            - --      -- -        - -  -     - --   -- -     -   --  - -   --         - -      -
-    -  -     -      - --        -  - - - -    - - - -   -   - -  -        - -               -  ----
-        --  -  --  --     -  -- - -         --    - -  -        --     -----    --- --        -   -
- -       --    -         -     - -   --   - -  --  -  --  -       -- --- - -    -      -   - -    -
--    --    -      -    --   -          -   -- -   ---      --   --    -  -    -- - -        - - - -
- - -       - -  -            -- --       ---   --- ---   - - - --  -      -  -  - -     -    --   -
-     -   -  -     -   - ---      --      - --      -   -   - -- -    -     -      -  -     --  -  -
- - ---      --  --    -   --  - -  - - - -     -  -  -  - -          - - -   -   - - -  -     --  -
-- - - --   -     -----    - - -- -        -  ----- - - -    -      -     -    --- - -   - - -     -
- - --        -- -   -   --- -    -  -        -   - --   ---  -    --- - -         -       - -  -  -
--   - --- ---  --  - --  - -    -  - --            - -   -  - ---  -  -   ---- - -    --   - - - --
- -    -  --        -         -- -   -     - --  -    - - - -  -   -      -       -       - --   - -
---      - -        -     - - -- -- -  --               - -      ---     -         - -  - - -    - -
- -     - -  -    -  --      --  -       -- --   -  -   -- - - -    -    -     - -     -        -- -
- -    - ---  -     - --    -      - -- - -    -   -        ---  - - -      -  -  -- -  -  --   -  -
-   -     -    -   - -       --  ---     -   --  -    -      -- --      -  - --         -     -    -
-   -- ---  - ----   - -   -- --    --   -   -    -   -  --    -- ---- --  - -      -  - - -  -- - -
--- -     - -       -  -- --   --             - -  -  - -             -   -   --     -    -      - -
-       -   - -  -        -  -       -- ---  -  - -      - -    - --        - -   ----       -  - --
- ---  --     --  --   -     - - - ----  -  --              - --        ---    - -   - - --      - -
-- --   --      -  -  -   --  - -     --      -    - --  --- --   --   - -- -         - -    - - - -
-  -  --    -- -      -   -             -  -    -   -  -  -         ----      -- - - --   -      - -
-  - -- --  -    -- - -      -        - - - -  -  -- -  -  -  -- -  -      - -  ------  -- -  - -  -
-    - -     -- -    - ---- -   -    -    - -       -  -- - -        ----  -  --   -     -  - -   --
--   ---  -  -      ---   -    --- ---  -     - -     -      --        -  --     -    ---  -    -  -
-      - - - -     - - --       --    -  -  - -    --    - -     - ---   -  ---       -- -         -
-- --      -      -  -    -  - -  -  --   -  -  ---- -   --  -    -       - -     - --    -        -
-       --    -     -- - -   -   - - -- - - - - -    ---    -         -    -  -    -   - - -----  --
-   -           -   -       - - -  -     -  -- -  - -   -       -      -     - - -- - -   -       --
---   - -  --         -   ---       -- -     -       ---  -    --    -   --    -     - --     - -  -
-  -    -   -  - ---  -  -    -- - -     ---   - --       -   -- -        -  -   - -               -
-----  -- -   -  -          -    - -- - -       -     -     -    --        -    -  - ---    -  - - -
- --  -   -     - -             --     -       - -   -    -     - - -    -  -  -  - -        -- -  -
-   - - --   --  - -   -  --  --      --       -      ---   - - -    -- --     -   -  -     - - - --
-  -  -     -  -      -   -   - -    - -  - -    -    -  -  -   - - - - -  - -  -   - - -  -   - - -
- - - -      - -  -       -  - - --  -  -    - --  -         -  - -           -  --- - -  -  -  -  -
- - - -   -     -  -  ---  - - -    - - - ---  --  - -         - -- -  --  ---       --  -   -- -  -
-  -- -   - -  - -  --  - --   -  --   -   -        -- --   -       -   ----  -     -- -  -- - - - -
--          -  - -    -     --           --  -  - -- -       -  - --      -    -   -  -     -    - -
- -   -      -    - --   --- -   -  --  --  -     - -  -  -    -   -    -- ---    - --             -
----------------------------------------------------------------------------------------------------
