100
100
----------------------------------------------------------------------------------------------------
-     - -    -         - ---  -  ---  -    --- -       -         --   -   -   -  -   --       -  - -
- -  - -     - -    -- - ---- -     -- - -- -     - - -    --   --   - -   --  -   --  --   -    - -
-     - - --         -       -   --- --    -  -   - -          ---  -  - -       -      - -     ----
-- -  --  -     - -  -- --  - --  -      ----   -    -  ----  --      -     ---    ---       ---   -
-    -  -    -  -  -   --   -  -    ----     -     --      -    --    --  -     - -  --  -    - ----
-  -    -          -     -- --   -  ---  - -  ---  - -    -  -     - -   - - - - - - -          -- -
- -  -   --      - -  - -      -  -     -  -  - -   - ---- -----   - - -      --          - -   - --
- --   --  --   --  - -    --  - -  -   - -   -  -    --       - -      - - - - - - -        -     -
--  - -     - - -    -  -   -  -  --   -      -   - --     -    - --  - - -     -   - -  - - -     -
----   -      - - -  --- - -     -     -   --   -- --  - -    -    - --   --     -   ---       -----
- -            -   ---- -   -    ---   -  - - -          -   -      --  --   - --      -     -   - -
-   -  -  -     --    -    -   -- -       -- --       --     -        -    ---     - -- - - -  -  --
-  -   -  -  - -     -       --  -  --    - -   --   --  -        - -  - --    -             -    --
-       -  -  - --- - -     -    -    ---   - - - - - -   -   ---  --- -    -     -  --   - --- -- -
-  - -   --   - -                 --    --     -     -    --  - - -    ---        --  -     -- -   -
--    -  -  -  -  --       - --       -          - -- -     --    - --  -    - --        - -    - --
--      - - -   -   -  -- -   --  -  - - -  -    - -    -- -  - - -     ---  --  -     -   -       -
- - -      -  -  - --    - - -     -   -  -  -- - -     -      -  -   -- -     -  - -  -   -       -
---    -    -        -   - -  - --- --  -     --   --  -  -   -     -     --   --     -            -
-  --      - --- -         - -      -  - -   -       -  -   -  -   -  --   --       -- - -         -
-     ---     - -     - -        --       -- -              - ---    -   --  --     - -  -   - - - -
-      -          -  -   --  --  -  -   ----         --  -   -   -- - --  -   -    - -- -   ----   -
-       --        -- -   - -   -      --             - ---     -    -       --   --    -     -  -  -
--   --   -    - -     -- - - - - -- -   ---     - -- - -  -  ---    ---      --  - --   - -     - -
-         ---          -    - -  - --       -      -   -  - -  -- -    --- -     - -  --   -  -    -
-     -- -    --    -       - --    --           --- -   -- ----    --      -  -          -   --- --
-  -    -  --   -   ---- -    --       -----      -       - -          - -- -- --          --     --
-   -  -  -   -   -        -      --   -    - -  - - -            --  -   -      -            ---  -
--  -    --   -    - - --    - -    -   - -   -- - - -    -           --   - - -    ---  ---- --   -
--    ---   -- - --- - -   -   -  -  -    - -          -   - ---   -     - - --   -     -       -  -
-   - --  ---              -     - -    -  -  -        -- --  -        - -  -  -- ---      -  - -  -
-   - - ----   -       -- -       -- --- --    --  --   -  --  --   -     -    -     - -  --     - -
- -  --- --      - -      -----  - -  - - -   -    -  --- --            -   --         -        -  -
- -     -     - --    --      -     -----   -  -          - -- - - -     -  -  -   -- ---    - --- -
-- -  --  -    - - -   - -     -- - -   -- -   - -  -- -    - - -     --  - --    -     ----  - - --
- -    - - - -- - -    - - -  -    - -     -   -   -   - -     - - -         - --  -- -     - --   -
- -   -- - --    -     -        -   -  - -- --- - - -       -  - - -  -- --       -   - -  -   -   -
-  - - -  ---  - -- -           -    --     -  - - -   - --  ---  - -       -   -  - - --  --   -- -
--- -- -      -    -   -             -     - - --  --     - -  --   -      -- - - -   -       -   --
-  -- -     - --- -   ---- - -     - - -- --  -   -  -      ---  -  -         - --    -----   --   -
-- -- -           -- -     -    --  -  -           --   - -   -- -  - - -     -    -  - -    -     -
- - - -     -- -- - -   -       -    -     -   -  -   -         - -     -        -     - -     -- --
- -         -- ---    - -  - -              -     -- --  --   -     --       -     -  --   -       -
-   - --   -       -   -    - - - - - -  - -   --        -- -      -  ---- - - -   -    -       - --
---      - -      - --      --  -    -    -         -      -  - --      -  - ---    - -    -   -   -
-   -   --- --      -        -            - -  - -   -    -      --  -                  - -   - -- -
-- - -          -  - - - -  -  -- - -     -   - -  -  -- -  --   -   --  -          - -- -- - ---- -
-   -   --  - - - --  -     -  - - -   --  -    --  -         -  -     --     -  - -         -  -  -
- -   --  - - - - - - -  -  -      -   -     ----    -  --- -   -     -    -    -     -   -    -   -
- -       --  - --  --  - - - - -   --  - -   -- -        -      - - -  -   -   -   - -  - -   - - -
--   -   --  - -     -     -      -    -   -        -  -  - -  -         - -       -  - --         -
- -  -      --  -            -        -  - -  --- -    -  - -     - - -- -   --  -   -   -  --  - --
-    -   -- -  -     --    -      -- -                 - -    -    -     - - --- -  -      -  -    -
- --  -   -         -       -   -        -   -- ---  --  -- -  -    --      -    ---  - -  -   --  -
--  -            - - -- - - -    --               -     - -   -   -    -  - -  -   - -- -       -- -
- --  - -  -    -    ---  - -  ---   -      -    -   - -       ---   -   --       -    -        - --
-  -  -           -   ---  --  -   - - - - -     - -- -   ----    --    -  --- -  - - -      --    -
-- -   --  - -     -   -       - - -     -  -  - -        -     -  - -    -   - - - - -   -  - -- --
-         -  -- -  - --   -           - -  -  --    --    -  --  -   -       -     -- -   -- -    --
- --- -  -- - -----  - -      ---  - -    ----            --- -       - - -   ---       - - -  --  -
-    - - - -      -                 - - ---  --    -     -  --      - -  -- --    - -        -   ---
-----  - - - --- -   -- - -- -  -           -     -       - -- -   -    -- -         -  -- -    -  -
-    - - - -   ---     -    - -    -    ---  -         -        --    ----    - - --         -    --
- -  - -  -     - - -        -     -     - -      - -  ---       --     -   -  -    - - -   --     -
- ---  - - -  -- ---    - -       - -- --   -    -  -- - -  --   -   - -  -  - - -  --  - -- -   - -
--     - -  - - - -  -  -  - -   - -      ------ -   - - -   -  -  - -  --          -   -- - - -   -
-  - - - -    - - -  ----    -  -   - ---     -    -    -   -   -- -        -    ---  -- -   - - - -
- -    - -       -    -- - -- --- -  --           --  --  -  - - -  -  -  - -   -        - -       -
- -- - --- -  -    -    -- -   - -  - -- - -     -- -   -    -   --  -         - -  - --  ----     -
- -     ---  -  -  -- --  -  --- --    -   - -          -    -    -   ---     -        --  -  -    -
-   ---     --  - -- -   -       --  --   - -  - -    --- -      --    -  --    -     -  -  -      -
-  -   -    -  -    - --  -- -- -  -    -    ----     -    -          -        ---- - -  -   --   --
-   ----- - -    -  -  --  -       --- - -        -    -- --     -  -- -  --   - -  - -  --  -  -  -
-    - -        -     -- ---  -   --   -       -      -  -  - - -     -   -  --  -  --      -   -  -
-     -    --       --   -   - - - -   -  - -- - - -    - -- - --    --  -   ----      - -  --  -  -
- -   --            -    -  -  -         -   - - -  - - -      --   -  -   -- -   -  - -- -      - -
-         -    -   -          - -   -- -  --  --- -    ---  -   ---    -        -     - -    - -- --
- ---  -     -   -   -   - -        - -   - - --   --   --    - -   -  -- -    -       -   - --  - -
---  --  - -     - -    --         - -  -       -                 -  -     -  - - --   ---      -  -
--         - ---- -  ---  -   -- -         -  - -   -        -- -- - -       -  -   -        -- - --
-  -  -     -          -      -   ---   --  -- -  --          -   - - -  -- -  -   - -     - -  - --
- -   -       - - -   -  -   - --  - -      --  --  - -   --            - -    - -       --- -     -
- -- -   - -- ---  -       --  -      -    - --     - -         - -      - -  - --  -  -   -- -   --
- -  - -  -              --- -   --  -         -    -   -    --  -    --      -- -   - --     -  - -
--  --        ---          --   -- - -  --  -       - --  - -  -      -    - -    --           -   -
-  -   -    --    -       -    - -    -       -- -   -  - - - -   - - ---  -   --      --   -    - -
--  -   --         -     -     -   -   -      ---  - ---       -         -  -- - ----     - - -    -
--      -  - --  -   -   - - -- -- -   - -  -  -   ---  -  ---- - -  -   -         - -            --
-         - -      -  - - -  - -     -   --    -    ---      --       -   - -     - ---    -   -- --
-   -- -- -  ----- - -       -  - --- - -  -   -  -- -- - -             - - -- --- -   -  - - -  - -
-  -     --     -    -  - -        -   --- -    -  -      - - --      - -            -- --  -      -
- -          -    -   -     --  --- --  -    --   -  -   - -    -- -       -  --   -       -       -
-    -  -      -           -  -- - --  - -   - - - - --  -   -  -  -   -   --   -   -  --     -    -
-  -   -     -  - --      -  -       -   - ---   --  - -- --   -- -   - -  ---- - --  -- - -       -
--  - ----             -  - - --     -               -  -            -     -    - -    -  -  -     -
-       - -    -         -        -   -      -  -- - - - ---      --   -    -  -  -   -      ---  --
-    ---  -      -     -   -  -- --     -     -  -  -  ---     -       -  -  -   -  -   -    -  -  -
-  -        - -  -   -    -    -     -   - -        --   - - --            -     --         -  -   -
----------------------------------------------------------------------------------------------------
