100
100
----------------------------------------------------------------------------------------------------
- -       -         -    -- -   -     - - -   -   -  -      --              --    -  -   -      -  -
-             - - -  ---        -       -   --  -    -    ---  - ---   --    - -   - -   -   --    -
-      - --      -   - -   --       -- - --   -   ---  - -     -  - -   --   -  --     -  -        -
-  -  -     ---     - -  -     -  - - -        -    --    -   -     -     -   -  -   --  -  - -    -
-    --    -  -       -   -  - - -    -   - ---  -  -           -   -         --  --  -    -     - -
- --          -   ----  -  -  -- -- -    -        --   -  -  -   - -------        - - -  - -  -    -
-  -  -    - -         --       --  -           --  -- -   - -   --          --     -  -  -      - -
- -- -  -   -   -  --- -  -        -    -     -- - -   -  - - --     -     --    -      - -      - -
-       - -     -      -    -   -   -  -         --    -      - ---    -  -            -   --  -  --
-     ---    -   --- -- -   -      - - - -  --   -   --  --   -   - -  - -  --     - -  ---        -
- -       -  -  -     -   --   --- - -   --       -       -    -- -    - -    ---  -          -    -
- - --  ----  - - -  - - -          - -       --   - - --- ---   -  -  -- ----   -   -  -        ---
-  --         - -- -- - -      --- -     -       --   - -                - --   - - -   --  - -    -
--    --  -    - -  --   -   - -     - - - -      -       - -  -              --        - -     -  -
---  -   -- -   - - -          - -            - -   --   - -  -  -  ---    -   - - --  -     -     -
--     -       ----     - - - --             - -        - -     -    -      -   --  -     -   -    -
-  - -    -        -- -- -      - - --         - -  -   -    -  -   -  ----  -       -- -  -  -  - -
- - -  -  -    - --  -  -  -- ---  --    --    - -     -   --  -    --      -         --          --
-- --- -    -- - - -- -- -- - - - -    --     -   --       - - - - -  --       --- -  -            -
-     - - -- -    - ---      -    - -      -   -      - --  -- - -  -  --   - - - -- -- -- -   -   -
-      -- - -  -- - -      - -   - --  --       -          -     - -  -    -         -   - -  - -  -
-   -- - -   -      -- - --   -  -        ---     -      -  - - --- -  --   - - - -    -   -    -- -
- -   -- --  -- --  - -- -     --  - -- -- - -       - - -  ---    ----    -   -- -- -    - ---    -
- -         ---       -    ---  --      ----  -        - - -    --- -      ---        --  -   --   -
-  -- - --   -  --  -       -- - -   -   --  -  ----        --     - ------    -        - - --  -- -
-        -    -  - -          -- -- -   -         --     ---  - -      -  -     -    -    - -   - --
-    -     -   - -    -  -    - ---    -  -          -  --      ---  - -    -- - -  -         --   -
-  -  - -   -- -    --- - -  -   - -      - ----       -     -- -  -      - - - ---   --   -   -   -
- -     -   - - -    - - -      -   -  -       -      ---        -  --   -    -   -       -   -- - -
- -   -       -            --   - -  -  - -    -     -   --   --  -     -     -  - -   -           -
- -     - - -        - -         - - - -     -  -- - -  -           --  -   - - --   - -     - -   -
--  --     - - -   -  -  --  -  -- -   ---    - -- -     --   -      --- --        -- -  -       - -
- -        -   - --    - -  --   - -    - -        -  --  ---    -  -      - ---        -- -       -
-            -       - -- --   -  -   - -  -  -   -  -   -    -    --  --       -    --          - -
-- -     -- -   -- --- -  - -  -      -      - -        - --  - - -    -   - -      -  --- --     --
- -    - -           -  -  - -   - -        -     - - ---  -      - -     -     -            -     -
-      - -- --         --    - - --        -- - --   -               -- -  - --    -    -----  -   -
--  -   -        -  - -  --  -   -   - --- - -   --- --  -- -    -- - -  -      -    - -   -      --
- -     --  ---     --  -      -- -      - -  -   - -    --    - --    -   -          -  -   - -- --
-  -      -  -- -- --   -   --   -  -  -  - -  -   --      - --  -       -  -   --   - -  ---    ---
- -     -       -  -- --  -     -     -  --     -    - ---  -    - -- -   - - - - -  ---- - - --- --
-    -  -    -   --  - - - ---  -   - -    - - -  - -      -   --  - - --  -  -       -        - - -
-- -       --      -   --    -  - -          -   -  - -     -    - -- -        -- ---      - --    -
-     - - -   --     - -  ---- -      --     -   ---   - -  -          - -   -    - - -  -  -    ---
-- --   -     -   - --    - -    -          --- -  -         -    - - --  -  -- -    -- -   - --   -
- - - -   -   - -  -- -  -     - -- -  - -   - -   - -     - - -     -      --- - -   -  -   -  - --
--     - -  - -         ---  --    - --     --  -    - ---        --     ---      - -   -  -- - - --
-   -- -   -- - - -  -     --   -   -    --- -      -  -    -- - -     --       - -- -    -        -
- -      - ---- --    - -     --      -     -  -   -     - - -      -  - --- -  --     --     -- - -
-         -  -    --- --  -        -   -     --      -       -  -  -   - -     -    -      --      -
-   - --    - -  - -  -  -     - --  --  - -    -- -    --- - -  -    --  --  --- - --       -     -
----   -  -  -  - - --  -  -- -     - -   --            -      -   - -    -  --    --     ---      -
-       - -    -  - -       - - -    - --    -    -     - -   ---  -        - --   -  -   ---    ---
- - - --     - -    ---  - -    -    --  --     --   -- --         -  -     -    - -          - -- -
- -     -     -- - - --           -      - ---     -      - -       -       -     -    -  - - -  - -
-     -    -       -   -    -   -    -- - -   -  -   - -   -     -       -  -            -  -      -
-    -           -      - -  -     -- --  --   --   -    -- -     --- - -   --   - -  --- -  -     -
- -   -     - - -      -  - - -   -        -    -- -     -  - -- - - ---- -  -   - -    --     --  -
-       -   -  -  ---  -  -   -   -     -   -  -      -   -       -             -  - - -- - -- --  -
--  - -  - - -              -  -   -   --   -  ---     --    - -   -         -          - - --  -  -
-  --  - - -     - -      -   --    -  --  - -       -  - --  -    -     --  ------     - --   -  --
-    -- -- - -  ----   ---          -   -          -          -  -   --   -      -- - -  -         -
--  - -       - -     ---    --  --          -- -      -- -  - - -  --  -  --- -    -  - - -  -    -
-     -  -  --  - ---  - -    -    - -    - -- -       - --  -     -  -   -- -  - - -      -      --
-     -          -   - -  -    -- --  ----    -     --  -    -     --- -     --   -  - --  -  -  - -
-   - -   ---    - -   - -   -   --    --  -   - --  -   - -    --- -     -- ---- - -  - -  -- -   -
- ---  -    --        -    -  -  - -   -  --       -    --  - -    -    -  -      -- --- - -     - -
-      - --       -    - -  -  -   - -   -- - -  -  -    -     - -   -  -     ---    - -- - - -- - -
--    -        -   - --     -        --    -    - -  -  - ----- -    - -    --   -       -     -  --
- - - - - - -   ---     -          -    --   -  -         -      -     - -    -  -   -  ----   --  -
-- -   - -         --      -----   -  -      --    -     -   -   -  ---  - -    -   - -   - -  -   -
- -  - - -      - -   - -  -    - - -       - --    -  -      -  -        -       - --    -- -    --
-- -       -  --  - --      -  --     - --    -   ---- - --  - -    -- -  -   --- - -          --- -
-      -     - ----    -    - --  -- -- -    -  --   -- ---    -  -   -     -   -   - --  ---  - - -
-    -    ---       --    -  -  --    -  - - -     -  -- -  - - --   -  - -  -     -    --         -
-  -          --   - - - -  -    - -    -  - --   --     -- - -  -  - -    --    -  ----     -     -
-    -    - -   -    -    -    -    -        -     -- --  - -  - -- - -   -- -     -  -    --   ----
- -- -           - -- ---  -   - -   -     -  -   --       - -   -----   -  -     -- -    - - --   -
-   -       - -- - ----     -       ----- --  -     - --- -  --    -   -    -  -    -   --  -  -  --
-       - - -   - - -  --  - -      - -    -  - --- -   --     - --  --   - --            --   - - -
- -   -  -    - -    -- - -      --  - -    -        --      -  --       - --  - -- -  --  -- -- - -
-   -     -  --  --- -  ---    -  -         -    -  --- -     -- -   -        - - -   --   - --  - -
- - --  -  -- -   -  -      - -     --      --  ---    - ---          -     - -     -      -     - -
-   -     - -   - -      -     -      --   -  --          -   -  ----- -   -  --  -   ---    --    -
--  --   -- -        - -     - - ---    --     -     -       ---  -  --   - -      -  -- ----   -  -
-    -       -     -   - -     -      - -  -        - -    --       --- -    --  --   - -     - -- -
-       -      -   -        - -     -    - --      - -     - -    --   -    --- -  -- -   -- - - - -
--  -   -- -  -  - -   - - - - - -  -- -   -  - -- - --    -   -    --   --       -       -   -    -
- --- -  - -     -     -     -      -     - ---      --   -  -     - - -    - --  ---        -     -
-  -- -  -   --   -  --     ---- --   --  -    -    - -  - --     -   -  - --  -- -   - -   --  -  -
-     -   ---  --- ---      --  -      -   -         -    -   - -   - --     - --     -      --  - -
- - ---  -   -   -  - - - -  --    - --  - -  --  - -     -           - -   - --    -      -    -  -
-    -    - - - - -  --   -               -   -  - - --     -       - - - - - -   -      -   -     -
--      -  -      --    -  ---    - ---        -   --   - --  -  --  - - -  -     -       --    -  -
-   - - --- - - -   -  - -    -    -   --  ----  - - -   -           -       -   -  -- -  - -     --
--    - - ---   --- - - --  -- -  ----    -  -  -- - - -  -      -    - -         --  - - -      - -
-- - - -  -  -     - --    - - -     -    - -     -  -      -  -  -  -       -- --  -     -- -  - --
-         -       -- -   -         --  -   --   -  -             --  -     -        - -  -         -
----------------------------------------------------------------------------------------------------
