100
100
----------------------------------------------------------------------------------------------------
-    -      --     -   --      -      -  -    - - - -   -            - - - -   -  --- -    -    -- -
-- -    -     ---   -    - -  - - -  -- -  -  - - - - --     - -  - -    -  -  -    -   -          -
- ---- -     -            -  --- - -    - -   -  - -   -  -    -  -     - -      --  -- ---     -  -
-      -- -      - -  - -     -      -- - - -  --      -      - - -        - --   -     -  -  ---- -
-  -  -      -   -- -   -- --      - --  - --  - -      -  ---   - -     -- -- -- -      ---       -
-- -   --  -    ---  ----  -   -   -     ---   --   -- -               -    -  -  -    -      -   --
-        --   -   - - -  ---   -  --     -- --    -            - - - -  -  -   --  -  -   -  -   ---
-   -    - -    --- -  -- - -    - - - -  -    --  -  -   -  --       - -   -- -  - -- - -    - - --
-  -   -   -   -    - -  - -- -  -- - -    -  -      --  -       -  -   -- - - -    -              -
-  -       -    -       -    -   -  -----   -      -  -- - -- -  -     -   -  - --        --  - -  -
- - - - --    -- - -           - -   --  --   -   - -  -  -  -  -  - - -   - -  --  -            - -
--     -   -          - -    -- -   -  -      - -- -    - - --  - -     -     ------   -    ---    -
--     -  -  -      - - --  - -      -    --   -  -  -    -   -   -    - - -   --   -    -- - - -  -
- -     -   -          -     -     - -   - - --     -  - -        -          - -           -    -  -
- - -            -     - --- -- --- - -     - - -           --    -    -  --  - -  -     ------ ----
- - --     - - -   -  ---  --  -      --  -  -      -     -        -        -   - -  ---       -   -
- - - - -   -  - --          - -   - - - -   - --  -    -  - -    --    - -- - -   -       - --   --
- -- -  - -   --   -       - -  - - -       -   --  - --- -- --     -- -  --    -    - - - -    ----
-   - - --   -  -  -- --  -  --   --    -     -          - -       - -  - -  - -   -- --  -  - -----
-  ---            -  -  - -        -   - - - - -   ----   --  - -  -   - --- -   - -     -    -  ---
-       -  - - - --- -         -    --  --  -   -----          -  - -   -  - -- -    -      -  -   -
----    - -      --     -   -- - -    -  -   --  - -      - - -     - - ---   -  -         -    ----
-    -- - - --- -    -- - -    -   -  ---  -      - - - --     -      - - -  -        -         -  -
----    - --   -  --    -- -        -      - --  -  -       --   -  -  -  -    - - -   - -  - -- - -
-        - -        --      - -  - --- --- -   -- -   --  -      -    - -    - - -   - -   -   --  -
-  -  - --    -  -     -    -        -  - -    - - --  -  --    - - -       -  -    --   - -   -   -
--  -- -    --  - - -       -  -     - -     --    -       -   -       - -   - - --   - -  ---  -  -
--    -  --  - -- -   - -    --  - ---  -    ---  -  - --    -   -        --    -  --- -  -   -    -
-  -    --  - -- - -       -   --   -- -         - --  --  - ---        -     - --- -        ----  -
--      - -             -          - -  - --         -     -    - -        -   -  -   -     --     -
-  -  --        -       -     ---  - --  -- -      - -  --   - -     --   --   ---    - -  -       -
-     - -        -  ---       - -  -            --- -  -   -                        -  -     -     -
-  -    --       -   - -    - -    -     -      - -       -  - -- -  -   - ---- -     -  -   -  -  -
---   --  -  -  -         --          -    -   -  -   -- - -  - -  -    -- -    -   -   -         --
-          -     -   -----     -  -   --- - --     - -   --       -  ---        --   --     --- -  -
--  - - - -   -    -          -     --  -  -   - - ---  --     --     - ---- -   -   -    -    -  --
-  - -  - --          -- -        -   - - -   - --    -       - - -   -    -       -- ---     --   -
-   -  ---   --   - -   -  -       -              - -   -      -  - -      -   - --  -- - - -    - -
- -       -               -           -- ---  --   -  - - --     --   -   -  -      -  -   -  --- --
--         - -  - -     -  --    -   -     -     - -  -   -  -    - - -    -      -  - - -  -     --
- --    - - -       - -     -  -  --    -- -    - -    -- -     -              -    -    -     --  -
-- -- -   - --  - - -          -- -    -- -       -       -  - - -  -   --- --   --     -  -   -   -
-          ---   - - -  ---- --    -  -  -   -  --     - -   - -       -  -  ---- --   -    -   - --
-   ----     ---       -- - - -- --   - - -   --- -     --   -  -- -   -     -             -  ---  -
- -     --   -       -    -   -   --     -         - - --  - --     --  -    ---     -   - --- --- -
- -  ---      - -  -  - -        -  -  -   -  -                -  -      - --          -   -   -   -
-  -    -- -     -    -  -   -    -  -           -    -    --       -     -     -   - -  --     - --
--  - ---       - -   ---  - -  -   -         ---           --  --   -   - -   -- - - --     -  - --
- - -      -    --   -        -  -     -  - -- - -  --   ---   -       --  - -      - -    -  --   -
- -     -  - -  -  -  --  -- - -   - - - -        -  -   -    -   - -   -     -        --- - -   - -
-        - -   - -   - -  -     -  - -  - -  -----   --   -   -         -    --  --  --- -     --- -
- -             - - - -    - -      - ---     -  ---       -   - - -   - -     - -    --   -       -
-     -  -    --    -   -- ----     - -   -    -     - -   -    -  - -  ---   -   - -   -      -   -
-   -     ----   ---    - - -- -          - -     - -    -    - - -  -  -     -  -- -     -  ---- --
--  -              -    --- - --  -  -    -- -- --- - ---      - -    --  -       -    - -  - - -  -
-- - - ---  --- -   -      ---     -  -    - -       -          -      -   -   --       -  ----- ---
- --- -- -  - -      --         -   -     -   -    -        -  --  --   ---          -   -       - -
-       -    -  -  - - -   - --          -     -       -    - - -   - -     -  -   -- - -  --      -
-- - -   --   -      -   ---   -   - ---   -   -  - --  -----  - - -  ---  - -  --    -- -- -   -- -
-- -     -   - - - -  - --      -         -  -- -      --     -      -       -   - -- -   -  -     -
--    - -    --  -  -   - -      -   --  - -- - ---- -   -   --  -        -  - - ---    - -        -
--   -       --     -  -  -      --     -  -  -     - -  -         - -  -  -- --           - -- - --
- --  -      --  -- -   -   -  - - - - -     - -  -        --- -- -- --- - -  -  -         --    - -
- --       -  - - - --       - -      -   -   --  -- -    - - -  --  -  -- -         --   -        -
-       --  -      ---   -   --  - -   -    -   -      -  --  -        -  -   - --- -    - -     - -
- -        -    --  -   -      -  -   -- -     -    -   -    -    -- -    - - -  -     -- -- -  -  -
--   -       -  --   --   -  -   -- - --  - --   --- -   --    -     --     -   - --    -    -- -- -
-   -  - -        -    -        -    -         -   -    -    --- -  -      -  -       -     -  -  --
-    --  - --   - -    ---  - --      -  -   -    ---  -        -   - - -      -      --  --  ---- -
-  -    -- -      -- --  - -      -   -       -  - ---    -  ---- --      --       - -      -  -   -
---     -  -  -     --    -  -     -       -            - --- - -          - -    - -     - --   - -
-  ----  -  --    -   - --- -   -  --       -  --    -  -     --        --      -     -    -- -    -
- -      - -    -  - -  - - --- - - --  -   - -      --    -  - -            -       -           - -
-          --  --    -  -- -   - -  -     --                       -    - ---  --  ---    ---- --  -
--         -  -- ---      -  --- --  - -    ---   - -- -  --- -        ---- --- --     -    - -  ---
- --  - -  -    --- -- --      -    -     --  - --     -          --       -  - -  ---  --    - -  -
-  -     - -        -  -    - -- - - -     - -        - -        - -      -  ---    -- -   - - -   -
-   - -   - --   - -     - ---   ---  - - -- -- -  -   --    -- --- ---- -- -   --      -  -   -  --
-   --   -   --- - --    -     -     -- - --       - - -    -     -  -        -     -- -   -    -  -
-    -    - -  --   --    -  -     -              -         --      -- -     -    ---   - -   -  ---
- --- - -        - -- -   -            -       -    -     - -           -      --- - -     - -    --
-           -  -- - - -  -    -  - - --    -   - -   -  -   --      ---           ---- -  - --     -
- - -   -   -    -- ---     - -  -     --        - -  - -- --          - -- -  --    -- -    --  - -
-  --        --   -   - -      -- -  -    -   -    --       - --      -  -       - -     -         -
- -     - -- -   -  - - -  -- - -    -   - --  -   -    -  -     - -    - - -  -              --   -
--- --   -   --    -     --          - - - - --- -- --      --  - -  ---- -    - -   -  --      -- -
-    -   -   - - -  -  -    ---     -    -   -     -    -    - ---   -  - ----  -  -   -           -
- -        -- --         -- -- --          --   -    - - --         -  -         -     - - -- - -- -
- -     -- - - ----   --  -   -  -  - - -       -          -    -        --       -  -  -    --- - -
-  - -- -  -      - -- --     --  -- -             --- -- -    - - ---  -    -  -  -          --   -
-     - --    - ---     -  - -         -  -  -  -  -    -  - --       -- --   -   -  -  --   - --  -
-- --   -- -   - -  --             -    -  - -   --  -  -- ---  -       -    -   -     -    -   -  -
-  - -    -- - -- --  - -      -     -- -  - -       -    -   -   -- -   - --    -  -            - -
-     ---- -  - -     -  -  -       -    -  -    -       ---  - -   -  -- -  -   -- -   -    -     -
-   -          --  - -        ---  - - -  --         -  -       - -  -    -   - - -    ---   -   - -
-   -   --  -           ---  -  --   --- -  - - -  -    -- -  - -    - - - -     -       - -   --  -
--   -  -      - - - -    -   --  --  -  - - -  - -  - - - - - - - -   -  -    -   --      -     - -
- - - - --          --- -        -    -      -  - -    - -       -     -- - -      -  - -- -     - -
----------------------------------------------------------------------------------------------------
