100
100
----------------------------------------------------------------------------------------------------
- -  -- - -      -  -  -        -  -          - -   -     ---         - -             --  -     -- -
- --      - --     -    -   --      -  -       -  -  --         -- -      --  ----       -  - - -  -
-- ----    --   -- -       -  --    - -  --    - -     --  --       --  -    -  - -    -    - -    -
- -       -   -   -  - - -   -  -   -- --  - - -  -  --    -   --    - ---    -              -  - --
-    -    --   - -    -- --- ---                   -  --   -       --       -    - --    --        -
-  - -       --   ----                -  -- - --   --   -- - - - - - --  -  -- -     -  - -     - --
-  - -  --- -   --     -- ---- -   -      -  -  ---  - --   - -  - - -  -   -  -     -   - - --  - -
- -   -    - -      - -      -   -   -      -- -        ---  -   --       -   - -- -    -- - -     -
--      - -  - -    - -       -    -      - -    -      -  -   -     -   -            --  -    --  -
-- -  -      - -       - --  - ----  -     --  -  --  -  -     -- --   -          - -- - -   -  - --
--  -       -     ----      -- -    -  -       --      -- - - -     -  -- --  -  --         - -  - -
-- -- - - - --   - -      -- - - -  --   -    --- -     -      -     -    -         -  - - -       -
-           -  -      - -      -  -    -  -    - -    -     --  -     - -   -  --    --- ---   -   -
-   - -- - -- --   -  -   -     -     -             - - -     -   -     -   -  -  -- -     -  - -  -
- - -  -          - - -    -  -  -        -  --  -     -   - -      ---      -  -  --   -         --
-   -       --  -   -        ----    -  -  -     - -       --           ---   -  -  -     -     -  -
- -   - --      --   - -   -- -     -   -      -   - --  - -   - -   -       - -  - -  -  -- -     -
--    - -   ---      -    -    -- -      - -     -  -     -   --    - -    - -   --      - -- - - --
-   - -  - -   ------ --    --     -  --  ---   -- -   - - -- -         - - - --     -  -       -  -
-  ---     - -           - --    -- -  --    --  - --  -          - -     -- -      -  - -- -- - ---
-  -- -  -   -  - --  -   -   - -- -   -   - -  -    - --- - -  -  - -   -  -    --  -- -  -  -  - -
-    ---    -   -     -     --         -     ---   - -      --   - -     -  --   -- -        -  -  -
- --    -   -    -   -  -    - -  ---  -   - --         -   --        -   - -  -   - ----  - -  -  -
-  - - - - -  -    -- - - --- -        - -   -     -     - --   -  - - -   -  - -  -      -   - -  -
--        -        - -  -        --- -  -    - -- -  -      - -  - -          -  --    -    - - -  -
-     -     -  --   --   -- --  -   -         - -  -     -         -     - --         -     - - -  -
--- -   --         -      -       -    - --- -   -    - -    --     - -    --    - -- - - -  -  -- -
- -   --- - -  -   -  -      ---   -----       -    -    -  -     -   - --- --      -  -    - -  - -
- -- - -  - --  -     -  -- -            -        -   -- --  - - --    -  - -    - -- -   - - --   -
-- - - - --   -- -  - --  -     - - - --  - -       -  -   - ---  --   ---      -- -     - -  --   -
- - - -  -    --  -  -    -- --  - -   -      --      - -- --    -   -    -- - -- -  -   --        -
- -   -            - - - - -   - - -  -     - -     - -      -  -   -  -  -   -      -- -   -    ---
--  -- - -   --  -  -  -       -    - ---    -         - -       -  -   - - --  -----  --       -  -
-       --     - ---     -   --            -    ---    --  -  ---- --    - --  -     -   -       - -
-      -  --    -   - --         -  -  --- -   --  -      - -           - -  - --  -- -- -     --  -
-  - -  --        - --  -- -      - - --            - -      -- --  ---   - -- - -   -   ---  ------
---       --  -    -     - -  --       -  -   -     - - -   -  -      - -  ----       - -   - -    -
-   -        -  -- - - -- -           - --- -    ---     -----     - -  - -  -  -  -    -          -
--- -  -  -         --      - - -       -  - - -       -  - --    - ---    -  --- --   -  --     - -
- - -         -     -    -     - -   -    -        -   -       -            -      -     -         -
-    - -   --  - -   - -- -  - -         - -    -   -       -  -  --    -  -    -- -   - - --    - -
- - -     - -  -       -  - --    -- --  -  -      -- - -    -   - -        -         --   -  -    -
- -  -- -       - --   -- -        -  -                --   --  -   -     - -    ----  -        ----
-  --    - -  - -- -- -  -   ---  -   - - -  -   -  -   - -  - --  -   -    --   -  - -  - -  -    -
-    ---  - - -  -     -  -      -  -   - --  - - -- -          -   -  -   -    - --   - -    -    -
- -    - -  - --    -- --   -    - ---     -         --  -         - - -       -  -  --      -    --
-     -     --    -      -    ---    - --  - -        -     -  - - --        -     -    -    -  -  -
-     -  --    -        -- -        -     - -  - - -    - - -      - --  -      - -        -     - -
-   -  - ----   - --- -       -- ---      - ----       -- -   -          ---   -  - -        - - - -
- -       -   -       ---  -- -       -     -    --    -  --         -          -  -- -            -
-   - - - - --    --   -  -   - --       --- ---     -   -   -           -   ---    -  - -  --- -  -
- -   -  -  -  -  - -         --       - -         -  ----  -      - -         --- -    -   -  --  -
- -     --    - -  -     -  --- - -       - -          -  -   --    --  --- -- -  -    -- - -- - ---
-  -   - -  -  - -    --  --       - ---      - - --- - - -      ---   -    --   --       - - -    -
- -    -- --- -  -  -   --   -          -   -  --             ---  - -       -  -     - ----      --
--    -   -  - - -   -- -- -    - ---  --  -- - -  --  -   - -  -   -  -   --- -    -   -       -  -
-- - ----  -  --   -      ----  -- -- - -    --           - - -   -   - --   -     -   - -    -    -
--  -  ---          --  --    - --  - - -       -- --    - -  --  -      -    -  - -  --     -    --
--   -      - - -  -     -    -- ---    -- --- -     -  -  --   - - - -  --                 - - -- -
--  -   - -  --        --  - --      - - -- - -   ---  - -     -   --       - -- - -  -  -- --   - -
- -     - -   -   - - -     -   -  - - --    -- -   - -- - -   --- - --   -       - -  -- -  - --  -
--    --    - - --        -  -   -       - -   -- --  -    -     - -   -     - -  -   -  - -   --  -
- - - - -- - -    - -  -     -    -   -- -  - -  - --    -    -  -   - - -   - - - -- ---    -     -
-     --        ---  -    -   --       -   - -  --       - --     - -    -   - - - -    -      - - -
-    -    --   - -    --          - --  - -  - -   -  - -  -   ---   -    -   -    --- -  - -      -
- - -    -    -    -     -- -       --  - -    - - -   -     ----  -- - --     - - -   - - ---   - -
- -       -  -  -   --       --   ---     - -  ---    --- -      - -   --    -  -  - --      -  -  -
--  -   -      - - -  -     -  -  ---   -    --  - -- -    -     - -- -        -   -   -  -     -  -
- -   -             -   - -     -    -- - -    -     -      - -  -    -     -        --- - --    ---
--   -    -- -  -  - -   -      - -   -   - -  -     -  -   -  -      --  -  -  - -     ---  - -   -
-      --   -- --   - ---  - - - -    -   -   --     -      -- -  - -       -- ---      - - -   -  -
-  - -      ---     - -  -  -   -     -  -  ---   - --  - --       -     - -   -    -  -       -- --
-    --      -    -- -   - -      -     -- -   -   -  -- -  -  ---   -   -       - -  -    - -   - -
-  -   -- -- - -  - - - - - --- -   ---- - -      -       --- --  - -  -- -  - -   -          - - --
-  - -- --          --- - -    -  --    -    -- -  - -- -       -       -  --  -   -  -  - -    -- -
- -  -  - - -  --    - --  --      -- -- -  -   --       --   -- -- -    -   -       ---- - ---  - -
-  -  - --      -   -    -          ---   - --- -   -          --    -- -    -   -   -   - - -     -
--       -    -- ---   -   -   -       - ---     -- -   - -  -    --     -  -  - --   - -    -     -
-    --   -      -          --   ---       --- - -      - -     -   -              - --- -     - ---
- --  - - --  -     -          -     -    - - --  -     - --  -   -   - - -  - - -  -    -  -- --  -
-    - --   - -  -          - -  - - - -- -     -  - -   -          --          --- -    --      - -
- ----- - --  -   - -  -   -    -     - - -   -        -      - - -     -  -       - --   -   -  - -
-- -   -    -    - - --    -      -     -     - ------   --      -  --  - -      -      --  -   -  -
-    - -   -  -  -  -    -  -    -  -          --   -   -  -  - - -  -- --      - - -         -  - -
-  -  -  -     --    -    -    -          -  --   -  -  -  - - -   -- -        -  --          -    -
-  -    -  - -  ---   -   - -    -- --  -    --  --  --- -- -- --   -      -       - ----- -    -- -
- -  - -- - -  - -    ---  - --  -  --   - - -  -         --     -   -       --   -         -   -- -
-    - -  --  - -- -  --  --- --  -   -   -   --  -  -  - ----  - - -          --  -  ---       -  -
--      - - -  -     -     --             - - -  - -- -  - --  --  -  - - -  -  -   -       -- -   -
- -  -  - -     - -         -     -   - -  -    -      -  -    -   -     ---- - ----   --  - -   - -
-       - --   -   -  - - -  -        -  -           - --- - -    -- -   -     -  -     - --       -
--    --    -   -    -   - -         -      -- --      --      -  -    --- - - - -  -    - - -- -  -
- -  - - - - -       -        - -  -      -- -   -     -- -- -    --  -          -       --   -    -
- -            -    -    -- -   -- -   -          -    -   - --  -   - - --    -   - -      --     -
-- --    --     -  -  -  -    -     -          - -       -  -       - - -        --         ---    -
-      -   -   -  -      -  -     -    -  -   -  - -  -----   -    - - - --     - -  - - - --      -
-   - -  ---  - -   - --  - - - -   -  ---  - -- -   -  -  --  - -    -      -    -            --  -
-       - -   - - -          --       -     - - -  -    -   -  --     -    -    -      -  --    -  -
----------------------------------------------------------------------------------------------------
