100
100
----------------------------------------------------------------------------------------------------
-      ---  -        -  -      - -     -       - - -   -  - -  -  -        -     - -     ---  -  - -
----  -      -     -        -     -   -- -              ---      -  - -   - ---  - -    -   - -    -
-----  -- - -  --    -   -    - -  - -   - -      -  -  -  -     ---    - --  -   - - - -  -   -   -
---      --               -      - -  -  -  -  --  --       -- -    -    --- -     -  - - - -  --- -
-      -- -- -- - --  -    -   -   -      --        ----- --     -    -- -       -    --    --     -
----  - -   ----  -           --     -    - -- --  -        -   -   -      --   - -  -  ----  -   --
-    --           -   -          - -    - - -   -   --      -      --        -  ---    -   - --    -
-  -   - - - - -   -     -   -- --- -    - -  -   ---  -    -       -     --  -  - --  -       --  -
-   --      --   -- -  -   -  -   -   --- --        ----    - --  --     -            -- -- --   - -
- - - -   - -   -   --- -  -    - -      -  -  --        - --   -  -  - - --            -- --  -   -
-  -   - - - -       -    -      - -   -- -  -    -    -  - - --  ---   - -  -      - - - -- - -- --
-   --  ---      - -   --  --             -   - --         -    --    -         -        -  - -- - -
- -   -  -  --     -  -       -   -- -  -- -  -  -     -- -  -   -   -   -  -   -   - -    -   - - -
-  - - - -     - ----- -- --  - -    -- -        -  --  - -  - - ----       --         - -   -- -  -
-  -     -    - -     -       -   -    -   -   --  --   -     - -    -  -    -    - -    - -    -  -
--  --- - - - -  -- - -        --       -    --   -   -- -- -  -  -   -      - -     -      -   -- -
-  -    -  - -- -        -  --         - -- - -  - --      -      -  --   --- -  - --      - -    --
- -   -  -       - --  --- ---  -        -    --   --  --   ---       -     - -      ---- -   -    -
-      -- --  --  -   -          -  - -    -  -  -         -    -  - -    -              - -    -  -
-   -     -- -        --     --           -      - -     -    -     -  - --    - -     -  -  - - - -
-  -- -- -               -         -  - -   -  -    -    --    -- - - -  - -  - - - - -  ----    - -
---       -- - -        --    - -       -    - -   ---   ---- -   - -----   -- -   -- -- -   -    --
- - -  - --  -   --- -- --    -- -    -     -     -   -    - -       -  --      - -- -        -    -
- -   -   -                   -- --   - - - - -  -- - - -   - --   -- -- -   ----   - -----   -  - -
-- ---   -   -- --- ----  -         -      -       -  --        -    -     --   - -     - -   -- - -
-          -         -  --          - - -   -- --  -   --   --  --  -  -     --- --- - --   -     --
-   --  -   -    -    ---      --   -   -        -   -  - - -- - - -     -    -  - -  -  -    -    -
-        --    -         --       -  -    -- - - -  -  -   ----      --  - --      -   -     -    --
-   -      -            - -   - ---  -   --    --   --  --         --  -  -  - -----    -     ---  -
-      - -   -- - --        -- --    -  -   - - -  -    -   -- -    - -          - -  -   -  -   - -
-     -  -      -     ---   -    - -  -- - -     -  - - -      -         --   - -  -    --  -  -   -
- - -- - -- --  - - -   --   --  -   -  -  -  --     -   -  - -     - --   - -- - -           -  - -
- --   -  -   -  -   -  - - -- -   -     - -   -   -  -    -  -    -     -  -  - --        -    -  -
-    --- -     - -- ----    -  -  --    ---     - -  --     -     -     -  -     -     - -  -    ---
--  -    --  -   -    -   --    --- -  -   -  - -     ----    - - ---       --      - - -      -- --
-  -    - --  -    - - -       -   -- - -   ---- -    -   - -----     - ----    -    -----  -    - -
-      --   - - - -  - - -    - -       -  -          -  -      --  -   - --- - ---    -   -    -  -
-       -  -- --     - -   ----- -  - -    --  - -  -     -- ---           --   - -  -   -  -   ----
-- --   - -  -   -  - -  - --  -    ---  -            --- -   -   -       -   -        -  - -   -- -
-     -        -  -  - - -  --  -     -       - -- --    -- --     -   --   - - -         - -      -
- -- -  - --       -  -        - -    --                  -  -       -- -   - -  - -    -  - ---   -
-     -  - -  -     -   ---    - - --    - - -  - - - --    --     -  -      -         - - -- -    -
-   - - -  - - -       -      -      --   -  -  -   --     - - --   -   ----      --    -  --    - -
- -- -- --      -  --  - -       - --    ---   - -  -   -      -           -   -     -       -   - -
-        ---   -     --  -        -  -  -  -   -  -     -    -    - - - --- --   --         -  - - -
-    - -         -     -   - -  -   - -- -        -   -  ---- -     -    --- -  -  - - --    --- - -
-   -      -- -  -  -   --   -   -    -  -            -   -  - --     -        -  -  -   -- -      -
- -     -    -  - - - -   --   -    --   --      -     -   --- - - -  -- - -       -  ---          -
- - - --          - - ----   -   -     - - -  -       - -       --  -   -   - ---         -    - - -
--      -   -  - - - -    -     --  - -  --       -  -      - ---- - --  -  -  -    ---   -   -  - -
-    ---  --- -  -   -- --   -- -      -     -- - -   - - -  --   -         - ---  -     -   -     -
-  - --  - -  -  -    - -  -  - -  -  -  --- - ---   -    -- - -  --      -- -      - -   -  ---  --
---    --  -- --   - -   - -   --  - --     - -     -     --  -         - --    -       -        ---
-  - --        -  --     ---  -  -   -         -         -   ---  --- -       -  -    -    - --    -
-   - -    -- - -         -    -       -  -    - - --      -  ----   -  ---  -   -   -   -  --     -
-  - -  -    - -   -- ---     - -  --   - -     --   -  -  --  -      ----  - --   --     -     -  -
- - -   -     -   -       ---   -       -   -      - - -   -- -- -     - -  -  -     -      -  -   -
-  -         -     - --   -        -  - -   -- - -  -- - -    - ----   -         - - ---   -   - ---
-   --     -       ---      - - -    --  - -  --      --  --     -   -      - - - ---         - -  -
-  -      -  --      - - --    - ---    -  --   - - -   - -    --  -    - -- - -    -    -- - - -  -
-      --   -    - - - - - - -     - -- - -    -   - -      - --      -     - -            --      -
-   -   --- -   -     -      - - -         --- -  -     -  -   --   - -  ----- -   -           --- -
--       - - -  --- --    - --  -   ---        -     -  -   ---  - - --           -   - - -     -- -
-       ----    - -  - --   - -  - -  --      - --      - -               - --   -- - -       -    -
-  -   -     --                     - - ---  -        -   -       -  --  -  - -  -     - -    -    -
- -    --    -- --  --     -            -  -- - -- -  -     --- -       -   - -  -- -- ---  - ------
--      - -     --    --    -    - -   -  --  --     -- - -  -   -  -       -   -          -       -
- - -    -   -   -- -    -  -   -     - -                 -    -  -- -  -    -  -  -   --  -  -- ---
--       - -        -- - - --     - -    -   -  -  --  - ---     -    -    - --     -      -   -   -
- --    --      - -  -   ----   - -  --  -  -     -     -  ---    - - -     -- -   - --   -- -- - --
-       --  -- - -  - -  - - - -   -      -  --    - -     -    -     -    -     -  --  -   -   -  -
--   -  -  -   -     -    -  -- --   --     -  - -     -   - - - -   -- --    -- - - --     --   - -
--    -  -  -- -  -   -- - -    --        -       -- - -      --- - -        -- -- -      -   ---  -
-        -  -     -  -      -   -  - -- - -       -      --  -   -    -    -   -     -  -  -    -- -
-    --  -  -     -  --           -      -  --    -  -   -    ---     -    -   -- -              - -
-  -   - -- - -  -   -  ---     - -        -      - -  --  -    - - ---  -   - - -                 -
- - -- -   -  -- --            -  --       --  --      -  -  -    --      -      - --       -  -- --
-     - -  -   -           -  --       -  - -  -       - -        - -  --   --       - -  -   -- - -
- -  --- -- -- - -  -  -         -     -   -     -   - -   -  --   -    --    -     ---  -       - -
- --    -    - - -  ---  -  -- --         -- - - -     --   -   -- --  - --    -       --  - - --  -
-    -   -         -  -    -  -   -   - --  -         - -    -       -     -   - -  --  ---     -  -
- ---  -   - - -   -  ---         - --  - -- -        - -        -     -    - - -    - -           -
- - -       - -        -       -  --   - -  -           -   - -- - - - - -     - --     --- --  -  -
-     -         -   -      -  --    -- -   ---    -     -    -   --  -   -   - -   ---    -   -   --
-   -     --   -  - -  -    -  -       -   --- -  -   -  -  - -     - -- ---  -  -       -- --  -  -
-      --  -  --- - - -  - -  -  - -     -  -       -     -       -   - - -      - - - -       --  -
--   --    - -  ----        -    -  - -       - - -     --         --  -  -- - -  -     -- - - --  -
-  -    - - - --   --- -   -      - - -    -    -    --   --    --             - -    --        - --
---    -  ----  - - - -       - -- -- -   --   -      - -   - -  -  -   -  -  - -   -- -  -- - -   -
-   --  -   - -  ---   - --   -    -  -   -- - -- -  -   -  --     ---   -  -  - -    - -  -     - -
--         -      --    --     ----   - --     -- --   ---   - --        - -  -     --          -- -
-   -  - - -     - - --         -   -    - - -             -    - - -          -   --    -- -   - --
--   --      - -   ---      -- - -   -     - - - -    --    -      --      -  - -- -  --   -       -
- --       -    --   -     -    --  -  --     -        - --  -  --  -          -     -  -  -      --
---  - - - - - -  - -    --     - - - -        -      -           --         -    ---  -    -  -  --
- - -   -     -      -      - ---    - -    -     -    -     -     -- - - -   --         -- --    --
-       --- -  -     -- - --        - --   ---           - -   -- - --- --       - -  -  ---  - -  -
-   -- --  -     -  -    -     - - --    -     - -               - -       -      -  -     -     - -
----------------------------------------------------------------------------------------------------
