100
100
----------------------------------------------------------------------------------------------------
-  -  - -     -      -           -      -   - -   -   - --   -   - -    - - -  -   - -       -  -- -
--  -  -   ---  -     --  - -- --      - --  ---      -          -        - -   --  -       -  -   -
-       -        - -  -    - -   --    - -      -  -     -  -   -   -  --    - -    - -     - -  - -
--   -    -  -- -   --  --  -      -  -   -   -- - -      ---  -    - -       - ---   - --  ---    -
-          - -         --  - - -  -   - -  - -  -  - ---     -   -- - ----  -    -  -- -   -       -
--     -    -  -  ---   -  --- - - - -- - -   -     -    -- - -  -    --       - -    -    -- - - --
-   -   - -          - --   --       - -    -   ----- -    -  -       -  - -- - -     - - -  ---   -
- --    - - - - -         -     -  --       -       -  -  -      - --- --  -  --  -- ---    -      -
-     -- -   -        ---   -     - ----- --     - --  - - -      -  - --  -               - - - - -
-  -  - -   -  -   -- -      - -   - -  -- -   -- -  -  - - -        - - --           - -  -- --  --
- --   --       - --- --  --     -  -  -     -  -  --- - -    ---       -  --     -      -     - - -
--   -    -  -       - -    -  - -  - -  --- --  --   - - ---      -    -  -- - - - - -     -   -- -
-        -       -   --   -   -     -    -        --  ---    - - -  --             ---         -   -
-- -   -    -   - - - - -  -  --   -      --  - -- --    -  --  -  --   -   ----  -        - ---   -
-     -  --      -- -  ---     - -  --    -  -   - --   -  -  -      - -      --     -   -   --  - -
-   -- -  -          -- -   - - - -       -           - - - -    - -   - -  -     -            - ---
- - --    -  --              ---       - -         -   --  - ---     -- -   -   --     - -   -  -  -
-     --  -  ------  -    -   - -   -  - - ---  - ---- - ---  - - --  -    ---   - -  -   -       --
-     --   -   -   -        --  - --       ---  -     -  -       -  ---  -        -   -    - ----  -
-- -            - ------- --  -     --  -     -- -     --- --    - -    -   ---- -     - - -   - - -
- ----- - -    -    -   -- -- -   --   -  -  - -  ---   --       -    ---      - -  -    -  -      -
- --- - - --      --  - --      ---  - - -    - - -   -- -      -   -  -  -   - -  -      --    - --
-  - - - --    -   -   -    ----    - --  - --       --   -   - -       -     -           -   - - --
-      - -- -    -    -  - -  -   - - -   --       -   --    -   --- --    -- -     - --  -        -
-  -   -      --- -  - - -  --  -----     - - -  - - --    -- - -  --  --   -   - - --  -    - -   -
---  --     -  - -  -   - --   - -          -  -    -    - -  --          -      -    - - - - -    -
-     -       -  - -       -       --   -        --- -- -      -  --   -- - -- -  -   --  -  ---   -
- -  -  -- -    - --  ---     -- -   ---  --         -   -  -  -             -   - - -             -
-        -- - ---- -      - --        -       - -           -  - - --   --   -    --  -  -   -- ----
-  -      -   -     -    -         --  -  -  - -- -    -  -   - --   -   --      - -    -   - -    -
- -  -  -     -     -  -- -  -         - --  -    -   -     -   -   ---    --        - -       -   -
- -     ---   - -   -   - -    -  - -   -  --    - ---         -   -  -  -    -- - - -        -    -
-   -  -  -          ---      -   -       -  - - -       -  -   --     -- - -   - -  -   - - -   - -
--   -  -- - -  --   -  -       -  -  -    -       --   - -   -          --     -  -   -  -   --   -
-  - -     -     -         -- --  - -  - -  -    - - -- -   -  -                   - -  -- --   -  -
-        --  -- -   -      -     --    -   --  - -  -         ---   -  -     -- -    --  -   -    --
-  -- - -       -       - -      -    -    -      -   ---       ---  -  -                 -   - - --
- --- -      - - - - --  -     -     -  -  ----      -      -  -       - -- - -        -- -    -   -
- ----- --  -- -      -  -    - -  -  -   --  -  -  --    -   -   -- - --       --  -   - -  -  -  -
-   - -      -  ----  -    - -   -  -    -         -    - -    -   - -       -  -   ---- --- -     -
-       --   - - -        -   -      - -       -   --        --- - - -        -   - -  ----    - - -
-- - -  -   - - -    - -   -      ---  - ---          -- - --       -  -  -     - -   -    - --    -
-    - -  - -   ----     - -  -      -          -          -  --     -  -     ---- --  -        -- -
- -   - ---   -  -   -     -   -         -     -  - -   -  -     -  - ---  - - - -      ---   -    -
-- -  -  -   - -  - -     --  ---   - - -     - -             -             --        -- - - -     -
-- - -  -      -   --- -- - -     -    -   --   -  --     - -    -    -  --  -- - - -    -   - -  --
-         -   -    -   -    -  -   - - -        -  -  - - -  -     --     ---   -    -          - --
-    - -   -  -  -    --  - -  -    -  -         -  -      - -   -     -    --   - -      -    - - -
-  - -   -           -   --  -       -- - --- - - -  -   --- ---          -  ----  - - -    - -    -
-    - -    - -- -     - ----- -  -   -  -   - -  - -            -- -   - - - --  - -   -        - -
- -- -  -    -  -  - -- -   -  - - - -   --   -   -   ----    -   -  ---- -  -  -   - - -  - -   - -
-  -    - - --  - - - - --       --- ---  -  - -  - -             --    -      -    - -- -        --
-  -  - -   - --   ---    -   -     -        -         --    -  --- -  - -  --  --   - - -   ---  --
---   --              - --    --  -- --  -     - -- -         -    -     -      - -   -  -  --     -
-   -- -  -    -    -  -            -   -   --      ---     - -  -    -   -  -- - - -   -        - -
- - - -  -   -    -- -       -- -  --  - - -- -   - -  -        -   -    - --- - -      - --   - - -
---    -   -    - -     -  -    --  - -- -  - -   -  -   ----   - -  --  -  -   -  -- -    - - --- -
--   --     -       - -  --- - - --- -  - -        -         - --        -         --   -  -       -
--  -  --    -----          --         -  -     --- - - -- -      - --         -- -  ---   -- --  --
--  - -   - -  - - --    --    -  -- --  -    -  -  --    - -- -  -      --- - ---              -  -
--         -        -   -   --              -- - -     -    -- - - - - -       -         - -   -  --
--  -            -  - --- -       --            --   - -     --  -   -   - --                --   --
--   --   -   - -  -       --    -      -    --       -    -  -    --- -        - - ---  - -     ---
---     --   -    --     --   -     - -         -   -    - -    -  -  -  - -   - -  -  -  -   --  --
-  -    -      --    -  - -- -       -    -- -   - - -       -  -   -   --    - -  -  -- --      ---
--         -  - -- -     -      -    -- --  -   -    -         --        -  -- - -  --       - -  --
-       -   ---  -    -        -- - - - - -- --    - --- -   -  - -    - -       --    - - -      --
--   -   -     - - - -   - ---   -           --- -    - --      -  -         -    -  -    -  ---   -
- -          -    --   - - -  - - --       - - - -  - -       -   - --      -  --    -     -       -
-  - -  --  -   --      - --             - -     -  - -  - - - - -  -  -    -   - -    - -  - -  ---
---   -   - --     -  - -         ---- - ----- -    -    - -- -  --      -    - - -- -  ---- - - ---
--     -  -       --   -                    - -  - ---          --  - -  -   -        -    - -     -
--       --      -  -  --   -    - ---  -    --   -     --  ---   -   -   - -- -- -   -            -
-        - - - -  - -     - -                    - -  -      - -   -  - -      -  - --  - --    -- -
- --    -      - -  - - -   -        ---     -       -       -     -      -      -   -   -     -   -
-        -    - -    -   - -   -   --      --  - -  - --          --- --  -     -- --           - --
-    -     -- -   --   --      --   - - - - - -  -   - --  -- -  - --- - --  ---             -   - -
- --  --     -    -  - - - - -     --    --   --  --      -- - - -- -  - -     - -   --   -    -  --
--     - - --    --      - -      ----- -   - -      -  -   -- - ---  - -   --  --      -  - - -   -
--       - --   -        --     - -  -- -     - --  -     --  -         --- -     - --   -  - -    -
-    -       - -  --  ---- - ---                --   -  - - -  --  --       -    -  -    --     -- -
--      -   -           -        -  -   -     - - -   -    -   --        -  -  -  - -    -  - -    -
-  --   -     - - -  -     -  --- -   --  -  - --   -  -  -  - -  -     -- -   - - --  --         --
--       -  - -    -   -        -- - - -          -   -   -   - -    - -  -  -    - - -            -
-      -- - -     - -- -  --   -   - -      --  -- - --      --  -  -          -         --    - - -
-     - - --     -   -   -   -     ----  -- --      --   - --       - -  -   --       -            -
- -   -   - --   -               - - - ---      -   -  -          - -- --  -         - ---         -
- --      - -  --       - -   -- - -- -   - -  -   -  -    --  -  -   -      -    -    -    -  --- -
-  -   --- -  -  -   --         - -    - -  - - ------  -    --   -  - - -- - -       -  -    -   --
- - --   -   - - -    -  - - -   -    -  -- -     -   -     - -   -  -  -    -  ---- - -  - -  --  -
-  -   --   -  -  -- -   --  -    -  -   -  -  -    -      -  -   -    -      --  -  --   - -   -- -
-        ---       - - -    -    -   -  -  -- --  -    ---    - - -- -  -   -    -  --  -- -   --  -
-  -   - -  --  --       -  ---   - - -   -    - -  -          - ---   -   -  --- -     -  --      -
--   -    --    -   -    - -   --      -  -   --      -  -    -- - -  -     -     -  -     -  -- - -
- -      -     -   -  -  --  - - ----   -    -  - -   - -   -   -   -          - -    -      -------
-  - ----  -  -    - -   -  ---    - ---    -- --     - - -   - -     -    - - -  -       - --------
- - --    -          - - - - -  ---   - -     -  -     -  ----     -  -       -- -                 -
-   - -    --- - - - --       -     - - -- - - -              -                      -  -    ----- -
----------------------------------------------------------------------------------------------------
