100
100
----------------------------------------------------------------------------------------------------
-   -         -        --    -       -  - - -   -     -             -    - -  -         -  -       -
---   --  -       ----   - -    -- -    - -   - - -      -     - --      - --   ---   --  -   -   --
--  - -  - -  -     - ----- -     -- - - -- -   -     -             --   --      -  -  -  -  ----- -
-  -     --  --  --  - -     -  --   - --           -     - - -         -  --- -   --  -    -    - -
-      --  - - -- -     --      ----     -     - -   -  -  - --   - ---    --   -     --  --  -  - -
- -  -       -       ---  --   -       -   ------ - --    -   -    --      -  --    -      -   - - -
--      -  -  - - -- -   -     -- --  - - -  --    --  - --   - -    -  - - --  -    - - --     -  -
-  -    - - -  -      --   --   --    --    -   - -  -       -  -     - --    --- -   -- -- -  -   -
--    --   - -   - -      -   -     -  -  - -- -  -- -- --   -- -          -        --  -  - -    --
-    -               -  - - -    -  - -  - -    ---  -  -      - -      -     -   --    ---    -- --
-- -  - -- --  -  -     ----   --  - -  - -  - -    -   -- -   -          ---  - -  -  ---       - -
-     -    -   -  - ---     -           - -  --       -       -- -   - - -  -     --- -  - - -     -
- -  -     -  - ---    -- - - -  - - --  -     -     -- -    - --      - ---- - -    - ---  - - -  -
- --      -         - - --  -  -     - - -   --  ---      -  --   --    - - - -   - -   -   -      -
--   -     -  -  - -  --      -   ----     ---    -    -   -  - -      -   -         -        - -  -
-    -   --           -        -  - -   -- -        --   -  ---   - -  - -   - -   -   --- -       -
--          --         --- -   -          - -  -    - -  - -    ----           --   - -    -    -  -
- -   - -   --   - -  - -       -     -  -- -  -     - - -     --  - -    -    - -       --  --  ---
- - -  -- - -  - --       - -    -          -  - - --- --   --          - --      -- -         --- -
-   -   - - - -- -  ----    -     - - - --   -- --      - -   - -  - -- -  -      ---       - -    -
-  -  -  - -  -        -  -- - -   -     -  -   -    - -   --   - --  - - -      -         -- ---  -
-      - -  - - - -    -    -  -  -   - -   ---- --    -   -          --   -   -    -    -   -  - --
-  - --- -   -- - -    - - --      -  --       -  --      -  ---  --  - -   -   -     -  -        --
-  -  -   -        -- -  -    - - ---   -  -  - -  -      -     -       - -- -     --  -    --    --
-    --  -    --     -  -    -       - ---      -    -- -  -   - -   - -   -  --  - - --     - -  --
-  -  -         -  --      -            - - --  --- -  -  -          -   --   -   -- - - -      - --
-  - ---     --   - - -    - - ---- -- - - -   - --  ---  -      - --   -   -     -  - -      --   -
-  -   - -    -    -  -- -  -   -   -  -        -  - ---    --       -  -     - ---     - -   --   -
--   -  -      -  -   -    --  -    - -    -   --- -  -   ----  --   -    ----  -      - - - -  -  -
- --  -       -       -   -       -            --      --      ---  - ----       -  --  - -    - - -
-  -               -   - ---   -  - -  -  --  --    -     - --   -   - -   --   -  -     --- -  -  -
----     --- -   -   --      -  -   -    - --  -- - - --  -    --     - ---  -   - -       -     ---
- - - -   -        -   - --   --  -  -  -  --     -            - -     -       -      -   - --     -
- -- -  --      - - -    -  - -                       - - -         - -- - -   --  -     -       - -
-    -    - -   --        - -  ---   -- -  ---  -  -- - -    -  -- -        -  - -   - -  --       -
- -  -        - -- -       -- -  -     -      -   -      - --   -  -      --  -  - -  -  - -       -
-       -      -    -       - -- - -   -  - - - --  -- -   - -     - - - -  --  -   -- -    -- -  --
--        - --   -          - --      - -  -   -    --        - --     -  - --     -      -   -- - -
- -  -    --    - -     -  -     -       -      -   -   -    - - -    -       - - - -          - - -
-  -    -  -        -- - -   -- -  --  -     --    -   - --     --  -  - -  -  - --- -     -- -   --
-   -    - -- - -  - -     - -  ---      -- -    -- -   -  --   -  -- -     - --     -    - -   - --
-    -  -   --     -  -      - -        ---       -- -- --    -       - - -- - - -- -- -     --- - -
-  --  - --             ---    ---     -   - --  - -  --  - -   -     -  - - - --  -  -   -  -     -
-  - - ---  -   - -  -  -         ---- - -  - -  --          ------  --- -    -    -  -    -  -  - -
--- -       -              --  -    --   -   - -       -      -   --  -     --- - - --  -      -   -
-       -  - - -      --  -     - -        -                     -       -     -  --- -  -   --  - -
--  - -- -    - - --     --   -  --  - --      --         -   --   -       --  -     -   -   - -   -
--  --   - -  -   --  -      -   -    -- -  -    -- - --    -   -   -     - --      -- --     - -  -
--       -        -  ---- -    - --- -  ---             --  - -       --   -  -   -         - -    -
-   --- - -   -         -  - -  -   -       -   ----  -   -       -  - - -    -- -     -  -   -  - -
-  -  --   -- -  - -  -- - --      -  - -  --     -           --   -  - -     -- -  - -     -      -
-  --  - -     -     - -  -   -     - -     -     - - --   --     -     -   -           - -  - -- --
- --  -  - -     - --  - --     ------   ---  --- -  --   -    ---  -    ----    -- -      - -  -  -
- --    -  -   -  -  -  -     -        -  -  -  -     - -     --   -   -              -  -        --
---     - -        - ----   -  -    -- -  -   - - -    - - - -  -      -   --   ---       -- -   - -
-     -  --  -  --       --  -   --   ---         -    -       --   ---     ----    -   --    - -  -
--     -   -    -    -   -   -    -   -  -- -   -   -     -   -   --  --- -      -   - - -  -- -   -
- -- -       -- -    - -   - -       - - -     - -- - -     - --           -- -  - - -  - -   --   -
-    - - - - -  - -   --- -     -        - -  - -   - -     -    --             -- -  -    -    - --
-  - - - --  - - -  -       - -   ----                 -       -   ---  ---  -   ----    - - -- -  -
--     -            -- ---    - -      -   - - -   ----  -   -     -  -   -   - -  -  ---    - - - -
- - --  - - - - -       -   --  -  -    -  -    -- --       -   -  ---  -   -  ---   --   - --     -
-----    - --   --- -- - --   - -     - -  -     -  - - - ---  - -     -  -    -     -- -          -
- -     -    -    -   -    - -  - -     - --    -   -    -   ---     -   - -           -   -       -
- -  - -   - - ---   - -  - - -   -  -        -   --      -   -    - -- - -     --- -    -- -  - - -
--  --      -   -        --       -        -     -   -     ---      -  - - -    -      - -      -  -
- -   - - --   ---  - - -  -  - -      -    ---   - -        -- -            --  - -- --  - -- -  --
- -       - --    -    -  -                 -   ---   -          -  --  -  --  - -  -        - --- -
-- --   ----- - -        - -    - --- - - -  -     -    -    - -   -      - -     -  -  - ---  --- -
-- - -- - --  --  -         -      -   -- --            --     --  --    -              -  -   -----
- --    -   -   --    - --  -     -- -  -    - ---  -  -  - -      -   -- --     -   - -     --    -
-   ---      - -    -- -   -       -    -- --   -- - - - -                  - -  -   - - -       ---
-             - - -- --         --- - - -     --  -  ---- -----   --    -      --      -- -   -  - -
-    --  -      - -- ---         - - -- - -   - - - --    -       -       -  --   -    -   -       -
-- -   -        --    --  --  ----     - -   -    -             -  -     -  -   -     - - -        -
- - -     - -      --  -          - -   -  -  --- ---    - -  -            --           --   - -   -
- -         -    -  - - -   - -  ----  ---  --  --     - -     -  -    -      -  -     - -  - -    -
-   -  - -         -    -- -              --  - -  -  -  -  -- -   - -  -  -- -    -  -     - - -  -
-   -  --       -   - - -    -         - - ---         --          -  - -  - - ----     -  -       -
-  --   -  -  --    -     - -    -- - - -         -- -    -- - - - -           --       - -    --  -
-- -   - --        -   -      -        -  -  - -   -  ---   -     -  -- - -- - - -         --    - -
-           ---     -           - --        --  -     -    - -  - - - --    -    -  -  -- -  -    --
-- --- -   -- -  -- - --- --    --    -  --  -    - -    -   -     - -   --  -    -       -    -   -
-          - -   -    - - -        --   - -----       -- -          -  --   -  -     -  -- - -   - -
-  -       - - -- - -  - -  --  ----   --       - - - --   -     - -     -  -    --    - - -  --   -
- -          -    -    -   -- - --         --  --  -     -  -    -  --  -  ------ ---       - - -  -
- -       --    --  ----  - -     ----- - -   -  --- -   --   -      -    --      -       -    -- --
- -   -     -             -- -  ---  -   - -      --    -  -    -       - -- -     ---  -      -   -
-       -  -    --   - --  -     -    -     -  -  -    -  - - --    -   - -     -    -  --- --   - -
- - --     -   --- - -      -       -   - -   -    -  - - -      -   -   -- ---     - -    -  -- - -
-    --- - -      -  -- -- -  -  - -- --         - -   -  --  - --       --       -- --    --   - --
-       - - --            -  -    -  - - -    --  -     ---   - -    - --  - --  --  -  -          -
-   - -   -       - -    -             - - --- - ---  --  -  -  --  -     -     -   -    --   -    -
-      --     --    -  -  -        -  - -      -      -    - --- -  -      - --  -  -    - -    -- -
-    -       -     --   -  -   -----     -    -  --   - - - -   --- -           -    --      ---  --
-      --   -             - -       ---   --    -  -  - - -   --  -- -- -- - -  -            - - - -
- -- ---     --  -  -     -    - --  -  -      --- -  -- -      --      -  - -    - --- --    - - --
-                           --  -        - --      - -    -        -  -   - --           -   -  -- -
----------------------------------------------------------------------------------------------------
