100
100
----------------------------------------------------------------------------------------------------
-              --   - -   -  - --  --  - -  -  -         -  -  -       --   ---- -     -   --      -
- ---   -- -            -  -    -      --    -   ---   --    -  - -  --   -  - -         - -  -   --
-  -       --     - - - -     --     -     -  - - - -  -   -       - ---   -    -  -- --   -- - -  -
-    -      - -  - - - --   -   -   -  - -      -    -   -- - -     -    -     -   - -- --  -    ---
-   - -         -   - -  -   - -        - -   - -- -     -   ---  -   --  -  -   -  --  - -  -    --
-       -      -    - ---   -     -   -   -  -- -  -  -      --   -   -  --   -  --- - - -    - -- -
-   --  - - -    -  -   -- -  -     - -    -- - --   -      - -        --     -    -  -     -  - ---
-        -   -- -   ---  - - - --  -         - -  - -   -   -   --  - - -              -    --  -  -
-   ---  ---  - --  -  -  -      -  -          -- - -        - -  --  -  -   --- -   -    -     -  -
-  -  -- ---- --  -- -      -     -      - -  --       -  --- --      --    -  --             - - --
- - --    --   -- -  - --  -- -  -  -         -- -      - -   -     ---  -   - - - --   ---   -    -
-  - - - -     --  - -          -- -    --       - - -     - -         -- -   - -  - --- -   --   --
- -  --     -         --       -          -  --  - -- - - -  -    -- - -    -   --    ---        - -
- -    -         -   --  --   - -  --  -          -   -  --      -  --  - -  - -  -- --  -  - - - --
-    -  --       -  - --  --       - --       ----          -- - -   -        -   ---  -   -       -
--    -     -  - - - -   -     - - -   -- -    --- --      -  - -  -- -- -- - -      ---   - -- -- -
-- - -       -         -  - -  -       -   -  -   -   -    -   -    -  -   -   -  - --   - - --- - -
- -     --    --  -             -         --    --  - --    -- - --  -    ----- --     - -- -   -  -
---  -    -   -  -  --              -   -    -       -         -      --          -   -      -- -- -
-  - - -    -     -         -     -     -- - -  - -      - -- -     -     -   -   --     -       - -
- -       - -     -  -   -  - -  -- -   - --  - -      ---   --  -  -- --    - - - - - -   -- -- - -
-- ---  -       --- -- -- -    - - -  -         -     -- - -   - -   -    - -- -- -  - -       - - -
----  -  -  - -     -      - -- -- - -     -     -- - -    -   -     -    -    -- -   -  -       - -
--   - -    - -      -  - ---     - -- --- ---     - -  ----    -    --      -- -  -  -     - -    -
-      - -  -   -   -        - - --  - ---     -  --- - -     - - -  - - --   -    -     --- -  -- -
- -     -    -         -   --    - - - - --      -        -   - - -  --        --            -     -
-   -  - --  -- ---   -   -   --      -     -- --    - --  -- -- - -    --      -- - -- - -     ----
-  --   --  - --  - -  ---  -  - - --   - --   - - -       -          ---  -   -  -     -  -- -    -
-    - -      -     -      - -   -          ---  -  -  -     -   - -- -- --  -- - -   --  -   -- - -
-   -     - - -   - -- -  - - -  -  --   ---   -- -     -    - -    -       -- -     -    - -  - ---
---  -  --        -     --- - - -   -     -- - -     - -- -      -  - - -- -     -- - -- -  -  - - -
-  -  -  -  -       ---   -    - -- - - -- -    - - -   -        ---     -  -         -   --    -  -
-- -   - - -                     --  -           - -       - -   - -       -        -- ----        -
--   -  - --   -       - --       - -- - -           -- - -           - - --    -- --    -  -   -  -
-  -  -- -     -   - - --  ----  --     -- -      - -  -  -           -  -     -    -   -- -  -    -
-   --   -  - -   --  --        -       - --  - --     - - - -   -            - ---    -  -      ---
--     ---    -  - -        -- -  - -  - -   -      -    -   - ---       -   -     -    --  -      -
- -  -  -- -    --  -  -  -  - - -- -- - -  --    -   -     -   --     -   - - --  -          - -- -
- ----    -    --  -   --       -          -- -    --   -        - -  - --      -         -      - -
-- -    - --      -        --     --- - -      ----    -  - -    - --      -  -  -     -    ---  - -
-            -   -  -  - -        -  -     --- -         -- --- - -   --     -       - -  -- -     -
- -   - -         -- -   -  -         --     ----  -  -    --    -- --   -       - - -   -- - -   --
-   -- - --   -  -   - -- -- -   -   -- --  - - - -  - -        -   - -   -  -        --  - -  -- --
-  -         - -- ---   --              - --      - --     -   --    -   -   --    -        -   - --
---  -        -   - -       -    -       -- ----  -  --      - - - -   -   -       -  ---   -   -  -
-     - - -  -  -- --            -     -- ---  - - -   ---    - -  -  -  - ---    - -    -   - -   -
-  -  -  -  - -   - -  -- - -----  - ---    -    -     -  - -  -     -- -      -     --   -  - --  -
-    - - -    -  --   --      -      -   -     - -         --   ---  -   - --- -   -     -      -  -
---     ---        - -   -   --     - --   -  -   -       -      - -  --  -    -             -     -
--      -   -  -- --   - -          - -  -- -  -      --  -  - -   - -  ----  -                    -
-  --   -  - -      - -   -- - - -- - -    --  -- -       - -  -      --- -        -   - - -- --   -
--         - --  --   --    - -     -       -    -       - -    --  -    --   - -      -    -- --  -
- -  -     -         -   -        -  -  -       -----       --      --      -        -   --  -     -
-   -   -      -      - - -  -    --    --  -        - --- -     --     -  -  --   - -        - ----
-- - -- - -   --    - -     -  --   - -                     - - - -----   -  -   -  - -   --       -
-   -  --  -   -  - -   --       -      - -- --     ---   -  -   -  - - -  -  -- ----    -         -
-  --  -  -  ----             --   - ---- -   - -       -     -       -   - -- -   --  -          --
-- --    -        -  -  - --     -     --   - - - --   -          -  - -  --   -          ---- -   -
-    --    - ----  -         -- --  - -    -   -  -- -  -  -    -  --        -- - -     --     - - -
- -          -   - -   -   -    - --   -  -  - --     --     -   -- -    -       -  -   -   --    --
-  -- - -  -   -  -- -   -  -               - - ---    -  -   -   -   -   - - -    -   - -   --    -
-   -  - -  --    - -  --- - -- -   - -   -    -  --   - ---  - -    - ---  - --      --    -    - -
-   --  -  - - - - -              -      - -    -  --     -- - --    -     - --     -   - - -  -   -
-  -  -   -  -  -  --    -  - --  -  --   - -- -  --    -- - -   -     - -  - ---   - -        -   -
-       - -   -        -        -      --      ---  - --   -         --  ----       - -     - - -- -
-    -- --  --  - -    - - -- -  --  -    -  - -       -      -   - -   -  -     - -   -   - -     -
-   -  -  - --   -     -  ---   - -     ---   -  ---      - -       - -   -  -   -     --          -
--   - -    -- --- -- -     -  - --   -      ---   -  --- -   --  -   -     - --      -  --- --   --
-           -    ---          -    -  -  ---  - -     -   -        -- - -     - --         --  --  -
-    -    -- -- -   - - -     - --- -- -   -        - -    -     -   -  --- -- -        -          -
--     -   - -    -  -    --         -  -        -- -    --  - - -   --     -  -  --   --  -  - -- -
-  -    -- - ---        -      - - - - --   -- -        - -       - -  ---         -  -  -        --
- -   -    -  -     -    - -  -   -----  -         - --             -   - -        - --   - -  -   -
-   - --   -  -        --  -  -            -- -    -   -   -   -- -    -  -   --  -  - -    -      -
-   -        -   - - - - -    --- -    - - -    - - - - -   -              -        -  -     -  -  -
-       - -       --  - -     -    --  -       -        --  -    - -   -   - - --      - -       - -
- - ---   ------    -       -  -      -  -  -     - - - -     -   --    -  - -- --     - --        -
- --     -   -  - -  -- -    --   --     --  ---  -  - -  -- -- -     - -   --    --        - ---- -
-    -- - -    --   -  --- - - - -    -    -     - -   -    --  --   -         --    -    -  - -  --
- --    -- -   - --- --- - -   -    -- - -    - -  -   -- -       -        -  --  -  -   -  -      -
-  -       ---      - - -  --- --       -  --  -      -   -  -      --          - -       --    - --
- -- -   -    -  --- - -    - -    -     -       -  --- - - --     -   - --   -     - - --  -  -- --
- -        - -    -           - -  -     -  - - -        -   -     -  -    --- -- -        --    - -
- - -    - --  -    -- -            ----      - - - -  -   -      -  -    ---       -  -  --  ---  -
-   -       -- - - - -   - -      - -    -- - -- - - -- - - --      -         --         -  ---  - -
-  -     ---- -    -  --               - - --  - -       -     --  -    -  - -   -- - -----        -
- -  -   -     - -  -     --  - - -    -     --   -  - - - -  -    - - -     - -  -  --   -  - -   -
-- - -     ---  -  -  - --   -    -   - - -- --     -  - --    --   -   - -- -  -   -    -  -- -   -
-    - ---  -    --  -     - --  -             - --  -- -   - --            - -           -- - -   -
---        -  --        -     ---  -  - - -   -     -   - -      -- -                    - - - -   -
-  --- --   -     - -            -  - -      - - -- -- - - -- -- --       - -   ---    -      -    -
--      -     --   -   - -  -  -   -        ---- - - - -  -       - --    - --   --  -   - -      --
-  -  -       -  - -  -    -    -- -  -   -  --  - - -    - -  --  - --       --     - - -  -    - -
-  -       --    -         -  --   -  - -  -                   - -  -  --  --  -----       -    -  -
- - - - - --   -      - -- -  -- -  -   -   -  - -  -  --         --  -            -    -  - -  -- -
-- -- -         --    -    - -   - -   -  -    -- -   -   - -       - - -       ----   --    - --  -
-       - -     - -    -  - -      - -  -  - -     --  -     - ----  --  -  -    -   -    -  -  - --
-            -- -   --      -   -  - --   -     -    -       --     -     -   - - --  -        - - -
----------------------------------------------------------------------------------------------------
