100
100
----------------------------------------------------------------------------------------------------
-  -     -  --- -     --        --           -  -      --          -   -  - -  -      -  - --  -   -
-    --    -   -  -----    ---    ---  - -- - --  -  -   --  -      -----   -     - -  -     --  - -
- - ---  - ---  --     -    -       -      - -       -  -     ---        - -   --     - --  -  --  -
-   --   -  -     --- -  -   -  ----     -  - -- - --  -  -  - - -- -   -   --     -   -    - -  ---
-- -  - -   -   - -        --    -       -   -        -    --       -  - -       --  --- --- -  -  -
-  -   ---- -    - -   - -   -  -  ---   - -    ---     - -- -   -     - -   ---         - -  -   --
- - --  --- -    -         -- -- -- --          -   --- - --   -   -  -       - -- -- --      -- - -
--   ----- -   --    --      -    -- -- --  - -   - -    - -  -    - - - -  -     - --  - - - -    -
--        -  -  - ----   ---  - -    -    --      --   -    -     -- -   -   --   -- -    --  -    -
--     - -  -- -    - - - -    -  -    ---   -    -     -  --- -    -   - -      -- -   -    -     -
- - - -   - -- -     -  -  --  -          -   -  -  -      - -    -  - --    -     - -- -  -   -   -
- -  -   -   -  --    --  -   -     -   ---       --        - - -        -       - -   --   - -   --
-   -  -     --  - - - - - -       -       -     --  --   -  - -    --  -   -        -   - -  --   -
-   -   --          - --- -  -      -- --  -       -    - - --       -  -   -   --   --    - ---   -
-    -  --   -         -    -  - --          --- --        -          -  - - -          -     -   --
--   -    --- -       --- -   ----   -   -- -   - - -  -  ----     ---- - -  - -  -   -    - -     -
-- - -  --        ---  - -     - ----   -  --       --        - ---  -    -  -- -   -  -   -  -   --
- -    -   -     -   -       -  -         -        --         -      - - --  -- - -- -    --       -
-  ---  --    - - --- -     -     ---    -   -   -   ---    - -   -   -  -               -- -- -   -
- - -- -  ---     -    -   - ---   - - -- -    -  -       -    --          -      - ----- -- --    -
- - -    -         -   -  - -  - -  - -      -   - -   ---- --   --   -- - -    - -  -    - -    - -
-  -      -        --        --      - - -      - -  --      - -   -      --    -        --    - - -
--   -   ----   -- -      -     -    - -  -     - -  - -        -        -         - -- -   - -   --
-- - - -  --- --  -- -   -   -- -  - --- -- -   -  -       -   - -      -  -   -          -    -   -
- - -  --    -  -  - -        -  --        -  -   -  --    -   - -- -            - -  - - -   -  ---
- -   -     -   -    - -- --   -   -         --   -      --   --     --  -    ----  -  --  -       -
- -   -- --      -     -- - - -  ---            -    -       -   -  - -   -       -  --     -  -   -
-     -  - -    -  -     -     - -- - -    ----     -   - - -  - --  -- --     - -   - -   -    -  -
-  -  -  --        -    -  -   - -  -- -     - - -- - --    - -  --   - - --  - ----  --  -   --   -
-  - - - - -   - --     -  ---     -  -  --  - -  -- - -  -        --       --       -     -     - -
-- -  -   - -    -   -        --                 -      -- -   --   -     --  - - --            - --
--   -  -       --  -  -  - -  -  -   -        -      -      -  -      - -  --   -     --      -   -
-     -   -     - --        - -  --   -  --    -- --   ---- - --           -     -     -  --   -  --
-    --     - -     -  --           -       -    -  -    -  -  -   - -     -  ---  -    -  -   -  --
-- -         -- --   -     -  ---    --  --- - -    ---   - -       -  -    -  --- --     -    -  --
-- ---   - --  - - - -    - --         -         -        - - - - -   --        -- -    -  -     - -
-  -  -  -  -- -      - ---    - -  --   - --   -      -----  -      -   -   -       -  - -- -   - -
-- -     -    -    -    -   -     -  -  -     -  -        - - -   -     -   -  - -      --  --- -  -
--  -       -   - -  --   -    -     - - -      - - -- -  -          -  -     -  -       - - -     -
-  --  -  - - ---- -        --  - -            - -  - - --  - - -      -    --   --    - --      - -
--  -    - -      - -     -   - - - -- --   ---      --  --   - --- ---        --  -     -     - - -
-- -     -  - - - ----  -      -- -  -  -   - -   - -     -   -    -    --  --         -  - -   -- -
- -        - -   -- -        - - --  --        -  ---            -    -      -  -        -   --   --
-  -- -     --- ---  ---     -  - -  ----  - -  -          -  --  - - --    -    - -  -   -    -   -
-   -   - - -  -- --   -    - - -   - -  --        -  --     - --   - -   -  -           -- -      -
-        -- ---   -   - - -  -   --     - --    - -        --    - -      ---  - --  --     --     -
- --    - --  -- -     -      -   - - -      - -- -  -    --     - -          ---   -       - --  --
-  -       -    - -  -  - --    - -         -- -    ---  -         -  --   --   --  ---   - -   -  -
-   - -    --      -  -- -  ---   -          -- ----  - - -    --   -    --  -  -         - -    - -
-  -         ----- --  -  - -     -    - --      -   - --  ---     -    - -      - --   -  -- - -- -
--   - -   --      -    -- - -- - - -- -       ---   -  -     -  -  -   --  -      -  -   -  - - - -
- -  -    -  - --    -   -     -  -   -- - - - -  --  -- -- -- --  --  -        ----- -   - - - -  -
-   -   -  -- -   --    ---     -   --     -      -   - -  -- -    - - - -   -  --  -      - -  -  -
-    -       -   - - -- -     - - - -  -      -- -   --          -  -     -        -   - -         -
- -  - -  ----    - -     - -- -  -     - -  --      -- ---  --    - --    -    --    -    - -     -
-   --         -    - -    -    -   -         - -  -      -           - -   - -----   -- -  - -   --
-    - - -  -- -   -       -  - ---- - ---      -    -            --               -      --      --
-     - -         --   -       -   -  - -  -  -  -    - -   --  - -----  --    ---          - --- --
-   -- - - -      -  -- - -- - ------          -     -    -  --            -       -  --   -     ---
- -  -           - -    --       --  - -    -      ---- -    --      --  -       -      - -  - -   -
- -    - - - -  -        ---  --       --   -           -       -  -  ---- -  - - --   -   -- -  ---
--    -  - -        -----      - ---- -   --           - - -- -   -- -  -   -  -  -  - ---  -  --  -
-  -   - --    ---  - - -  -   --  - -     - - - -   - -   -   -- --   -   --      - -  - - --    --
-   -        -                - - -        - -       --       - -  -      -    -     -       -  - --
-   - -----     -   -           -    - - -     -   -  -  - -         ---- ---    -      - -  -  - --
-      -  -  ---- -  -   ---  -    -  -    -     --- -  - -   -   -      -   - - -    --         - -
--     - -  - -     --   -     -      -        - - -         - - --     -     -  -      - -   - -  -
-   - - --   - -     --    ---  - - --  -- -    -  -    - -  - -  ----           - -         -   - -
- -     -- --  -   --     -- -   ----      -- -      -    - -     -     --- - - -  -  -    -   - - -
- -  -   - -        -       -     -  -        - --       -      --         - - - -  -   -- -  -  - -
-- --   - -   -        --  -  -  -      -  -- --      - --  - -- - -   - --   --  --  -    ---   - -
-  -        -  - - --  --   - --- - -- - -         -  --   - -- - -  -  - -- - --       --  - -- - -
-  -    --      -------   -     -     --- --   -   - -       --    - - - -     -        - ---    ---
-    -   - ---   -  -     - -     -  - -- -  - ---   --       --  -   -    -       - ----     -    -
-  -       -  -        --   -  -    --       -- - - -   - - -      - -   -- -    -  -  -    -  -   -
- -     - -    - -  - -  -      ---    - -         -  -       -  --    -    - - -   - -  - - --   --
-  - -- -    -         -- - -  -    -- -   -           - -          -     -        -    -  -   --- -
-  -   -     -     -     --        --  - -     - -     -   -     -     -  - - --  --  - - - -   -  -
- --     --   -       -        --  -   -  - --    --  - -  - -      - -    - -         --- - -   ---
-   -  --  - - -   ----       - - --  -        -  - -- --   -    - -  -    -       -    -      -   -
-  -     -- -- -  -   --     -   --      -      - -   -  -        - -    ---  - -  - -- -     ---  -
- -             -  - -  - -  -  -  - - -   -   -        -- --    -   -   -  -    -  --        -    -
-    - -   - -   -   ---      - -        -   --   -- -    -  - -  --    - -   --- - - -- - -   -   -
--   -- -  -   - - -    -- - -  -    ----     --   -   - - -      - --  - -- - -    -  - --- - --  -
- -- - --    -    -  - -     - -  -  -    -  -       --  -  -  -- -    --            ---  -- -  - --
- -       -    - -      ---  -     -    -    --         - -         - - -  -       - -     -   - - -
- - -     -   -     -       - -  - -- --  -  - - ---        -  - -  --       --  --       - -  -  --
-     -     -  -     -   --  -   --  - - --    -       - -   -  -   -  -       - --       -- -     -
-  -   -- --      -        - --    --- -    - -   -     -  -- -- --   - -  -  -    --   - - --     -
--  -  -       -        -   -  --     - --  - - -  -   -  ----   - -  -    -  -  -   -        - -  -
-        - -       --  -  ---      -   -  - --       -  - -  ---   - - -  - --    -     - -- --    -
-      -   --    -    - - -   -   -   -  -  ---    -     - -         ------       - --   -       - -
- -- -    -   - -   - --    ---      -   --     --              --  - -     - -      -  - - -   - --
- -  - -        ----   - - - -  -   --- -   --   - -   - -      --  -           - -   -     --     -
-  - -   -- - -      --         -----  ---- --- -  -  - - ---        -      - --- - -     -  -  -  -
-    --  -  ----   -    -     -       -    - -    - -   -  -     -     - -     -        -         --
-     --  - -       --    - -   -  -      --  -  -   - -- --    -   --   --            -    -- -  --
-       - -   -  - -             - -- - -   -   -    -  - -  - -  --         -   -     - -       - -
----------------------------------------------------------------------------------------------------
