100
100
----------------------------------------------------------------------------------------------------
-    -           - --    -       -                   --- - -            - -- -      -  -      ---- -
- -   --   --- - -        --       - -- -      - - -    -    - -  --  --- - -   ---- -  -   -- -   -
-     -  ----     -      -  -   -      - -   -    -    -     -       -   -   -   - --    -   - --- -
-  -  -   -  -  - ----  ---   -   -- - -  - -  - -           - -  -   - -  --  - --         - ---  -
---  -  --    - -    - -   --  - - -             -       -  -   -     - -   --  --    -  -   -  -  -
-- -  -- -       - - - -   -    -       -   - -     ----          - - - - - - ---   -  -   -   -  --
-  - -      -   -  -- -   -- - -  ---       -         --      -   -    - ---  - --      - -- - -   -
- - -  --  - --  -   - --       -  --     - -     ---   -   --  -   --     -       ----    --    ---
-      ---         ---   -- -    - - --       -    - - -  -   -    -   ---      - -  - - -   - --  -
--   -       -- ---         ---      -  -  --   -      -      -  -- -       --   - ---     --- - - -
- -  --  -- - -    -    --      -            -    - --        -----    -  --     - -  -  ---       -
- -  - -  - --  -  --  -      -- -  - -    --  - --- ---   --        -      - --    -  - -  - --  --
-  -    -  - - -    ---   - -  -- -   -  - - -- -   -    -  -  --   ---           ---- - -   -     -
-  --  -   -      -  -           -   - --  - -   -    -   -   --  -      -  -   -     ---      -   -
-     -- -- -  -         - - -    -- --- -     -       - -          -  - -   -  -      -           -
- ---- --  ---    -   --   -    - -   - -  -     - -         --  -     - -  --   -   - -  -  - --  -
-   - --  -    -   - - -  -  -- -  - -- - - - -  -    -- -     -   --  --- --         -     - -    -
--   -       -- -     -   - -    -  -  -  ---   - -     -   - -       -         -    -- - -  -   - -
-  - - -  - -  - -- - -  -   -     -  -  - - -      -  --   - -   -- --  -- -- -- -    - -        --
-  - -        -     -  --      -   --  -- -   -  - - -    -- -  -  -   --- - -  - -  -  --  -   -  -
-- -  -- -  -   ---   --    -  -   -          -- -          --     -  -   --- -        -   -   - - -
-   -   -   -  --     -- - -- -         - -    - -       - -- --   -   -  -     -   -   -  -   --- -
-   ----        -     - - -   -   - - -- -- ---- -        - - ---     -    - -  -- -- ---      -   -
-         - - -- -     -      - - -                  -  --   - -     -    - -   -       -- - -    --
- -   -  - - -  -  - -  --   - --    -- -  -- -   -   -- -- - -    -  - -   - -- -     - - -- --   -
-       - -- -       - -   -- - -- -      --  ---    -    -   -   - -  ------ -    ---  -   --     -
-   -    - - - - -      - -     -    -  --  - -  --     - - -   - -   -- -    -    -  - -      - ---
-   -      -    -  --- -     -   --   --      - -   -     --  -      -    --   --- -   -   --    - -
-  --     -      - -  -  - - -- -   -    -  -  -   -  -    -     - - - -- --  --   -   - ---  --   -
--   --       - -   --   -          - ---  -  - --    -  -   - --    --      -   -       -  - -  - -
-      --  --    - -          --                     --  -             -   -- --   -  ---- -    -  -
- - -  --     -    -   -      -   -  -   - --  -    -- ---  -  ----  -- -     --  -   -   -    -   -
-   ---       -       -  --  -- -    -        ---            -- - -    -   -  - -   -   - -     -  -
-      -   -     - -        --    --  -   - -       --   - -  -    ---  -   -   --    - -      --  -
- -  -  - -   - -  ------ -   - -       -- -          - --    -  -        ---     - --   -----   - -
-            -   -    --         -    --    -    ---      -   -   - --- --  - - - --   --   - - - --
- - -          - -  --   - -   -    -     -    - -    ---       -    -    -- --          -       ---
-   - -    - -                -   -- -  -  -     -- -    -   -  --      - -  -      - -         - --
-  -     - -     --  - -   -      -  - -       --      -- -    - ------  -       -- -- -    -   -  -
- -   --    -  - - -     -  - - -   --- -   - -- -----    - -          --- --  -    --  - -     - --
-    -    -     -- ----- -  -  --  -       -- -      ---     --   --  -   -     -  -   -         - -
-----    - -- - -  -         -    - -   --   -  --- -   --    -    -    --      --        -  -     -
-   -     - -- - - -  -   - - - -     -- -    -  -   -        - -      -  -     - -   --   -  -    -
- -- - - -   -  -  -     -           -  -      -        -            - - - -    - ---   --  -  - - -
-    -  - -           - -  --   -   -    -  --- --    --   ----    --      -  -  -   - -    -    - -
- - -    -  -   --       --  --   -   --      --    -   -  -            -- -       -     - -       -
-       --  - --         --      -   -- - --  -  -         - --    -   -  --      --  -   --   - ---
- - - -- -   -   -  --   -   -     -   - -  - -   -       -  - ----     --- -- -     -- -    -   - -
-   -    - - -- -        --      -  -   --   - -    - -  -      -  -  -   - -    -- -          -   -
--       -     -   --- -   - -      --       -  --   ---           - -        -- --   -    -  -    -
-- --   - -       - - -   -  -- - -  --    -    -  --   -- - - -----  -      --       -     --  -  -
-  -            -  -          - --     - -  --  - -  ---       --      --     --        - -     -  -
-  -    -    - - -     ---  - -          -   -   --     -   --    -- -   -   - - -- --  -  -  -    -
-- --  -        - -  -  -        --         --   ---  --  -- -      -         -   --    -   - -    -
- -     - --  -   -   -    --  - -             -   - -  -   --  - -      -      -   -- - - -       -
- -  --  - -   - -  -         -- - ---  ------       -    - -   -      --      ---- -      -  - -  -
-  - -     - -        -  -- -   -       -    --               - -----     - - -  -        - --   - -
--- -    -   ---            -   --   -          - -   -      -    -  -  -       - -  - -       - ---
-     --        -       --    -    -  - - - -- --  -   - --    --     - -    -- - -     - -       --
-----  -    - - -  -   -         -- -     --        - - -    --  ---   ---  -      - - -  - -  -   -
-       -  -          -   -- -  --- - - --    -     - - - -  -  -   -     --     -  -    -   - -   -
- -  -   --      -- -  -        --- -  -   ---   --   -  -    -       -- --  --    -     - -     - -
-     -    -     -   --  -- - -       -- -   - -  -   -    --        -  -   --- - --      -- -     -
- - -  -  -         --  -         -     ----- -  --- --    -  --- -   -- -      - -    ---         -
- - --   -   -           --   - -     -     - -- -   - ---  -     - -  -  - -   -        -    --  --
--- -     - --     -     -        -  --   -    -- --  - -    -   -  - - -          - - -    -  -   -
-- --  -- - -  --  - -  -     -- - --    -  - -    --            -- - -      --- -   ---     -  -- -
-        - - --  -      --       -- -       - -      --  -   -    - -     --- --  -   -     - -  - -
- --    -- -       -- --       -      --- - -           --  -  -        -  - -    -- -    - --  -  -
--  -     - -  -    - - - -  -   - - --  - -       -   -   - -     -     -   --- - ---   -      - --
---   - -    -- -   - -  -- -    --- --  -  - -- --     - --   --   -- --    -    -  - -          --
-    -    -        - --         -    -  -          -  - -          -     -  - - -    -   -   - -   -
-  -- - -  - -  - - --  - -  --   --  - -   -   -- -   -  -   -  -     -  --    - -       --  -   --
---   -   - -- -   -    -   -   - -  --   -     --  -   -      - -- - -- -   - -- -     -  --      -
-   -  - -        -  --- - -  - - - -     ---  - - -            -   - -      - --- -  - -      - - -
- -   --    - -     -  --     - -- - -      - -  -         -- -    -    -      -       --       -  -
-            - --     -   -       - -  -- -        --   - -            --  --  ----  -  --- - - -  -
- -  --     -    -      -  -   - -  --     - -     -      -    -    -      -  - --   -     - -  -  -
-    -  -- - - --  -   -      -      -- -------  -   - -   -  -   -   - -   --  -  --  - -- --     -
-  -     -  -       -- - -   -  -  -   -  -    --    -- ----  -- - -  - --     -  -  -      --  -  -
-    --- - -  -   -   -  - -  --- -    - - -  -               -- - -- --   -  -      -    ---      -
--     -- -   - --    -  - -   -    -- -    -  -- ---     -- -          --        - -        - - - -
-  -  - --  -   - --   - - - --  -  -  ---  --      --       - -  -    -     -       -      -- - - -
--    -   --- -       -  -  - -  -    -      --  -      - --    - -          -   -  --  --  ---    -
-  - -     -      -  -  - -  - - -    ----   -  -  -- - --- -   -   ---         - --  -       - - --
-    -        - -  --      -  - --       - - - -   -   -     --    -  -- --  -  -   -    - - - --  -
- -      -     -  -  -   -  --          -   -- - -   --  --      - - -      --   -   -   -  -  --  -
-         -      - -    - -   --  - -- -  -    -   -         -   - --    --  -     -    -  --  --  -
-   ----     ---  - -   - --             ---   -       -  -    -       -   -      -             -  -
- -        --  - -  - - -       -   - -   - -- - -   -  --      -  - - --- --  -    -       --- -  -
-          -     -   - -  - --           - -    - -   -  - - -   -   -  -           -      - -    --
-     - - -  - -   -  - - --   -     --  - -  -   - --  - -         --  -  - --   -      ---   -   -
-   -   -          ---      - -      - -   -- - --   -   - --- -    -     - -   -   -  -     -   - -
- - -   - - -   - - -    --  -  -   -      - --  - --  -- -  - --- - -   -  --     -   -   -- -    -
- -     -     - - - - -      - - -            --  -   -    -         -  ---   -     -      -   -   -
- - --    - - -  - -    -    - -  -  -   -   - - -   -- -  -   --          --- - -     -  -    - - -
- - -      -   -  - -   - - -  - - - -   - -  -  -- -     - -    - --- -  -  -          -- ----    -
-  -  -      -  - -      -     - -        - -  -      -- -  - ---   -        - - -    -     ---    -
----------------------------------------------------------------------------------------------------
