100
100
----------------------------------------------------------------------------------------------------
- -  --      -     -              -  --  ---   -- -    - -- -   -     -   -          -    -  -  -- -
-   -  -  -     -  - -   -- -  - -     -       -  -     -   - ---   -  -    --  -      -   --- --- -
-- -  - -      -   -- --   - -    -- - --    -- - -- -  -  - - - - - ----               -- -       -
-   -   -    --      -  --    - -- -- - --  -- -  -  -    - --- -  -     -   -  --             -   -
- - - -        -  ---       -  ---  -   -     -      -  -  -   -         - -   -   -- --   - -- - --
-- -  -   -     -  -  - --   -   -   --       -   -  - - -- -   - --         -   --     -    --  - -
- - -      -  -    - --       -            -   -- - -         - -    -   - -- -  -       -    --   -
-  -  -   -   - --      -     - - -   -         - -    -           --  - --    - -       -- -      -
- - -  - -- - --  -              --  - -       -- -  - -      - --    --    -    -        -     ----
--     -     - --   - -- -   -               -  -    - -  ----                    -         -      -
- - -   ---   --  - -      - -   --     -         -- - -  -  - --   -  - -      -  -  --  -- -    --
-   -   -   -       -- --      - -  --- -  --- --         - -     -  --      - -   -  -  -  -     --
- ---        - -  --  -      --- -  -                 --      -   -     -- - - -    ----      --   -
-    --  -     -  -  -               --   -  --     -   ---        --  --- --- - - -    --    -    -
---                --       -   -  -                --- - -   --      --        --     --  --  --- -
-- - -      -  --- -- -- -- -   -          - -   - -  -- - -     -      - -  - - -   ---  -   -    -
-- -       --          - --  -    - ----- --     --  --     -- --    -       -   -  -   - -   --  --
-   --   -  -   -  -----       -   - - -  - --  -      - -  --- -    -           - -          ---  -
-     - --        -           --   -       -       -  -  ----    - -    -  -   - -  -    -   --- ---
--     -  ---        --    -       -      - -     - --  -        -  --  -  -     -  -       -  -   -
- -      --- -  -     - -   - -       - -   -  --  -      -              --     -   -- --  -    -  -
-  -   --  - -  -- -       -         -- -    -  -     -  --      -  --  -         -      -  -  -  --
- -      --            -  -        -       - - - - -      -    --  -  -     - - --  -   -        - -
-   - -     --   - -- --  --  -- - -   -           - -   -    -- -  - -   -     - - - - -  -    -  -
-- --      - - - --      ---  -   -          - - -   -      -- - -  -   -  -   -      - -  -    -  -
--             -   - - - -     -  --  -- ---       --- -  -  - -             -  -    ----  --      -
-   -  - -  - - -   -  - - - - --  - -       -   -    -     -  - --  - -  -   -   - -    -  -    - -
-       -    -   -   -- -    --  -      -    - -   --- - - -        -- -   -    - - -   -  - -     -
-     -  - -   --  -     -     ---- -     -- -      -      -  --    -  - -- -        -     -     - -
-     -- --  -  - -  -  -    ---  -   --      --- -- -     -      ---   -  -  -         --  - -  - -
-   -      - -     --  -----   - -  -    -   -   --- -    -    --      -     -- -   -      ---     -
- -    - -  -         - - -   -  --   - -    -- -       -  -      --   - - - -- -   - - -  --  -   -
-  -  --  --   -      - - - - -     -    - --    --      -- - -  -- -     -   - -- -    - -  --    -
- -         -- -    -  -  - -  - -- - - --     --  -   - -    --   - -   - --  -  -   -     - - -  -
- --  - - -   -- --    - - -- -       --          -      - -  -  - -- -  - -  --   - -    -    - - -
-    -     --   - - --         --         --  - - - -     --    - - -  -- -  - - --       --     - -
- -      - -  -  -- - -      - -  -         -            -    - -               ---  --     -  --  -
--  -       -  - - - - - -      - -- - -  -  -  -  ---     -   - - - - --- --   - --     -    -  - -
-                -     -   ---  -       --  -    --   --     - -    -           --  - - -   ---  - -
-   -    - -    - -              -          - - -  -     - -- -- -  -  -  ----     - --           --
- -    - -   -               -- -  -- - -          --  -   - -    -         -  --   - - -     ---  -
--  --- -   -   -- ----         -- -        -      -    - - -     -    ---             -   -   -   -
-      - --- - - --       -        -     -  -     -  -   -         -    - -  -- ---- - -    -      -
-- -  - -     - --   - -  - - -   -   ---   - - -  - --  -- -- -   - -      -- -       ----     -  -
--   -     -- --         -        -    - - -    - -  -    --    - -         -  --- - --    - -  -  -
-    -  -   --      -             -   - --  --    -    -- -   -  -  - -   -  ---       -     -     -
- -  -    --               --   -   - - - - -   -        - -- - - -- --- --  --    -     -   - -   -
-              --    -    --  --- -      - -   -   - -       -- --  -    -  - - -   - -    -    - --
--- --       -         -    -   -- --       -- -   -   -  - -- -    - - -  - -- ---   -       -- - -
---   - --- - -  -  ---    -   -   --   -          -  -   -  -     -   -   - -    - -    ---       -
-    -    -   --         - ----      - -   -- -  -  - --    -   -  --   - -  - -      -     -    - -
--     - --   -  -- -  -                          - --            - -     -   --     -- -  -   - - -
-      - - -      -  --  -   -  -- --- - --    -   -          -  -  -  -   --             -  -     -
-  --      --   --  -   - -          -   -   --  -- --  ----       ---  -- - --  - - -      - - -  -
-  -       --   -     -            -  -  -     -  -    -  --    --    - -     -  -     -    - --   -
--  -       -      -    - --     - -     -   --    - - - -   -    --    ---   - - -   -    -     - -
-    -   -  -   --- -- -- -    -  -  -         -  - -  --       - -    -  --  ---   -- --      -   -
--    - - - - --   - - -         -     -     --   --        --   -  -  -   --    - -     -  -    - -
-  -     -   -     - --    -  -    - -      -  -  -- -  -      -       -- -       -  --      -     -
- -    - -   - -     ---   -   -  -     - --  - -  -      -  -  -  -   --  - -    -   -        -  --
-  -- -   ---       - -      -  -   --   -     - - -   -   -  -    -   --     -      -  - --- -    -
- -    -     - ----- - - - -   --     -- -   -- --  --   - -  -  - - ---- -    -        -    - --  -
- - - -  -  -   -   - ---  -- -- -  ---   - -        -  -  - -       -  -  -   - - -  -  - -- -    -
- -----   -   - - -      -     - --     -  -     -   - -  -  -    - -         -     ---       --   -
-         - - -- ---    -  ----  -  --  -   -   - - -   -  -- - - - -  ---  --     -    --  --     -
--  -          -  - -  --  -       -     -     ---     --  -   -      - -  -- - -   ---  -  -      -
- -- -     -        --   - - -      -      -- - -   --  --  --   -  -    - -- -  -       -   -- -  -
- - -  - -      -      -  - -      -  -      --  --- - -   -       - -- --   - -     -   -  -- -   -
- - -    -      ---  - -   ---      --   -       --- --   -  --  -    - -    -      - - -     -- ---
-   -  -  -  -     --  -    -            -  -   --            -  -        - -  -     --  -  -   -- -
-  -      -    ---  - --  -        --- -   -    -----    -    --        -   -  - -- -  -- -  ----  -
- -     -  -   -   -  - --  -  --         --     -  -   -   -     - - --- - -- - - - -- ---  -   ---
-  - --- -  -  - - ---   - -  -   -     -    -   -- -  --   -    -      --    --   -  --   -   --  -
-  -   -   -  -   - --     - - ---     -  -  -  -   - - -   -     ---          -      -            -
-  -    --   - -       - -- - -   ---  - -      ---  - - -    -     -  --       - -    -  -   -   --
-            -    - -    --   -     ----   - - ---   --     -- -   -      - -     -  --   - -   -  -
- -  -   - - --  --               -    -    -  -- -   - -- -  -   -    -    -   -- -     - -     - -
--   - -  -- - -- -  - - -  --- - ---    -      - -- --  - -   -   -  -----  - --    - - -       - -
--- -- -   --- -    - -         -  -        -  - -   -   -     - - -      -  --  -  - --    - - -- -
--   --- --  -  - -    - --   -         -  --      - -   - -- --   -- -- --   ---    -   - - -     -
- --    --  -   - ---  -   -   -    -    - - - --   -     --   -  -  -  -  -----  -   -         -  -
--- - -      --         -  -- - -- -  -----   - --- -  -  -   -   ---    --    -   -     -  -  - - -
-  -- -      -      -     -   -       -  - -    -  -  -     - -      ---   ---   -  - - -  -   --- -
- -  -      - --- -  -  -- -   -  - -     -   - -    -             --      -        -- - - -       -
-  -  -  - -   -- -----        --       --- -    -- -    -  --    --   -- -   --  - -   -    - --  -
- -   -  - - -  --      - -       --- -     -   -    -         -   -- - - ---  -    -    -  -   -  -
- -          -  - ----  --    -     --  - - - --  -   -  --    -- --     -      -      - -  -  -- --
- --   -  -   -    -  --     - - - -  -- --         -   - - -     -      -- -    -  -     ---     --
--  --         -   --    -     - - - -   - -   -   - ---- -- --  - --- -    -  -   - - -   --   -- -
- - -      - -  ---   ----          -- - --  - -        - --  -         - - -       -      -  -  - -
- -   -  -  -      ---  --     -  -     -   -   -   - -  -  ---   -   --   - --   - - --  -- -- - --
-    -- -- -  -  -    -         -     ---  -  -  - - -              - - - -   -  -   - -   - -  -  -
-  -       -    - -  - -     -- -   -        ---    -     -  -   -   -    -   --      -  ----- - - -
--   --       - -   -     -    - -   - - -  -        -    -   -- -    - - - -   - - ---   -  --  - -
-     -   -- -    -     -    - - - --      - -  -        - --   -  --    -- - - ---   -    --   -  -
--  -  - -    - -          --     -    --   - - --  - --  -      -    - - -  -   -- --  --  -    - -
--         - -    -          - -   - -   -- --   - ---      ----  -     - - -   -       -      --  -
-       - -  -   -   - --       -    - -    -  -       - - ------    -     -     -- ---  -      -  -
----------------------------------------------------------------------------------------------------
