100
100
----------------------------------------------------------------------------------------------------
- - -  -      -     - -  --  --    -       -          -     ----        -  -  -  -    -         -  -
- -  --  -- -  -   - -       -  - -  -  -   -       -  -- -     -- - --  -  -  -       --   -    - -
-   -   -       --     -  -   --  -   -     --     -  -    -  --- -     -       -   -  -- ---     --
- - -   -   - --    ----   -  - --- -  --       -    - - --       --  -  -       -   -       -  -- -
-  --       --          --  -  -   -     - --   --         --    - -  --  --  -- --- --- -   -     -
--  -  -  --   - ----     -    -  -  -    -  -                   -   -    - -   -  -   - - - - - ---
- --  - -  --- - -  -    -      -  -  - -         -   - --    - -        -  --  -            - -   -
-   --            -- -     -    --     --  ----  -   ---   -    -     -     - -    -- -   -      - -
- -    --        -- --      -  -   -     --     - --    -   -      ---  - -  -- -  - -  --    --   -
- --  - - -   --      - -  -     -   -    -- --- - --  -   -     -    -    -  -            - -  -  -
-  -      ---     - -  - - -- - - -- -   ----    -   -----    -     --      --     -    -  -    - --
--   - --   -        --  -     --       - -         -         - -      -- -   -  -   -       --  - -
-- -   --- --  -   -    - --    -- - -  -   -  -     - - -     -  -       -          -  -- - - - ---
-            -     -    -  - - -   - -     -  - - ---   -  --             --- -   - -   -   -  --  -
- -  --  ----       - --   -    -     -- --      -   -   --  --- -    -   -     -  - -  - -  --    -
---    - -- --   ---    -     -   --  --   -    -   -    -  -  -    -  -   --   -       -- --      -
- -    -     -  - -   - ---    - -   -     - --   -  - - - - --     - -       -  -   --  -- -  -  --
- -         --  -          - --   ---  -     - - --  -    -- -  -   - -- --  -  -  -         -  -  -
-  - -  -  -- - --    -- -        -  --   --    -        --                         - -  - - -  - --
- --   -  -     -      - --   - - -     - - -----  -  -     -     -   --  - -  - - -      -   - -- -
-       - ---    -   -  - -   -  -  - -     -    -  -    - -   --      ---- -    - ---    -- -   - -
-   -     --      --  -  -    --  --    - -     ----    -  -   -- -- --   -    -       --    -- ----
-     ---    - -     -   --   --- -   -  -- - -     --   - -  --- -  - -  -  - --- - -    --  --  --
-  -  -  -        -  --    -              - - -  -     -      -    -- -    - --  -     -       --  -
-  - -  -     - -      --        -- -- -- -- -     - -      --    -    - --     -  -       - - -   -
-  -   -   -  -         - ----- -   -  -     -    - -  -   -      -  - -   --  - -  --  --    -  - -
-- ---           - - -        - - -  -- -    -    - -  --         --        -    --   -      - -   -
-   - - -- -  -  -       - -          - -      -      -- - -    - -  -    - -- - --   --   --      -
- -- -   -     -  - - --  ---  -   - -   --            - -  -  -    -   -  -  -    - --       -  - -
-        --          -  -  -       --        -   --    -    -       -      -   ---   -  -     -    -
- -    -  - - --   - -----  -- -     - - --    -   -- -   -  ---   ----            -- ---       -  -
- -    --                  --    -     - - ---      -     --   - --    --      -  --  -  -- -     --
- - --     -     -  -   ---- --- -    -   - - ---       -- -    --  --   -   - -  -    -    --  -  -
-- -- --    -  -- --       --      - -     -   --  -  -  - -   -  -    -   - -        -   ---  -   -
-       - -----   -     --      --- -  -  - - - - -     -- --        -        -  - -   -  -   -- - -
- - -             -        ---- -     -  -- --   -  -    --  --   -   -  -   -  -      -   -- -    -
-   - - - -----          - - -      -  - - -   -      -          - -     -    -   - -----   -     --
- - --       - - --   -  -       -      --   -     -   -  -   -- -  -  --   -  - -       - -   - - -
-   -    -      -  -  -- -- -   -   - -    - ---   --   --    - -  -     -         -- ---       - --
- - -     -  - - --      -- --    --   --- -    - - - --      -      -  -  - -   - - - ---  -      -
-    - -     -  --- -- - -     --      -    -  -   --  -  -     - ---  ---- -   - -   - -    - --- -
-   -  -  -   - -    -   --  -- ---   - -- -    - - - - - -  - --      -   - --  - --  -- -        -
-    -   -  -             - -   -                -  -    - -        --   -       -  ---  -     -   -
-    -    -   - -    -        --   -   -   -             - --  --     - -  - -        -    -  -- - -
- -    -   - -    -  ---   --  -  -   -  ----- - -  -- -      - -      --- -   - -- -            ---
-   -    - - -      -   - -    -- -       - - -  -   -   -- -   -- - -- - -   -- -  -  - -- -  --  -
- -  --    -- --   --     -          -  -          -  --       -    -   -       --     -    -  -   -
-  --    -- - - -    -  --   - - --   -        -       -   - -     -  --   --    -  - -      -   - -
--   - ---             -    -  -      --   -- --  - -        -         ----  -    ---   -     -    -
-      -   - - --- -  -         ---    -      -    ---- -    - - -  - -   - - - --  - ----- --     -
--      - --      --    --  -  -      ---   -   -    -   -     --      --  -- -   -   -  -    -- - -
-   - -    --  --- - -    -- -- - - - -- --   --      -      -     --  --  - --  -      -  --   - --
- -  -  ---    -  --   -  -   ----- -   - - --   -   - ---   -        ---  --  --   -   -  -- -  - -
--    -  -        - - -             - ---   - -- - --  -     -  -   - -  - ---   ---    -      - - -
-   - -    --    -    -      -  - -   ---  -   -  -  -- -   ----   - -  -     -  -      - --- -- - -
-   -  -   -      -   -  -  -  -   --    --  --  - - -  -   -  -   -  - - ---  -    -       - --   -
-      - - -- --    - --    ---  --  ------   --         --  -- --  - -  -- -      --      -     - -
--    - -    - -  -  -- -- - - - - --    --     - -  -   -    --- --  - -    --  -   -       -  ----
-  -   - -   --            -      --       -   - -  - -   --     -   --       -    -     -   - -   -
-   - --    -         --  - - - -       -   -  - --    -   ---     -   - - --  ---- - -- -- --  - --
- -  --     -- --      - --   --   - ---     ---    - -  -   --   - - -    -            --  - --   -
-   ----      --  --    -    -- -- -  -        - --      - - -  -     --      -    - --- --     -  -
-  -          -  - -   - --  -     -         -  -    --   -  -       -      - ---    -   - - - --  -
-    ---  - --  -  -  -   -    -- - --     -     - - -  --        - -  --   -   -        -        --
-   - -  -- - - - -    - -  -    -       -      ---- -     -        --    --        - - - -- - -   -
-    - -     -    - -    -- - -    - -      - -- -    - -      - --   -     - - - - ---      -  -- -
-   - - -   -    -   - -  -     -   ---   - - -   --  -    -  - -- --- -   - - -            -      -
-         - - - -      - - -  --  -      -   -   -      --  -- -     -- ---  -   - --  -    -     --
-        -           -   - -  --  --- -       -   -- -  - -      --  --  - -      -   --  - -  -----
-  --    --- -    - - -- - -   -   --  -  ---                  -     -       --  -  -  -    - -  - -
-  -   --     -- -  --           -        -   --  -   - -   -   --   - -          -   - -    -     -
-    --   -  -         -       --   - -  -  -- - -        -   --   - -  --  -- -  - -- -   -       -
-- --   -  -  -   -     -          -      -      - -  ---     - -       - --   -       ----  - - - -
- -  --      - --  -      -      - -   -- -     -   - -  -- - - -    --         -     -  -- -      -
- --    -   -  --     -  -  - -- - -      -    -- -  --   -  -  - -  --  - -  --    - -      - -  --
- -   - - ----     - - - - - -      - -   -  --  ---     -    --- -- -- - -     -   -       -- - - -
- - --- - -    -        --  - -   --     -- -   - - -- -    -  - - ---  - ---    -  - --   -   -   -
-- -  - -  ---- - - -  -     -   -   --- - -     -      - -      --   -       -  -  - --   --   -  -
- - -- - -     -  --    - -  - ---    -        - - -    -      -    ---   --  -   -  -  - ---      -
-   -   -     -  -   -- -- -  - -           ----   -  -   -      - --     ----  -      --    -   - -
- - ---   --  --            - --   -  -  - -      - -   - --  - -  -- -    -     -    -   -  -     -
- -     --       ----    --       -   --     -    -   -   - --          -       -              -   -
-    -      - --  -    -  - -     -   -      - -     -    -      -- -   -  ----  --- -    - -   - --
-- -    - -  - -     -- -  - - -       ---         -     -      -   -   ----   -    -   -  -       -
-  - - -    - --      -   --   ----    - - -- -      -      -   -   - -     - -  -     -   -   - - -
--     - --     -   - -  -    - -   -    -  - -  -   -    --- -  -   -  -  -   -  - -    --      ---
--   - -      -   -   - -  -  -- -   -  -   -     -  -       ---  --      - -    -       -  -----  -
--         - -      -   -- - -   - - - -  -  - - -      - -    --               -      -  -   -  ---
--  -             --- -    -  -       -  -- --   -     -      -     - -- - ---    -  -   - -      --
- ---    --  ----   - -     --    - -   -     - - - -  -     - -     -- -     - -  --      -     - -
-  -   -        - - -      -   -----       -    -   --  -   -   - -  --  -  --  -          - -   - -
---  - -  - -     -             - -  - -           -      -   - -  - -           -- -      - - -  --
- -  -     -    --   - -- - - -         -         - -- - -   -       - -  --        -   --     -  --
-    - -  -- - -      - -  - - -  -- - -        -     -   --       - -           --      -         -
-    -   -     --     -   -- - -    -  -  ----      --  - -- -       -      -     - -      -     ---
-  -       ---          -     -  -  -      -  -  - -   --   -   --    -     -    -    ----       - -
-      - - -     ---   -  - -  -  -       -   -    - - - -   -     -    ---  - -  -  - - -         -
-    --                 -                  -  -   --           -   - -     -  -             - -    -
----------------------------------------------------------------------------------------------------
