100
100
----------------------------------------------------------------------------------------------------
- - - -- ---           -      -- -   -  - --- -- -    - -   -             -- -             -       -
-     -  -  - - -- -    --   --   - -  --       - ----  -  --   -              - --  - --   - -   --
-            - ---  -   -     - -  -- - - -      --- - -  - --          --- -       - -    --  -- --
--    -     --    -  --  --  -   -- - -  -  - ---      -  - --   -  -       --       -  -   --   - -
- -  --- -    - -   -- ---  - -  - -    --  -  -  -      --   -   -  --      -          --       - -
-   --      -  - -- - -  - -- - -   - --         -    --  -    -  --     - -   -    -     -  -     -
-  - - - --- - -  - -   -  -  - -   -    - --   - --       --             - -    - - - -  --- ---  -
-- -   -     -----   -    -- ---  -- - -             - --- -  -   - - - --  - -  - --  - -   -   - -
-     -   -     - -      -   -   -     - ---   -    - -      -     -       - -  - - - --  -    -   -
- -     --          -  - - -    -- ----     --- --    --     --       -- - -      -   -     -    ---
--    -    -- ---- -     --   -        - - -  -  - -       -           -     -          - -    --- -
-    - -- - -      --  --   --  - - -     -   - -   -      - --            --     -      -        --
-   - -   -   - - --  -         -- -     -  -   - - -    -    -   -  -- --- -  -     --- -         -
-   -      -     --      -   -   --    - -    -            -     -        - -   ----    -  -  ---  -
-      -    -- --          -  -      - -      - - -- -  -        -  - -  -----  -       - -   - - --
-     - -     -   --  --  -       -        -   - -   -   - - -                   -        -   -- - -
--  -  -   -  -       --     -   -     -    -   -   -        ---    - -   -   --   -  - - ---    - -
--        -  --- -  --    -       -    -     -       --         -  -  -- -  -  -   --       -  -   -
---     -   - -    - -  -  --  - -            -  -   - -   --- ---  -         --     -- -   -     --
-   --  - - -   -    - -     -  - - - -        - - -       - - -    - - -    -- -   -- -     --    -
- -- -         - --       --   -   --     ------   --  -    - -      -  - - -   -     - -- -    -  -
-  - -- - --  - - ---    -   --  -  ---   -  --  -      -  -  -   --           -- - -  -     -  -- -
-  -    -            -   --            -   - -   -       -   -- -  - -  -- - --   - - -- -       - -
-      -  --- --- - -   - - ---     -     -  -        - --  -    ----      -  - -  -   - - - - - - -
-   -   - - -   -  -    - -        -    ---   -   - -   -  -   -       - -   -    - - -  -  -  - - -
-          - -- -- -- -    -  - --    -              --            - -    -  -    -  -     -       -
- -   -  - --     --               -    -         -    -            -- -   -  - -- --- --   -- --  -
-     - - -     -    --        -    ---- -   -  -  - -- --  -  -       - -- -     - - -   ---      -
---      ---    -- -    -         -    -  -    -----    - --   - -  -- --  -    -   -- -          --
--     -       -  - -- -- -  -- --  - --  -      -     - -  -  -  -- - ---- --   -    -       --  --
--   --  - -    --         -  --        --                 -  -  --- --   ---  -  -- --        - - -
-   -- - - - - -      -      --  - - - - --     - -     ------  -       - -  - - --  --     -  - - -
-   -  --    -  --   - -   -   -        -  -        - -  -      ----      - -    -   -   -     -   -
- - -     -      - -    -     -  - ----  -   -    - ---   - -   -  - --         -    -  -    - -   -
-      - -    -   --- - --  -    -      -  -  --  - ---          -- -  -    -   -- --  -    -    - -
--    -  --        - - ---     -    -- --      -     --- --    - - --            -  - - -       -  -
- -  - --    -  -   - -   -         -        -- -    -     -         - -- --   ---- - -   --   -   -
-    - -      ---         -  -      -  - -    -  ----    --  - --- -- -    -      - - -----   -    -
- -  -      -    --- - - -  -   -- - -    -  -     -  - -             - - -   ----- -              -
-  - --    -        - --  -- -- -- -   -    -  -- -      - -- -     -- - - - -      -  -- -        -
- ---    - --    -   -  -   -         -   -       --  ---  -   -      -     -  -    -          - - -
-      - - -     -    - -  -- - -   --  - ---      --  -   - - -        -  - - - -   -        -   --
- -    -        -   - - -  -    -----  - -   -- --       - - - -      -  - --  -   -  -  - - - -   -
-   --      -        --  -   -      -      - -  -- - - - -      - ---    - - - --- - -   - - -- -- -
- -  --  -     -   -- -   -    ---   - --  -- -     -- --  -          ---     -    - - - -    -   --
- --  -   -- -  -   -       --  -    --  - -  --   -  --  -  - -  -  -   -  -         -    - - -   -
--   -      -             - -    - --  -        - - -    -      --       -       -  -     -  -   ---
- - - - -  -     -------     -- -  --     -     -   - - -- -  - --  --- -- ----        -   - - -   -
-- -       -   -  -     -        -   --       - -                  -  - -     -  - -- - - -  -  ----
-   -- - -   - -- ---    -- - -  -     --    -- - - - -       --     -   -- -           --- -  - - -
-  ---       -     -     --  -     --   --     - -    -   - --  -  -     -     -- --- -     -   -  -
--- - -  -- -  - -- ---      --   -  --    --  - -- - -  -  - -   -         -           - -- -- -  -
-  --       - -          -   - -  -- -     -  - - -  - -- -      - --  -----   -   ----     -  --- -
- -  -- -   -   - ----   -- ---         -- -     --    - -- -  -   - -   - -                --     -
-  -      - -   --          -   -  -     -   - -   --        -   - -   -   - -       --    - --- ---
-    -   -    - --      -      -     -     - -  --- --   -  - -- - - -   -   -   ----         -  - -
--      --   -  -   - - - - ----  --  -  -  --     -  -   ----             - -- -  -  - ----   - - -
-  --  -- -      -       -- -       -- - --- - - --   - -         - --   -  --   --   -        --  -
- --       - -     -       -  -    -- - -  -    -  -  -   -     ---       --  - -   -- --   - - -  -
--  - - - -  -   -  -   - - --   -   -  - - --   - --   - -    -  - --   -- --  - -      -   - - ---
- -     - -   --   -    -  - -  -     ---  -  - -    -     ---     -     - -     -   -      -  -  --
-   - --- - -    --  - -- -   - - -- - -  -   - - ---   --   - --  -  -    -  -        - --  -  - --
--    ----    -   - --   - -   --- - - -            -  -  - -  - -   - -         --    -   -       -
-  --   - -     ---  -- - -   - -- -      -    -  ---    -   -              - -    -- -   --       -
-  -   - -  -  -   --- --     --       - -    --      -- -    -- -         -           --   -    ---
-  --   -    -     -   - --  --               - -  -    - -   -      --- -   -      - - - --    -  -
- -   -  --- ---- -    -- - -  --       --   -  - - --    -- -     -   - -      -    -     --   - --
-------      - - --        - -        --       -    -   ---   --- - -   - -  -  -  -         -  -  -
-         --  -   - -   -   -    --  -   -  - -- -  --               --   -    - -- -   ---   --   -
--  -  -     -   -  -   - - -    - -     --  -   --- -      - ---     - -   -- - -  - -      - -   -
- -       -   -   -  -     -   -      -      -   - -     -   -  -   -  -  -       -  - -           -
-- - -- - -  ---    -        -    ---  -      --    -  -  - - -  -  -   -        - -  --    -   -- -
-       -  -    - -      - ---  --    -  -  --     - -- -   -  -         -        -    ----   -  - -
-  - -     -  -         -                 - --- -               -- - - -       -    --     - - --  -
--     -- -  -  -  - --  -  -      -  -----    -  --  - -   -  -      --- -   -   - -- ---  -     --
-     -- -   -  - -    - -        -        - -   - -     --- -  -  --- - -- -      - --  - -   --  -
- ---   - - - -   - -       -  -   -   - -- -           -  -   -     - - -  - -  - -  -   - -      -
-     -   -      -- ---  - -  - -   -    -   - -   -    -   -      --  -- ---  - -  -   --   -     -
-    -  -  --- - ---      -         -  --  - -  - - --      --  - -    -   -  --  - -              -
-   -- ---     --    -- - -     -    -  - - -   -  - --   -- - - -    -             -       - ---  -
-           - -    -- -    -    -           -     -    -   --       - -   - -          -   --  -  --
-       -    -  -  -         -- -- --    - --  --    -   -- -     -   -      -- -   - - - -  --  ---
- - --    --    -- - --   -                    -    -  -   -    - -      -  --  ---   - -- --     --
-   -   -  -    -       -- --   -     --   --    --   -          -     -      -    -- --  - -      -
----  ---  -    -     -   -    -  -- - --   -       -  - -  -     -        -             - -  ------
- -  -  - --  - - -  -  - - -- ---- -    -     - - -     - --     --  -   -- -- -    - - --        -
--   -          -   -         - -   -  -- - -   -- -         - -- -       -    - --     -    - -   -
-         -  -           --       -     --     -            - - -   - - -- - -  -  - ----- - - -- --
---   - --  -   -   -    -        -- -  -  - -     - - --- -- - -       -    - ------ -         -  -
-   --     - -   - - -- -- ---  -    - -          -- --   -        -    -   - -   -     -  - -  -  -
--- - - --   --    -      - -  --       -                     -    --    - --  - --  - -  -      - -
- --   -    -  - - -   -   - - -     --   -  -  -   - --             -    -    --  --- --    -  -- -
-  -  --  - ---     --  -   --     -           -       ---- -  -  - -      - -     -            -  -
-      --   -- --- -    - - - -- -    --      --    -    -     - -      --    -  --         --- -- -
-    -           -- - - - - -      -   ---  - -   -     -     --  -    -  - -      -   --  -    -  -
-   -  --     - -        --  -   - - -                  -   -  -              -- -   -   -  -      -
-        -       - -- - -            -- -   - -     - -- - - -    - - - -    -       --    -       -
-    -       -  -  -     --    - --               - -  -      --  - - -   --      -   - --  --   - -
----------------------------------------------------------------------------------------------------
