100
100
----------------------------------------------------------------------------------------------------
-  --- -   - - - - - --  - - --     -- -- -             -       - -              -    - -   -   -  -
-  --  -     - -     - -     -   -              -   - -   -----        - --    - -    - - - - -    -
-  ---   -     -      - - - -- - -  -    --        - -        - - -   -----     -    - --  - - -- --
- -  -    -- -     --    - - --     -  -  -   -  --- -     -   - -- - - -       -  -   -  - - --  --
-- --   - - --              -  -- -- --     --  -   - - - -    -   -     -- -   -   --    --  --- --
-    -----      -       -    - -  -    ---- -    -    -    -        -    -  -       -   - -    - - -
- -  -    -   ---  -  -   -- --  -  -  ----    -        - -    -                         - -    -- -
- --       - -   -----  -   -- - ---  -   - - --  -        - -- --   --         - - -----     -- - -
-   -- --  -      -     -  --     -  - ----- -- -   -  -      -        -- ----    -      -  - --   -
-  -  - - ---   - -  --   --  - - --   -    -    - -        -   -   -     -  -  -        -  -      -
--  -  - -   -  - -   -  -   -       -     --  - -              -  -      - -    -  - --  -  -  ----
--     -- ---   -  --  - --  - -  -- -- --   -   - --- --    --  -  -   -    ----- - -   ---    -  -
-   - -  - -          -                 --- -  -- -      -- -  --  -      -  -       -  -        - -
-         -            --  -   --    -   -    - ---   -  -  -- - -  -  -      -  --  -  -- --  -   -
--  -       - -- - - -- - - -   -     - - ---  - - --     -        - -     - -        -      -   - -
-    --- - -  --     - - -  -  -      --- --  - - -  -- --    - -     ---- --  --- -  -  -      ----
--   -  --                -       -             -    - --  -  -     -- - -   --  --  -      - -    -
-      --  - -  - -   --   -- --      - -  -          - -  -    -   -     - -   -   - - --  - --   -
--      ---  --- -   -  -- -         - -          - -     -         -   - -   -- -   -     -   --- -
-     -  -  -       - -    - --   - -    -      -   -- -  -- -   -  -  - -       -  - ----- -     --
-    -- --  -   --      -     -    -       -  -   -   -        - -       - --        -           - -
-             --  --   -- - -   -     --- - - - --    -   -  -           -- -  - --     -          -
-   -   - - -          -- -----     -   ---  -     -- -   - -  --  -  - -  - --- - -  - -  - -  -  -
--      - - - - -        -   -   -    -      - -          --     -   -      --  -   --   -   -  -  -
-      -- -  -    -    -      -   --        -    - --     -        -     -      - -        - -    --
- -  -    --  -    ----    -        -  --   - -  - -- -  - --    -                     ------- --- -
-    -- --     -  - - -  ---             - --  -   -  - -   -  - - -  ----  -- ---          - -   --
- -  -    - ---    - -     -         -    -  -  -  -    - -    -   - -          -    -- -  -       -
- -    - -     --- - --        -  -  -    ---          -  -    -      -   --     - -      - - -    -
--  -- - --   -    --   -   - -    -  -      -- --- -   -          -     -    - -    -- --   -     -
-  ----  -  -  - --  --   - - -  - - - - - - -        - -   -----  - - --  -  - - - - - - - - - -  -
--      -  -  -        - -       -- - -    -  - - --  - -    -   -   -  --        - - -    --      -
--   - - - --    - - -   ----  -     - -            - - -     - -  - -          -  - -  --   - -- --
- -   -    ---    -  - - -  -   -    -   --  -    --- ---   - - --     -  -  ---       -   -      --
-   --  --- - --     ---  -- -     -   -      -       - - -  -       --     -     -  - - -   -    --
--   -     - -     - - -     -       ---    -- -- -    --   - -  -  -   -  -  -- -       -  --  - --
-     -    ----      - - - -      -   - -          -          -      --    - -  -  - - -        -  -
-   -   -   -   -        - -     -       ---   - -   --    -  -        -  -  - - -   -  -     -    -
-- -      -    --   -  --- - -   -  -  -        -  -    -   -      ---        -     --   -     -   -
-      -             --   - -- -         ---- ----  -  -  ---- ----  -   -           ---        -  -
-  --      - - -    - --  -- -   -- -             - -  - -    -  -- --   -   --  -         -  - -  -
--  -  --- -  - -    - -         -      -  - - -      -    -     -- - -        ---    --  -- -     -
- --    - - - --         -  -- -     --        --         -      --     -- -- --  ----   -    - -  -
-    --- -  -   -  -  -               -- - -   - --    - -  -  ---- - ---  -           - - - --    -
-  - -    - --- - --         -   --    -    - -        -  -        --    --  ---   -    -  - -     -
-     -  -     --  -      --  -- - - -       -   --  -       -  -     -        -  -    - --   - -  -
--  --   --- -           -      - - -     -   -         -- -   - ---  -- -  - -   -  --     --     -
- -        -   --------  - - --   --  - -  --- --  ---   -  -   - - -                  -   - -     -
-  -    --       -  -     -- -    -    --    - - -      -  -  - -   --     -  -   - - - -  -  ---  -
-     -- -     -   -    -  -  - -      - --   - -- - -  -  --             -- -   -         -    -- -
- --   -    --- - -        -- - --   -     -   -  -  - -        -  --  ---- --   -  --      - -  - -
-  -    -      --- -     -    - -       -   -  --- - -   --   -      - -  - -- -  -  - -   -    - --
- - - - - -  --  -   -     -   -  - -    -- -  -  - -  -   - - --    --  -- -  - --  - -  - -  -- --
- -         -      -   -   -   -  -  --  -     -- - -   --- -   --   - --   ---- -  -       -   - --
--       --    -- -         - -    - -      -    ---      --  --   ---  -        - -  -  -         -
-  --         -  -    -   ---         ----  - --  -     -       --       -  - ---  - -          ----
--     -        - -  -    -   --   --     --        - -  -  - -           -         - -      --  - -
- -  --   -  - -        - - -   -          -  -- -    ---   -  --  - - -     -- -  - -  -  --  --  -
-           -  --       -        --     - -    -   ----   --    -  -  -    -   -    --   - -- -   --
---     --- - -   - -- - - --- - -     -       ---      - - - --- -  -  -       -  -       -  -   --
-      -    -  -  - -  -   -     -- --   --  --   -   -  - -      -          - --   -- --   -   -- -
- -- -   -  -   -   ---   - -  -   -- -   - --    -  -    -  ---   -    --   - -        -  -  -  ---
-   -     -   --  --   -    -    --     --  -- --  - - -- -- -  - -      -            -  -  - - - --
-   -     -  - -    - -            ---   - -  - --  - -   -    -   -  ---      -- --    - --    -  -
-    -  - - -  -   -   --   -  -  -  - - -        - -    - --    -  -  -  -     -     -       -   --
-   -    - -           --  -        -  --   -  -- - -      -   -  -  -        -     - -  --    - - -
- - -  - -     - -- - -   -- -  ---     -         -  -   -   -   -  -   -- -- - --  -  - -  - -- - -
-    -     -     -   -  - -       - -    -        -     --     --  -  -   -  -      -     -  -    --
-         -   -   -   -     -     -   --     -  - - ----   -   - --   -  - - - -- -- - - - -   -   -
-  -   -    -  --- --  - -      - -   - -     -- -   -           -  --- ---  -           -    - - --
-  --  - -   -        -   - -       -       -- -  -   -      -  -- -    -  -    -- -  -   -   -    -
--    -  - ---      -   - -   - - -  -   -        -   ----  ---          -    -  -     -      -    -
--        -         -- - -    -   - -   -          - --   -   - - -- -  --  -   -    -    -     -  -
-   - -    --  -   --     - -   -  - - -   -- -   -- -- -   -   --   --    -  --  --      -  ----  -
-         -  - - - -             -- --   - -    -      -    -   -   -  - -      -  -  -  - -    -  -
-   -  -  -  - -          -    -     -      -  - --  -   ---- --    - - - -    -  --  - - - - -   --
-   - -- - -     -     --    - -    -         ---  - -- -   -  --   -      -     -   - ---  --  -- -
- -    --  -- -  - --    - -    ---       - -    -  -     --  -- ----    --   - -        - -   -  --
- - -         -           -   ---      -  -           - -- - -       -  -  - -      - - - -  - -   -
-  -    -  -     -      -  -  -  --   -      - -      - -   --   -- -   - -  ---            ----- --
-          - -       -    -       -- - - - - - -    - -        -   -       -- -   - -   - -        -
-  - -   -   -- -- -    --- --     -    -            --            -  --     - - - -  ---          -
-- - - --    -- - -- --  - - -- -   -   -   - -     -  -             -  -     -- -        -  -  -- -
-        -      -     -  - -  -  --         -  -  - -   --       -  --       --- - -  -    -  -    -
- -   --- -   -    - - - -   -    -  - -     -- - - - -  - - -  - -  - -   --     -- -      -  --  -
- -- - - -  -  - -   - -                 ---            - -  -   -    -    - -- --        -     - --
-    ---   - -   -  -- --     -     -  -- -     -     -   - --     - -  -  - -  - -  ---  - -      -
--- -    - --        -  --  -   ---     -     -    - - --                     --  -     - --- - -- -
- - -- -- -   - -- -  -     --     -- -- --   -  -   ---              - -   - -     - - -      -   -
-- - -   -       -- - - -   -  -  -- - -     - -   -      ---- - -  - ----        - -   --- -   -  -
--  - -- -- -- -- - - - -  -       -   -  -  -     -- -    --- --    -  - -  -  -- -    -       - --
- -   --      -   --        -- --   - - -  -        -  -    -- - -- -- - - - --   - -  -   -- ---  -
-    -  ----   -       -  --        -    -   -      ---  -    -    -     -     - --     --   - -----
- -   - -  - -  -        -     --    -  -  - -       -    -           -  --  -       -        -  - -
- -           -    - - - - -  -      --   -  - -    -- --  -  - - - -        ------ -   -  --  -  --
-   - --           - - ---   -        - -      - ---  -    ----- - -       -- -  - -   -         ---
--    -          ---   -     - - --         -   -   - -      -   --   -    -   -- - -         --   -
-    - --- --    -  - - -    - -  - -      - -     -  --   -                 -   - -  -      -   - -
----------------------------------------------------------------------------------------------------
