100
100
----------------------------------------------------------------------------------------------------
-      -    - - -   - -    --      --         -  -        ---  -     -           -   -    -        -
-     -                 -     -- - -  - -  --   -  - - -    -   --   - -  -  --    -   --- - - --  -
-   -     -    -   --- -    -      -    -- -     - -     -      -      -   --       --     -  -    -
-   -- -      -- -      -      -  -- --- -        -  - -  - -  - -      -        -- -  - - -    -  -
- -      -      - --- -  - - - -    --    - - - -  --    --- -     -    -      --      -  -  --  ---
-  - -   -    -   -  -           --     - - -   -     -- -        - ---- -   - - -   -   --   -    -
-   --   -   -  -  -    -     -     -  - - - -  - -      -  -- -       -- -  -  -      - -   - -   -
-       -      ---    -  -   -   - -  -   ---    -   -    -- -- -  -- -   --                -   -- -
- ---  --  -       -- -- -          --        -     -  -    -        -    -  -     -      -        -
- -    -    -  --   -    -- ---   - -  - - -     - - --  - -       - -- - -           -  -   -  -  -
-      - - -        - - -         -     - -   -     --- --      ---   -- -   ----     --   - - --  -
- -- --   --         --   - --  -      -- - -   -   -   - - -      --    - -   - -  --  -  --   - --
- ---  - -- - -- - -   -   -                 -    -   -- -    -   -    -   --- -  -  -        -   --
-    --       - - -    -  - -----  -   - --  - - -       - - -      - - -   -  - -  -      -    -  -
- -  -- -   -  - -- -   - -    - --   - -   -   -   -    -  --    --   ----     -       -  -     - -
- --  -   ---- -  --  -  -  -- -  -  -       -  -          -    --  --     -    - -        --  --  -
-     -  -  -    -  -     -   --    -       -   - -- - - ---         -  - --   -   -       -  --- --
--         -  - -    - -   -       - --  - -  -     -      -   -  ---        -   - --  -           -
- -- -    - - - - ----   -      - -  - - -    -- -- - -- -  -- -  -  -  --       -     -  - -   -  -
-  - - -      -- -    -   ---  - --   -      - -        -  -    -       -  - - -  - --          - --
----   -  -      -  -     - -- - --- ---    -    ----    --   - ----     -        - --  -   - --   -
-   -  -    -  --   - -  -    -       -   --     -     - -  -  -     --   - - -- -- - -        -   -
-- - - --    -   -    -  -  ---- - ---  -  -      -- -----   --  ---      -   --  -        --   -- -
-  -  --     -          -                   -- -    - -        -         -   -         -   ----    -
---    --    - -   -   -  --  ----  --  - --  -    --  ---     -      -    - ---- -   -     -   - --
-    - -    -     -- -- - ---         - -- -    --         -     -  - -- ---    -  -- - --   - --- -
-   -  -   -- --   - -- - -    - -- -  -     --- -   -- -    -    -       -           -    -  -    -
--  -  - -  -   - -    -    -            - - -       -   - -       -    -          -   --  -     - -
--             ---  --   ----   -  -- -          -     -- -    --   ---       -   -  --  -   - - ---
-  -   - - --- -         -      - -  -  - - -       --  --  --  ---    - - -   -  -     - -  -- -  -
-   -       -      - - -   - --      --   -  - -  -                -- --    -- -   --  --    --   --
--   ----      -    --- -   -   -            -  ---   -  - -    -    -  --    - -         -     -  -
-  --  -             --      - - - -   --    -   -          -   --   -   - - -    -   --  -  --  ---
- --  - -   -  --  - -   -  -  - -     -     -            - -  - -   -  -  -  ---  - -         -- --
--   -   - ---    -   -      --   - -    ---    ----- -     - -- ----   -- -      - -         - -  -
-     -       -      -    -     -     --- -  - - -  - -       - - -     -       --      --   -     -
- - -    -   - -    -  -   - -    -  - - - -   --   -           --   --- -- - -  - -   -   -- -    -
- -- ----     - -- - -- - - - -  -     -     -  -     ---   -  - --   - - --   - --   -    --     --
- -  -  -   --     -   -  --      - - ----  - -    -  -     -   -   - - --  - -    -    -    --    -
-      --    -   --- - - - - -  - -      -          - - -     -  -  -  --     -   -  -   - -  -  ---
--     -   --  - - -     -  - -     -  -  - --- - -       -        -  -     -              --   -  -
- ---  -         --   -    -  -    -  -  -     -  -                 -- - -   ----  -    -       -  -
-    -- -   -       - -        --  - -  --  --       -- --  - -     -   -      - - - -      - -  - -
--  - -   - - - - - - -    --- -            - -      -  -            -  --   -- -   -  -----   -  --
-       - -    -   -- - ----      -- -    -  -   -   -      --   ---          - -    - -   - - - - -
----  ----  - - -     -  ----    -  -    - -       - -  - -    --  --     -- ---   - -- ----  --   -
-    -    -- - - -  - - --- -    - -- --       - -  ----  ----   -    -  -      -            -     -
--- -  --- -   - - -----      -     -- -  -  -    -  -  --  - ---  -- -   - -            -- -  - - -
-    - -     -  - - ---  --- - -  -    - -      -         --       - - -   -    -  -- -- -  --- -  -
-  --    - -   -       -         - -   -   -  - --     - - - -  -       -    - - --  -  - -     -  -
- -   -      -  - -  -  -   -- -   -  -- - - --   -  -   - -     -- -  --  -  - -  --  -   -  -    -
-- - -   - -- -   -   - ----    --     -- -      - -- -      --- --      - -       -   -   -   - ---
- - -- --    -  - -  -----      -    --  - ----- --    -----   -    ---     -       --    - - ---  -
-  - - -  ---    -               - -   -  - - - -  --   --     -    - - - --       - -  -   -  - - -
--             - -   -  -  --     ---    --- --- -       - -  -    -  -  -  ----   -       -     - -
- -   ---    --  - -   - -   - ---  - --  -        -   - -          -     --   -  --      - - -    -
-    -  - -       -            -  - - -  - - - -  - -       ---     ---   --- --   -         -    --
---   --   -   - - -  -  --   -   -    -  -     -  -   -   -   -  --  - -  --   -    --  --  - -   -
-  - -  -      --    -  -- - --   ----  -           -- -  --  -  -    -   -          --     -   - --
- -- - -- -  -- --    -    -- -    -      --       --   -    -    -    -   - -  -   - -  ---- -- - -
-     -     -  -     -  -  -- -----  - - --            -    - - -    -   - -  -    - --   - -- - ---
-     --  -  - - -     -            - -    -     - -      --  -      -      ----- - -   -   - -   --
- -  -      --  -   - -    -- - ----          - --- -    -  -    --   -  -  -         --     -     -
-- -   -    -   - --- - -  -     -- -      - ---  -   --  - ---    - -  - -   -- --   -- - -  -- - -
- - -  - - --  -   -  --  -  - -  -     -   -   -      - -    ---         - -  -         ---       -
--- - -  -  --  ---          -- -  -   - - -   -   - -  - -    --- -   - -       -  - -      - -   -
--    -    -        --    -- - - -- -      - -   -- -- - -   --   -       -     ---  -   --  - -  --
--   - -   -  -- -    ---  - --    - -    --  --       -   ---  --  --   - -     - -    - -        -
-- -  - -   -          ---   --    -   -     -- - --       -  - -  -  - - -      - --       -      -
-  ---  - -   -   - -  -    - -   -         -           --     -      --  - --   -  --   -   --    -
-  -      -   -          --  -   -        -    --   -   -           --      - -    -   -  - -      -
--   - -  - -  --  - -  -  -  -     - --- - -     -           -    -     --    -- -   - - -  --    -
-  - -     -- - -    -     -  - -           -       - -  --   -  -- -     - -        - -           -
--         -     -    -         --    ----   -- - - --          -        --      -    -  -         -
-  -      - -   -   - --   --  -     -  --- -   ----    -  - -        -   -       --    - --    -  -
--   -- - -  -  --   -   --   - ----  -   -  -       - --          -      - -   -   -    --    - - -
-   -   ---      -- - - -     -  -     - -     - - --  -  - -        -     -    -  -   --  ---     -
-    -  --   -  --        -       - -  -     --  -  -    -       - -     -     --- -- -       --  --
-         -     - - -   - -    - -  -      -     --- -- -          ----   -   -   - -- -  -      - -
-    - -   -  -       - -   -   - --        --  --  -   -    -   --  -  -        -      -   ----   -
-     -     -  - --  -      -      - -  - - -- -  --   -- -  -  -- -- --     -   -  ---  --   - - --
- - - --      --   -    -   -        - -- -        --   - -- - -     - - -    -- -     -       - - -
-- - -      - -      - -  -  -  --   --- --      --  -   -  -   -   - --- - -   --  - --     - -   -
-    -   - -  -   ---   -   - -  --  -      -- -  --  - - --  - - --    ---       -     - - -  -- --
-  -  -   - -     -      --     -  -      -    -    --     -     - -   -  --  -         -     -   --
--  --  -    - - -  - -    - -   --  -   - ----      -      - - --- -     -       ---   --   --- - -
---    -   -  --  -      ---       --     -     -  -    -- -- -       - -       -    -   --       --
-    -        - --   --    - -  --    -   -   -- -          -- -         -- -- -           - -     -
- -  - -  -      --       -  -  -  -- -- -   -  --   - - -     - - -                 --            -
-   -   -     -  -   - -- ---   - --    -- - -    -     -  - -- -        -- --    -         - -    -
--   -- -- -- -         -- - ----          --  -    -   - -  - -   -    -  -       -   - - -       -
-- -   - -    - - --         -   -      -     -   -        - -      -   -  - - -- -   - -          -
-- --   - -  - -  - -  -        -       -    -  -        ----  -     -   --   -    -        - - -  -
-   -  -  -  -  -   --- -       -         -    -     -- -        -       -   -   -- -  --    - --  -
-    -     --     -- - -   ---   - - - - -   -- --     -  --   - -  -- -- --   -- -  -       - -   -
---      -   - -    -  -  -     -  --       - -   -- -   -- --- -  -   -- --    -  -   - -- - -    -
-   -   --          -    --- - -  -      - -  - - - -- - - -   -   --  -            --  -  -       -
-    -   -           -       -      - -      -         - - -    - -    -      --           - - -   -
----------------------------------------------------------------------------------------------------
