100
100
----------------------------------------------------------------------------------------------------
-  -    - --      - - -   -  - -             --    -  - - ---   -  -       - --       -     -   -  -
--  -- -    - -- -     - -  -- - -- -   ---    -     - -   -   -      -  - - - --      -    -    - -
-  -   -  --   -   - -    -   - -    -  -   -  - - -  -  -  --   ---  - -     - - - -  -  -    -   -
-   --   -      -  -  -    -    -- - -     - -  -    -  - -         -      -  - -   -   --    -    -
-      -    -     -     -   -  -    -    -- -  --- - --    -    ---- - -             -            --
-   -     -- -  --    --    ----    ----   -  - -   - --       -   - -- - -  - -      -   -        -
-    - -  ------    - --   --  -  --    - -   -  -   - -  - --    -      -        -    -     -  -- -
-  -    -             -   -- -- - -- --   --    -  -  -  -        -- -- --   -- ---- -    ---      -
-  -  -    -   --  -      - -      -      ---   -   - -   -   -  -   --    -           -  -  ---  --
-   -   -   --       - - - -     --   -  -    - -  -    -    -   - --     -  - --- - -      -  - - -
-    -- - --    --    - - -    - - --    ---         ----          -   -   -   -  -     --- ---- - -
-  -         --   -  -  - -    --  --- ---  --  --    -   - -    --  -  ---   -      - - -         -
---- ---  - -  -  --  -   -  -          -     - -  -   -     -     --   --- -    -    --      - -  -
-         -  -  --    ---   - - -    - -    --  -   --  - - -- - -   ---     -    ----   -  -      -
- -    ---          -      -        -   -         -  ---- -   -         --- - -  - -  -  -    -  - -
-  - -   -   -  -       - --   -  - - - -  -    -              -- -- - -                   -- - -- -
-      - ---   --             - - -  - - -   ---  - ----  -  -        ------     --   -     -  -  --
--  --   - - - -  --   --     -  -   -      -   - --  - -  -  ---  -     -- - -   - -  -  - - -    -
-   -    -       --    --    - -   ---  - --  -      - --   -     - -             -   -       -    -
-       -  -       -- -  --     -   - - - -             -  --  - -- - -      - -  -   -  -----   - -
- - -   -  -   -     --       -     - -  -  --- - -     -      -    -- --- -    --     - -    --   -
- -   - -  --     - -     -   -- - -    -     - --  --- - --   -  - -        -   - -   - - --     --
-     -      - ---     - -   - -   -- -   -   - -    -   -      - -- -   --- -    - - -- ---   - - -
- - -       - -   - -    - -    -- ---          - --    - -   ---- - --    -   -   -        --     -
- -    -       -  --- - - - -     -    -   -    - --     --   -    --  -  --  - --  -  -  -   -  - -
- --     - -  - -          --     --   - -- - --      - -  - -     --         --         - -- -    -
- -   -      -  - -  -  -     - - -   - --   - -     - -     -  - -   - -  -    -   -   -     - -  -
-      --  -   -      -   --           - -    - -  - --       -        -   -      --    - - -  -   -
-   -     -     --       -     -   -   -- -      -  - --        -        --     -    -   - --- -  --
---    -   -   - -        --   ---       - -  - -  ---- - --  - -    -      - -        -           -
-    -   -  ---   --            - --   --  -        -     -  - -  - -  -    -   -- --     -  -    --
--    -     - - -- -      ---      -    -    - - -      -           - ---   - -  -                 -
-     - - -   - -        -    -    - -- -        -- -   -  -  ---    - -      --   - -  -     -  - -
-       -   --          - -  - - - -   -       -  ---- -           -  -  -  - -  -        - - --   -
-  --     -   --       -- -  --   -- - - - - -   -     -     ------- - -   -   -    -  -   -  -- - -
-----  - -  -   -   -   - - --  -         --   -  --  -   -  - -          --- --    - --- -   - -- -
- -   -    -    --- - -    -  ---  - - -            -  - -  - - -----     -    - ---     - --  -   -
-  --  -    --       -  - ---    -   -      - - -  -    - --  -     --  --  -  -  -  -       - -  --
- --   -   -        - --      -- - - ---  -  - -    --   -   - -   -    -- -  -     -  -        -- -
-  -    --  -   -  -  -   -    - - - - - ---- -           --        - -         - - -   -        ---
- - -      -     -   -     -       -  -  -  -  -        - --   - -     - -   ---            --  -  -
-       -- -  - -  - -- -   - -- --            -  - - ---    - - - ---    -- -          - --    -  -
- - -           - --  - -   - - -      -- -         --  --  - -- --     -     --  --      -  -  -  -
- -   --   --       - -    -  - --  - -           - -  -   - -  -     -  ---   -   -     - -      --
-         --  -  -         - -    - -  - -   -       -- -           ---- - -        --         -   -
- --   -  ----        -     --     -    - --     - -- - --  ----       -      -     -   -   -  -  --
-- - -    - - -- -- --    - -  -    -  --  -- - -  - - --      -- -         -     -          -  - --
-    -- --    -   -       -     -    -   - -    - -    -  ---     - -        -   -  - - -      -   -
- - -  -       -  -  -  --        -- -  - - ------    -       -  - -           -  ---  - -        --
- -  --   - --- -      -     -    -       --  -     -  --  - --       -   - -- -  --   -        - --
-   -   -      -- --     --  -   -- -    -- -       ----       - --  -- --   -    -    --    - - ---
- -   -           - ----      -        - ---  -          - - -- -   -    --- ---  -  -           - -
-    - --    -  ---     - - --    --  - - -   --      --    -   - ---  --     - ---    - -     -  --
- --  - -- -  -     -  ---            -      -  --     -     -  -  - --  --  - ---   -  -  - -     -
- -   -   -  -  -- -        - -  -  -  - -     -  - --- -     -     -     -   -     -- -       -  --
-   -     -  - -  -    - - -- -       -     -   - - -   -  -   -   -   --   - -  --   -  - -- - -  -
--  - -          - - -  -   -    -  -  - - - -  -      -      ---    -  -                     --   -
-     ---    -  -    -   -- --   - - - - - - --  -     --       - - ----      - -      --- --- - - -
-- --     -  - -   --    - -    - -        -   -    - -  --   -     -       -  -    -- -    - - -  -
-  -  -    -     - -     -  -  -- -   -  - -    -    - -    -    --  -   - -    --    -  -    -   --
- -- --   -- -  - -    -  --  -   -  -        - -    -   -  --- -  -- -  -    -    - ---       -   -
- --  - -  -- --    -   -  -- ---- -   --   -        -   -     -     -          ---    - ----   -- -
-  - --     - -    -- -- -   -        -   -    - -  --  - -         - -- -- - -   -----    -  -    -
- --      -  -    -           -   - -  -        --  -- - -        -  --- -  -   -   -  -- --  -    -
-- -    - -    --        --     - -  -          -      -  - -  -  - -  --        - - -- -  - - - - -
- -       -          -     --   -- -   --- -- -  -  - --  -  -- - --   -    -   -  -      -     -  -
-  --      --  - -   -   -   -    -  --  -    -           ----  -     - -  - ---- - -  -  - - - -  -
--   -  -     - -   -- -    -   - -    -- --   - -   ----    -  -    -   - --   - --   -   - -     -
--- ---   -     -- -   - -      -          -  -  - --  -     -- -  -   -      --- -  -----     -  --
- - - ---  -- - --   -    -  - - -  --    -  --- --    -  --    -  --- -- -- -  -    -   - --- -  --
-    -             -     -  --  - -   - -   -  -    --       --    - -    -    - -  - -     -  --  -
-      --  - -  --- --        - - - -  - -  -       -  - -  -          - -   --  ----- -  -  --  - -
- -  -         --   -  -  -      - - -       -  -  -             -         -  --   -     --  -  -  -
-   -  -    -      - -   -    --     - -   -  -    -- ---        -     --  -        -      -       -
- -  -  -      - -   - -      -   - -  --  -    - -- -  --   -            -  ----  - --  --  -  - --
-  -      -  -    -   -    -     -       -   - -  -- -    - -   - -       --        -    -----     -
- -             --   -  -    --  --             - -  -     -                 - - -           - --- -
-   - -  -  -   -- --   - -     -  -    --  -  --      -  -   ---   -         -         --    - -- -
-   -      -      -       -     -  -   - -   - - - - -  - -- -    - --      -     --  -- - -   - - -
- -     - - -         --       -   -    -    -- -  -   - --   -  - -   -  --  - - -        --- -   -
-     -  -- - -  -  -    - -  - -      -          ---- -       - -    -   -  -     -   -  -   ---  -
- --   --   --   -  - --   - - -- -  --      -       ------   --- --  --- -        - - -    - --   -
-  -  --      - -      -   -  --       --  -    --           -       ----- - -      -  -    --  -- -
-    -  -    - -  -  - --    -- --      ---  -   -    -    -   -- ---   -   - - -       -  -    -  -
- - -   -   -  -     --  --   -   --   -       - -- --   -- -   ---  - -  - -   -    -     - - - - -
- - - -  -  -   -     -- --  - ---   --  -   - - -    -- -   --    -  - -      - - -   -     -    --
-    -    --  -- -  -    - --   -   -     --  -   -  -  -  --           -     - --  -  -  -      - -
--  --      --    -   --     - - -   - -      -    - -      -- -         ---       -    - -   --  --
- -  - --       -    - --    --     -   - --      --- - -   --   -- --      -  -  -- - - --   -    -
-- -   -  -     --         -  -   -- --   - --   - - --   -     --       - ---  -       -  -  -   --
- -   -    - - --  --   -   ---  -  - -     - -  -         - ---   -  - -   -        - -  -    -   -
-      ---- -      -  -    -  --- --      - -- -  -  -           -     - -  -    -  -   --- -   -- -
-        -  -  -        -  -                -  -   --       -  - -  --         --   -     -      - -
-   -     - -      -   -   -  - ----     - -  - -   - --- -  -    -    -  -        -   - - - - -   -
--       --  -       --- --  - - -    --    --  - -- -    - - -    -   - ---     - -   -   -    -  -
-   -    -    - -        -   -   --  -  -    -       ---      -       -  --  ---   - -       -  - --
-      -- -   - - -  ---  - -- --   --        -      - --- -     ----   - -       -        -      --
-  - --      -     -  - - -       - - -     -      -        -  --       -  -    -     -- - -    -  -
----------------------------------------------------------------------------------------------------
