100
100
----------------------------------------------------------------------------------------------------
- - - --        --       - - - -- -  -      -  -      -      - -  -      -   - -- -  - - -  -   -  -
-         -    -  --    -    -      -        -- -        -       --    -   -   -       -    -      -
--     - -- - -  -  -   ---   --- -     - - -  -- -             -   - -   -     - -- -    - -- - - -
-      --  --     --    -           ----  -   -   -  - -    -- -    -         - --  -- - -    -    -
- - --   --   -  -     - --    - - -        - ---- -     -    -           -    -     -  -          -
-    -  -  - -- - -   -    --   - - ------    --    -    - - - -  - -  - - - -          -   -- -   -
--        -   -     --       - -- --  -    -  - --  -      -     --  - - --              - -      --
- --      - --         - -  -  --  --- --- - -      -   - - -         ---    -   -   - ---   --    -
- -- --- -        -- - -         - -- -     -     --   -            -    -    -- ---- -   -    -- --
- -     - - ---   - --     -- - - --    -        -  -    -        -  -  -   - ---    ---     -     -
-      -             -   - -     -      -   - --  ----  - -  -  -  -   - -      --       -         -
-      - -       -       -      - --          -   -  -       - - -  -    ---  -    - - -   - -  -- -
- - -       -  -   - ---    - - -    ---  - - -     -- - -     -   -        --  - - -- -  --  ---  -
- -- -- -     --- ---- -  - -    -      -  -  -    -   -  -  - -    --  - --        -- --        - -
-   -  - -  -  - -    --    -      -    -  -    --- -     -        -  -        - ---        -  --- -
- -- -       - - -     -  -  -       --  --  -          -- -   - -   -- - - --    -      -    -   --
-- -      - - - - - -    -     - -     -      -  -   -   - -  -   -      -    -- -   --      -     -
- -      -- - -    -     ---- -    ---  -   -        -    - -   -     -   - -    -      - --  - - --
-- -        - --      - ---    ---   - - - -- --- -  -  -  - --   -  -    -    -    -          -   -
-   --  --     -            - --      --  -- -   - - -  - -    - -     --   --   - - - -- --- - ----
-       -  -         -- -      -   - -     -   - - --- -- - - -- --    - - -    -   ----   -       -
-            --  -- - -- - -    -   - --  --- - -- -- -  -      -  -  --   -     ---   -    - - - --
-  --  -   --  -    -         -- -      -  -  - -  --   - - -  -            -- -  -   - -  --      -
-    -  -   - -- --    ----  -       -        - -  -- - --     -  -        -            -  -     - -
--- -  -     - -   - --        - -     --- -- -  - - - - -  -- -  -      -    -              -   - -
-        -----  - -       --   - -          -       -   -      --- ---- -   -  -   - -         -   -
- -- - - -  -   -    -  ---  -   --      -     --- -- -   ----  --   -       -   --  --      --    -
-  -        -  -          -  -         -        --   - -  ---- --- -- -  ---   - -  -   - --    -  -
-   -  -- -- -       -   - ---      ---   -   ---    - -        --  -  - - - --    --       --     -
-    --   -  -     -  -   -   -----  -   -     -  -      -- --- -     -     ---  -- - -           --
-      -- -       --  -    ---    --    -    - - -      --    - -  - - -- -            --     -   --
-  ---   --    --      -    -  - -  - -  --     -  -       ----   -   -  - ---   - -- -    - -- -  -
-              -   ----  -  -   - -   --       - ----   --    - -- - --    - -    -    -  ---   -  -
-   -- -   -  - -   - -         --  -   ----   - ----       -      -         - --- -- -  --   - -  -
-- -      -     -               -            - -    -  -- -    - -  -   --     - - -    -  ---   - -
- - -  - -  -    -- --  - - - -    --  - --- -     -  -  -- --- -                - - -   - -       -
-   -- - -- --   -- -  --   --      -       - - ---  -  -   - - -- -   -   -    -- -     --   ---  -
-     -     -   -        -    -- - -  -    -- -      ---   -  - -  - -------     -- -          --- -
---  --     -  -  -     -     -  ---  -         --  --- - -  - - -          -    - -    - - -     --
--     -    --   - - - -      --  -- -  --  -     - -    -     -   ---  - -   --   - -- -  -- -- - -
-   --   - --   -  -        - -       - -        - -     - - - - -        -  -      - -    -  -    -
-      ----     - -   --  - - -- ---  - -- - -   -   - - - - -  - -  -  -     ---  --- - - -  -  - -
-  ---  -    --- -  -   -      - -    -  - --  --   -   -   -  -   - -    -      --         -  -   -
-         --  - -  -- - --- -  --- - -             - -   -- ---  -     - - -  ---- --   -   - -   --
-  ---  - -   ---    - -   --     -        -     -  - --- -     -   -     - -- -    ---  -   -  -- -
- -  -  -  --    ----  --   - ---        - - --   --        -- -  -    -  - - - --  -    - --  -   -
-  -      -    -         --  -            --  -   -  ---        -  -          -      -   --  -  -  -
- - --     -    -   -  -    -   -  --   -     - -  ---  --     -    --   - -  ---    - -   - -     -
- --   -  -  -  -    -- - - - -     - --  -      --       ----- -             - - --  -  --   --  --
--     -   - -    -  -    -    - -       -  ---     ---         - -            --   - - - -   -- - -
-- -  --    --  --     -- -   - -   -- ----       -     - --- --    - -      -      --- -   - -- - -
-  --   -     -    ----    -  -          -  -    -    --  -  -    -- -     ---  -   - -          - -
-  -  -  -    ---     ---     -   - - -     -- -- - --       ---   -   -      ----- --        --  --
- -                 --    -- - -  - - -  --    - - -   -    -   ---  -  -   --    -     --       ---
- -- - - -    -      --  -     -  -      -   -      -  -   --  --- --         -  -     -  -  - -   -
- - -       - - -   - -  -- -  - -  -- -       - - -     -     -      -   -     -   -        -     -
-  -- -  --    -  - -- - --- - -   - - -   --  --     --  -    - -  -    -     - -  -  - - -     - -
-       -  ----     -- -       --  -    -  -   -   - -   -  -       -- - -     -  --    -   -  --  -
-  - -   -    -          -        -   ---- -     ---       - -         - --- - ---- -   -    - --  -
-  -    -- - -        - --- -        -   -     --    - --  - --  -   -  -         ---   --     --  -
-   -   -       -- -   - - - -   - - - --         -     - - -       -     --   --     --- --  -   --
-    -     --        -     - - --  -    -  -    -     --         - -  -     -           --    -    -
-      -    - -----  - -- ---    -  -      - -   -- -        -   -  -   -  -- -  --- --   --  -  ---
--- - - -    - --  ---     --   -    -  -  -   -        - -- -  - -- - --  -   -           --  -  --
- -  --  ---  -  -   - - -    -       -  --        - -  -- --   --  -  -     -    --   -      -    -
--          -   - -  -- - -  - - -            -   -    - - -    -    -       - -         -  -  --- -
- ---   -   - --               - -   -  --  -  -          --      --      -- - - ---     -       - -
--      -  ---  - -        -         - --    -     - ---   --- --      --                       - --
-   -  -  - -          -      -- - -     - --   - -      -    -      -      -  - -        - -  -   -
--       -- --    - -            -   -     - ---  - - - -- - -  -  -  -    - --   -  -  - -     -  -
- - -           - -  --    -     -   -  -     -     -  -  --     -   -   -   -  -   -     --     - -
--- -  --  - -    - -  -  -  ---  - ---           -       - -  - -    -   -    --  -- -        --  -
-       - ---   -    -------  --      -             -  -  -      -       -   --- -     -    - - -- -
---  -     -   -  - -       -      -  -       ---  -     -  -      -  - --     - -  -- - - - - -   -
- -  -        - - ---   - --    - -  -- -        --     --    --      - - -     -    -        - -- -
-  --     -  - -   - -    - -     --- -         --- ---       -   - -  -- - -- -   -   -  -- ---  --
-        ---    -   --         -- --        - -  -     --- -  -          -- -   -  -- -    -    -  -
-  -    -       -    -- - -- -  -       -      - - ---  -  -- --     --     -- - -     - -  - - - --
--   - -- -       -  - -  -    -     - -   -        --   -  -  - - -   - --      ---    -  -   -  --
-- -     -    - -  -    --          -     -     -    - -- -  --   -      -  -    -  - - -     -    -
-   --  --  -         --  -   -  -   ---   - -- - --  -- -- -     -  - - --    -- --     -  -      -
-  -      -  -  - - -        --           --  ---         - - -   - -  -    - -   -- -  ---     ----
- -     - ---               -    - --     -     -    -              - -   -- -  -  - -      -  - - -
- -    --   -       -    -   -     -   - -   -                    - -   - -  -     --    --   - -- -
-    ----  - - - --  - -  ---    -- -  - - -    -- -- -- -  -  -        -         - - -   --  -   --
- - --    -   --    --                 -- - - -  -     --     ---  -       -  - --  -   -  -    -- -
-      -   --    -   - -  -- --- -  - -    --  -- -   -  --        -----    - -     -     --   -  --
- ---   - -    --    -    -           ---   -  -          --    ---      -   - -  -     -    --    -
-       --  -  -  -   -        -      - - -- -  -       -- - -  -        ----    -  -    -      ----
-     -    - -       -   - -- - - -      -  - -   -   -- -- -      -  -      -   -  -   -          -
-   -   --  -   -  - --- -  - --    - -    -    -   ---   - -      ---   - - -  -      - -- - -    -
--    -   - -      -    - ---     -- -       - - -        -     ---     -- --  -      -  -  - -    -
-   -      - -- -      --           -    - -  -  -   - --    - - - -    -     - -  -      -     -  -
-    -   -    - ---  - --   -- -  --      --  --     --    -   -                   -  - -     - -  -
-  - - -- - - - - ---- -    - --         -   -    ---  -           -  -   -  -    -    -   ---  -- -
- --  -- -      -   -    - -- - -  -- -- - -    -     -  - -   --   -            - - -  -- -     - -
-  - - -  - -   - - -        - -    - -    - --   --  - -  - ---       -  - - -      --   -  -    --
-   -    -            - - --  -  --    -   -    -     -     - - - ---  -      -     -     ---   -- -
----------------------------------------------------------------------------------------------------
