100
100
----------------------------------------------------------------------------------------------------
- - --  -    --    -   -    -        -       -  -    -- - - -      -            -   -- - --      - -
-     -   -     --- -  - -- --    - -- -  -- - -        -    -  -   -    -  ---        - -  -  -   -
-   --    - - -    -    -    -    -  -   - --  -   -  --  --                -  -      -  -   -     -
-     -  --- --- -      -        -    -       -  --   - --  -  -- --                --         --  -
--         --  --  -     - -    -      --  --- --  -   - --  -     --    -     ----    - -  ---   --
-     - - -  --      ----      -      -        - - -    -      -    -       ---    -       -       -
-  --- -  - -   -   -- -   -   -  -      --   -    --- -  - -  -    -     --   -  - -  -    -    - -
-          -   - -    -     ---        -   - -- - -   - --        -   -   -  -  - -  -   -  -  - ---
---    -    --- -      -  -  -  --- -     -         -- - - -  --  - -   -    -        -   -     -  -
-    -    - -  -   -  -   --   -       ---  -- - - -- - -     - - - - -- ---      - - -     -- --  -
--    --- - -  ---      -  - -   - -- -  - -  - -   -  -  -  -     - -  --  --   - -- -  -   -  -  -
- --  - - -- -    -       - ----    - -  - -   -    -   -   -      --         --   - -    -  -   - -
-           - -      - --  -     -       --      - -   -    - ---         -  - - --         -- --  -
-     - -- - - - -        - - -   -   - - - - --     -   -  -    -  - --   --   -    - -   -  -    -
-    - - -      -     -         -  -      -   - --  - -       -     --    - -  - --       - -  --  -
--  -    -  -       ----    ---- - - --    --     --  ---          -    -      -- - ----        -  -
-    -  -   -   -   -   -   -  -    --  - --  -- -    --    -      -- -    -   -   - -    - - --   -
-  -      - - -  -    --     - -       -    -   ---  -   -        - -      --  - --     -         --
- - --      -   -  -    -- -    -           - -      --- -- -- -  -     --    - -    - -   - ---   -
-  -    --          -  --  - - -    -    -  --   --         -     - -      ---  - -- -  - ---- -   -
--  - - --- -  - --  -       -  - -  -- -- -       - - --- -  - - -     ---   -- - - -        -- - -
- - --      --  --     - -  - -          -  -    -     - ---      -  --      - -   -  -  --- -  -  -
--    - ---              -  -  -  - -  --   - -   -- -   -  --  -       - --     - --     -   - ----
-  - - - --- -  -- ---        ----       -   -    -   -  -   ---  --         -     -  -- -  -   -  -
- - -  -  ---              ----  - -       -  - -   -  -- - -             - -  -     - --        ---
---  -- -     - --- -  -      -     -  -   -   -          -    -   -- -    -     -   -   -  ---    -
-  -  --  -- - -       - ----  ---  --   -     --      -              ------ --  -  -  -      -   --
- -     --  - -   --- --   -- - - -   -      --   - -  - -  -     --  ----       - -  -    --    - -
-     -  - -------     - -- - - - - - - -        - -  - --    ---  --      -    -   --   -        --
- -     - -       --   -    -    -  - --     - --- ----    -- - -      - -  - --- - -  -- - -- --  -
-   -    -   -- -       - - --  -        -              -    -- - --  - - -      -  - - -        - -
-  -    - -        - -  -          - --  - - - - - -- - -   -         -     --  -    - -   ------ --
-    - ---    - -     --   -- - --- -  -        -    -   ---     - -   - - -  -  -  -    --       --
- -       -  -   - - - --- -  --    ---  -- --    -- -  -   --   -  -  -   - --  -     -    - - - --
- --- - ---   --  ----           -      -             - --- - - - -     - -   -  - - -- -     -  - -
-     --   -     -  -   - -         -     --   - -     -   -   -  -   - -   - --- -     -   - -   --
-    -   -  - ---     -- - -- -         -  - -----    -  -   -   -  -  -- -  -            --   - - -
- - -  - - - - - - --       - -        -- - --  --  - ---    --    -        ---   -    - -      -- -
---    -  -    -   - -    -         - - -           -   - -   -     - -- - -            - -- ---   -
-               - -- -  -- -    -     -  --        - -  -    -   -  --  - --- -       -   -   - - --
-        -- -   -- -     --    - -     - - - -   - - ---  - - -- --   -  - -  -  -  -              -
--      - -   --    - - -  --  -       - -    - --- -  - --- -     -  -     -  -         - ---   - -
-- ---    -   -- -     -     - -- - -   - --  - - - -    -     -   --      -      -     -   -  - - -
- - -  -   -     -   --  - - -    -  -- -        - - -        -  - -- ---  - -  ---             -- -
-        -   - -    -- -        --    -- ---            - -    ---  - -  -  -  -   --            - -
- -  - -- -   --  -      - -- -  -   --         - - -   - -     - - - -- -   -               - -   -
- --        -   -  -    -    - -   -             -     ---  -   -         --        - ---   - -    -
-   -   -   - --          -  - -           - --  -   -         -    --  --  -  - -- - -  -  -   -  -
-      -         - -  - - -     -    -  --  -    - --  ----  -      --        --  - -     -  -     -
---  -             --    -- -    -            - - ---   -              -  -    -              - -  -
-  --   -  -    - -  ----      -          -    -    - -- - - -- --  - -     --     -- -   -     -  -
- -  ---- - -- -  --   ----        -       -  -     -       - - -       -   -  -- - -  - - -  -  - -
-- -      - -  - ---   -       - -    --     -   -   - -   -    -         -     -- --      -  --   -
-- -   -               - --    -    --- ---  - ---   - - -----  -       -  -  -   -- -  -    ---   -
-    -         --  -    -  -  - - -  - ---        ---  -    -   --     - -        -    --  -    -  -
-  - - --    -  -     -  -  -- --    - -   - - ---   --   -    - - - -   -     --            -  - --
--   ---  -   - -    -     -- -    --      -     -- ---   -     - - - -  - ---  - - - -  - -      --
-       - - -   -  - - -- -    -     -        ----     -  - -       -  -      -      - -   - -- -  -
-    -     -       - --  -    -   --     -  -  -    -  - - - --   --      -- -  -  - -   -    -  - -
-  - -  -    -   -      -   -- - -  -      - -- - - -  -  ---      - -- -  -  - -- -   - - - -     -
--    --  -  -      - -  -   - -         -     -      -- -  --      - --    -  -  -  --     - - - --
-    -    - - -      - --   -   - -  -- - -- -- -    -  -  - -    - -   -- - -      -   - -     -  -
- -      -- - - -- ----- --    -            -- - --    -      -   -  -   -    -      --    - -- -  -
-       - -  -  --   --   -   --- -  --- ---   --  - -                -   -     -    -  -         --
- -   -      - -   -  - -     -     -     - --         -      -  - -  -    - -     --      ---     -
- - - - - ----  -    - --   - --    -  - -   - -      -        --  -- - -    - --   - --- - -    ---
-- --       -   - -      - --- --  -  ---- -    - - -       ---       -  -  -   -  -    - --    -  -
- -  -   - - -    -   -- - -   -  -    -  -- -  -      -   -  -  -   -  -  - --           -  -     -
-      - --    -   --  --  ---   --     --   -  - --  -    - -  -- -  -  -   -  ---    --   -    - -
- -- -   - -  -  -  --    -   - -    -     --     -  -         -        --     -   ---  ---       --
- -    -          -        -- - --    -     - -     -       -       - - - --   -- -   -       -  - -
-  -    -  - - ---       -    - -  - -- - - -- - -      -  -  - -      --    -      -    --  --- - -
-   -  --     -    -    - --   -  -  -    -- -- -      -    - -   - - -    - -   - - -   -   -  -  -
-  ---      -  --        -  - -    -  -  -    - -     -  --   - --   - -  -  -         ---   -  -- -
--   - -        -  --    -     -   -- - -     -   - -    -   - -    -  -    -   -       - --    ----
-     -       -------    -- -    -- -  -  - -   -  -  --    --   - --  -  -  - -     -   - -  -  - -
----      -  -   - -- -              - -      --  - -       -   -  - -    -            -      - -  -
- -    -   - -  - -- -  -  -   -  -  -     - - --   ---- --     --    --    -  -   --    --  -  -- -
-   --   -     - - -      -     - -- -   -- -        -       -   --  -       --    - -      --  - --
-----   - -- -   ---          - - --    -  --        -         -   -   -        -    -     -       -
-        -  -   -     ----   -     -          --        --  - - -- - --- -   - --- - - -    - -    -
----- ---    -       -     - -       -  -  - --  -  -  -      -- - --   - -  -     -   - - -  -- - -
---   -   - -    -  -  -   ---       - -   --  -  - -   - - -        --   ---   --       -    - -  -
-     -  - ---          -            --        - -  -          -      --      -         ---   - -  -
-    -  ---- - ---- - -    -- -  - - -    -  - -   - - -  -   -             - -    -- -   -   - -  -
-  --     -     -- -   -     - - -    -             --  --      -  -   -     - -- -   - --  - --  --
--  - - --   ---    - - - - -    ----     ---     -      ---- -  - -          -    - -     -       -
- --       -     ---- - -   -  -  -  -   -       -- -- -    - --  --  -  - - -     - - -  -  -   - -
-   -             -   -- --      - -    -  --   -       --  - - --         -   -  -   -   --   -   -
-    -  -    --    -   --     -   - - -  --     - -  - -   - -              -  --  -  -   -   - -  -
- -- -     -            - - - -   -    -     -- -- -      - ---- --   --  -             -       -- -
- -  - -   -   -    --  -    --   - --- - -     -  - - -  -        -- - -  - ----  - - -       -   -
-          ---  -     --      ---             -  --  -- -   ---   -    -- -                    -   -
-   --  -   - -   - -   -   --    -   --  -         -      - -      - -  -       --- - - -   -   - -
-             --      -    -  ---   -   -   -- - - -  -     -    -           -    - -      -       -
- -   -   - -  -     -- --- - -   --  - -  -  -     - - -    - -   -   -       --     -   - -   -  -
- --- - -   - -   --    ---- -  --  - - -   - -   - -    -   - - --      -- - --  -     --      -  -
-       -  -    -  -   --   -      --   -- -                     --   -  -  - - -     - -- - -     -
----------------------------------------------------------------------------------------------------
