100
100
----------------------------------------------------------------------------------------------------
-       -       --      -  -   -    -- -    -   ---    -   -  - -- - - --   -             - - -    -
-  -  -   - - -    - --   -   -   - --  -   - - -    -  -      -  - --   -   --- -   -- --- -      -
-   -   -   --   --     --     - - -- -    -- --      - -  --   -  -           - - -  -  -   -     -
-         -   --    - -   -   -  ---  -    -- -  - - ---   ---   - - -   -- -        --- - - -- - --
--       -  -- -  -        -  -    - - -- ---- -- ----    --   ---  -- -     -  - -       -    -   -
-- - ---  ----  -  -  - - -  -   -        - -          -  - -      -  -     --      ---  --   -  - -
-    -           - -  --- -  -  ----  -  -- -- --        --  -     - - - ---    -     - -       -  -
-      -           -   -   --       --- -       - - -   --   - - - -- -        -   -      - -  -  --
-   -   ----     -      --     -   -- -         -   --           - -   --    -   -   ---   -  ---  -
- -  -  --       -       ---     --  --       -  -   ---  --   -   -    -  - -  --  -  -  -  - - - -
-- -  -         - -        --      -  - - -  - -   - -      - -   -      --    -   -    -     --   -
-    -     -       -  -  -- -   -  -         -   - --  - - -  -- -        - -  -  -    --     - -- -
---  - -     - - --   - -- ---   -  -  -       -    - - -- -  -   --- --         - ---   --    -   -
-     -    -       -- --      -  - -  --       -        ----- -   - -      ---    -    -  - - -    -
- -  --  --   -  -        - - - - - -  -  --- -  -  -       -         -      -    - - -   -     - --
-  - -  -   -- -    - -- - -   -   -  -  - -    - -   - - ---      -   --  - - -  -    -  ---      -
--  -    - - -   -      -  - - - - -- -   -   -  --             --  --   -    - ---- --     - -    -
-- -   - -   - -- - -      - -    --  --    - --  --           --  - - - - - ---   -      - - --   -
-  - -  - -        - --   -      - --    --  -      ---  -  - -      -  - -   --     - -   -   -   -
--   ---    - --- -   - -    --   -        -  -               - -   -  --  -- - - - -- -- - --     -
- -       --     -     -   --   -  - - -- -    -   -   -        - -   -   --  -   -     -    -  -  -
-    -- -   -  ---    - -       - - -      - -- --                  -  -  -     -     --   -- -    -
-- - - --  -  - -  - -- - - -   -   - -    -   -   -   - -       - - -   -    - -    --  - - -- - --
- -      - -  --  -  --    - - -    -   -  --    -  -    -     -  -    -   -     --    --  -   -   -
-      -- - --     --   - - --    -  --        --   -     - -- ---  - - --     -   -     --        -
-    - -  - - --  -----       ----  - -     -  - -  -      --            -  - --         -    -    -
-                -     - --  - -       -        --  --     -- -- -   -          -  - -          -  -
-     -   ---     - - --  --   - - -    --- -  -      -- -   -  ----   -  -  ----     -   --- -  - -
-         -                       --  - -       -          --  -    - -  ---  - - - - -       -  ---
-- -        - -  --   ----   - -   - --   -   -   -- -  -     --     --   -       --     -  -   -  -
- -   --    - -- -  -  -  -         --    --     - - --  -- -      - -  -  - -  -      -   - - -  --
-    - -  - --     -    -   -  -     -       -  -  ---- -        -   - - --   -- --- -     -  -  - -
-  --  - - -  -  -    -      -- -  - --    -   --   -- --       -  -  - -  -    - -  -     -- -    -
-   -  -   --  -   --- -     -   - - -         -   -   -  -  - --   - -  --- --  -   --  --  - --  -
-        -           - ---- -  --       - --     - --- -       ---         - -     -   -  - -    - -
-        --   -- -- -  -  - - - --   --  -  -     -  --  -  - -           - ----  --     - -  -    -
-  - -       --      -   -  -   -            -   -     -- - -     -        -       -    - -   - -  -
-  -     ---               - ---  -    --          -          -  - -    --   - - - -    -       -  -
-  --  --     -- ---- - - -        -  - - -      -  -  ------    - -  - - --  - -     -   - -  - ---
-   -  - --- ---   -    -  -  - -         - -    --  -  - -     --    -    --  -  - -- -  -      - -
-    -- ----   - -  -- - -    -     --  --     -- --   - - -        -     -      -           ---   -
- --       - -        ---       --   - - - - -- -   -     -  -  - - - -  - - --    --     -        -
-  -  -   -         -     -  -        -        -  --  - -   -   - -     - -            -  --  -  - -
--  -    -      -     - -  -- -   --   -   -  --  -  -       -    -      -  ---- -  -   -      -  --
-  -  -  - --  -      -   ---   -    -- -  - -- -   --  - -  -   -   -    -    - -   - -  --   --  -
--               -    -     -  -  --    -    --  - -- - -  - - --   -- -        -     -   - -      -
- --   -    - -  -       -- ---- -  ---       --       -   -- -     -  - -    -     -  -  -    -  --
-  - --    - -   -     -     -       ---    -      -   - --  - --   - --    -     - -          -   -
-- -- -     -     - -- --     -  -   -      --     - -   --  -       - - -        -     -  -     ---
--      -  -  -     --      ----  - -  - - -              --   -  - - - -    --     --     - ---   -
-   --  -     --   - --   -       -  ---     --- -      -- -- - -     -  - --  -  -     --  -    - -
--  -  -   -  -   --  -----   -    -   --          - - - - -     - - -      - - --  - -    -  --   -
-   --  - -        - -  -  - --- -  -- - ---   -  -   -   -- -  - -- - -- --- -    -  -  -         -
--- -      -     - -   --  - --- - -    --        -  -  - -     - -           -- --       -      - -
-  - -  -   ---   ---  - --   -  -    -- -  -   -  -        - - -        -      -     -        -   -
-- - -- -  -               -    --  - -- - -   -- -   -  -  - -  -- -  -     --    -   - --  -    --
- - -       -  - -      -- - -   -      -      -- -          - -    - -   ---    -     - - - - -   -
- - -    -   - - - -                - -  -     -   - -      -     -    -    -  --    - -    -      -
-- --      -- -- -- -   --   --   - -  -              --      --         -        -  -       --    -
-    --- - -    -    - - - -     - -- -   -      -   -  -    - --- -  -     --  -    -- --         -
-   -- - -  -    - - -    -  - -            -  -      -   -   -           -- -   -        ---   -  -
--     - -     - ----   --  -         --       - - -     -  - -    -  - --    -- -  -  -   -- - -  -
- -   --     - - -  -  -- -    -    -    - --       --      - - -       - - --     -        -    - -
-        - --      -      -  - -    - -  --  - -  - - -   - - - - -   ---     -   -  --   - ---- - -
-- -   -       - -   -- -   -   --    --   ---  -    -   -     -         - - -  - -      - -    -  -
--       - - -   -      -    - - -      - - -      - - - --   -    - -  -    -     -   - -  ---    -
-  -  -  -   --   -  -    -    -- -  ---   --  - --   --- - -     -  -  --- --- - -  ---  - -- -  --
- -  -    --  -       --      --    -    -   --   -- --  -   -   - -    -     -         -          -
-  -- - -      ---           -  -  -   -   ----      - -   - -- -  -  - - -     -  - --      - -   -
-    -  -  - -     - - -     --  - -             -     -       -  ---  -      - ---- -     -     - -
- ---  -  -      --       -   -   ---  -- - -- - --     --- -  - -  -  -   --    - -         -  -  -
-    -  -   -        - ----    -  -        -  -- -  -     -       --   --    - --        -  - -  - -
-   -   --      - -- -- - -              -   - -    -  - -  -    -   ---     ----   -- -  -        -
- ---     --    -  -   -     -   -- -  - -     -  --  - - -  --    -    -   -        -  --    - -- -
-     --   -  -- -   -   - -           -- - -   --  -    - ---     - -  -  -  - - -   - -   -  -   -
- --  -  - - -  -             -   --     -  -  - -  - -  -- -  --   -     -       --  -           --
---- - -     -  -  --   -  --    -- -    -     - - -    --   --     -   -     --    --  -        - -
-  -  - --  -  -- - ---   -  -   -  -                   -  -     --        - -  ---- -   -- - --   -
-   -  -  -  --          --  - --   -  ---  --- - - -     -  -- -   -  -      -  -    -  --     - --
--      -    -     -  ---        --                   --- -  -   -     - -  ---   - -       -    - -
---  ---     -   -  -   - -  -  -   - - -- - --- -     -   --- --- -- - -   ---            -  -  ---
--- -      - --      -         -      -    - - - -  -  --         -   -     --  ---   -   -  -  -  -
-       --     -  -- -   -  -   -    -  -  --   -    -    - --  - -       -     -   - -       - -  -
----      - -  -      -         -   -    -   -- -   -    --- - -  -   -- - -   ----  --          ---
- -   -      -    --   -   -    - - -- -       - - -  -   -  --   -   -    -  -   - --- --  - --   -
-         -  - -   - -    --      -- - - --   -  - -   --   -- -   --  -- - -  --  ---     -  -   --
- - -- --   -    -  - -   - - - -    -     --       -- -  --      - ---      - ----  -- -  --  -   -
-      -      -   - -   ----- - - -    -  -     - -- -   -  -     -    -  ---  -  - -       -  -----
-    -  - - --  -   -     -     -   -- --    ---    -  -    - --- - -        - ---           -     -
- -  -  -          - - -  -   -       -    --   --- - - --   - -   -       - -   -   -   -    -   --
-- -            -  -  - -  -   -        --   --   - -  -    -     -------- -   - -   ---  -       --
--  - --     - - -- -   -       -   ---          -  -   --                 ---       -     - -    --
-   -- - -     - -    --  - --    - - -  -   - ---    -      -  - - - -- -- - -  - -  -  --  - - - -
- -   -   - --   -   --   -   - - -  -   -   -       -    -    -       -  -    -                 - -
- -  - -    --  - - -    - -    - - - - -  - -    -  - -    -  ---- - -   ---  -     -  - -    --- -
-           - - --   -- -     -     ---    -  -        - --        -  --          --    -          -
-     --   -- - ---   --    - --      -    -     -     -      - -   ---   -    -      - - -      - -
- -        -          -             -        - -   -    -  -      --   -  -            - --  -  -  -
----------------------------------------------------------------------------------------------------
