100
100
----------------------------------------------------------------------------------------------------
-  -         -     -    - ----    --      - ---     -   -     - - - --     - -- -             -    -
-   -    -          - - - -    - --  -  - -  -  -   -     -   --       ---  --      - -   --     - -
-    -    -    --  --      - -- -        - -  -    -           -   ---        - -   -   -   -----  -
- --  - - - -- -      -   --   - --   -   -     --    -  -- ----   --- -     -     - --    ---   - -
-    -   -   -     - --- -  -    --  - - -  - -  -    - - -      - -   -        -      -       -   -
-   --    -    - -  -   -  - -    -   --   -   --               - -   -    -    - - -     - -    ---
-  -    -  -          -       -    --     -- --     -  -    - -  - --   -   - -  -- - - -   -     --
- --    -   - - -      -- -  -  -  -    -            -       --  -   --      -   - -  -  - -  --   -
-  -   -    -       - - -    --  -----    -   - --   - -     -      -         - - ----  --      -  -
--   -     - -   - -- - - -        - -   - -   --             -  -  --- -- -- -  -   -     -   -   -
-   -  - -   --     -   - -    --    -         - -        - --  --          -  ---- -- - -  - - -- -
-   -  - -  --        --- -- -  -   -      --   - -    - -    --    --  -  - - - - -      ----  -  -
-  -     - -     -    -   -  - -----  --  --  - -- -- --   --  - -        - ---    - - -- -      - -
- -- -        - -    - --                -  --    -     -  - --   --   -    -  -   -       ---     -
-      -  --    -     -       -     --  --  - -         -  -    -   --   -   --   -  -   -     -   -
----   - - --     -  -  -   - -  --              -  -  - - - --   -     -     -     - - - -   - ----
-      -  --  -   -     -   --   - --  ---  - -  -       -  -  -      -   -      - --        - -  --
-       - -  ---       - - -      -    -      -     -  --   -   - -  -    ---   -    -         --- -
- - -  --- -         -         - -      -- -  -       --  --- -        - -     -        -  -       -
--     -    -   - -- -  --   --   - -    - -     ---    -  -    --  -  -  -           ---    - --- -
-  -   -      -  - --          -         -      --  -    --  --  --   -     --- -  -  -     -     --
--  -   -   - -- - -- - -           - -     - --   -     -    - --   ---   -  -  --  -- -    - --  -
- -  - -    ---     --      --  - - - -  -  - -- - --     -----  ---     -  -     - -  -    - ---- -
- -     -        -    ---- -  -          -       -  -  -  -       -    -  - -- --    -  --  -  --  -
--  -        --    - -   - - -- -- -  -- ---   - - -   - -  -    - -- -    --   -         --  -    -
- --        -  -- -        -- ---   --          - -  --      - -        - -      --- --      -  - --
- -  --     - -        -  -  -  - - -- - --     -    -    -       -       - -             -   - -  -
- -  - -  -   -       ---  ---    -       ---   - - -   --         - - --     -  -   --  - -    -- -
-- -  ---        --   --        -     ---         - - - -  - - --     - - -- -            --  -    -
-- -  -        -      - -- -- -      -   -    - -    - - - -  -        -  -   -  -- - -   -     -  -
-   -    -      --- -   - -    -   -     -- -    -     -- - - --- -  - -     -       -- -      - - -
---- - - -  -      - ---   -   - -  --  -  -    -   - -      -  -    --         -     -- -- -   -  -
--   -       -   -  -         -        -        - --    -       - -    -      - - -- -   -- ---    -
- - --       - --       -       - -  - -      - - -      -    -  -        -     -- -  -          - -
-       -  -    - -         -   -       -- -  -      -         - -  -    -  --  -        -    ------
-  --  - - - - -      -  ---    -- --        --    -  --           --     - - -  ---  - - -     -  -
- ---    - - -    --     -    - -       - - --  -           ---    - -      -- -      -  -    -   --
-       --- -   - -  -         -    -      - -- - --- ----- -   --     -   --- -    -    - -     - -
- -          ---- ----- - -    - -     -     ---   -  -         --        ---  - - - -- -----   - --
- --    --  ---  -     --     -- -  -     - -    -         ---     - -     -  - --  -  -    -    - -
-  -- -      - -- ---      - --  -  -  -     -  - --   - --      - -   - - --- -      -    -  - -- -
--      -  -- -  -       - -     -     -   -  -    - -  -  -      -  -- -     -   -    ---  ---    -
-   - -   -  -        --- -  - --- - - - -  -  ---  -   -- -    -  -  -    -- -   -- - - --   - -  -
-   -- -   -  -   -   -  --        - - -- --       - - -     -    -    -- -  -                    --
-    ---  -  -    -- -  --   --  - --  -  -    - --  --- -    -    - - - -    --       - -   - -  --
- -       --  --  -   --  -       -- -   - -   --     ---   ---    -     --       -   -   -    -   -
--  -   -  -     --      - - --- -  - -   -      - --     - -      - -   - - -   - -  - - -        -
--  -     -      -  ---  -     -      -- -  -   - -   ---  -  -      -- --    - --   -   - - -  -- -
-      ---    - -  -      -        - -       -     --   -   ----   -  -          -   -- --    -    -
- - -- -  --  --      -     --- -- -  -  -    -   -  -- -   -   -   - -- - - --          -    -    -
- -      -     - -   -      --    - -  -  - -    --     -    - -   -- -   - -        - --  - -     -
--- -    - - -  -  ---  -               --   -       -       -   ---- -   -  --   -- - - -  -      -
-       ---   -      -  - - - -     --   -  -     - -    - -      --        -  - -  -   -  -       -
-- -- -- -- -  - --  -   -- - -- -     -   -  -      -  --  -- --       -  -     --    -  - - --   -
-  -  -      ---        -  ---  -     -     -   - - -   - --   ---  --    --  ---    -   - --- -   -
-     - - -  - - - - --     -   -   -   -  -  ---   -     - --          -         --- -      ----  -
-     -   -         - -      - -- - -     ---    -  - ---    -  -   -    - -      -   - - --   -   -
-   -- - -    --    -           - -  -             -        -   - -    - --- -- -        -    --   -
-        - --  -      - ---        ---- -   -  - -   --- -        -- -  --   -  --   --   - - - - --
- ---     --       ---    -   - -   -     --    -  -     - -   -   -           - - -       -  -    -
--  - -  -   - ---   -  -  -----   - -   -  --   ---          -    -     --- - - -   --  --      - -
-      - --  -       - - - -             - --  -     -    -  -    -   -         -   --- -- - --- - -
-           -   -          -   ----     --    - ---   -  -   -      -- - --- -   --   --  -   --- --
-    -     - -   --- -- --                - -    - -    - ---  -  - -     -  - - -  - - -   -- - ---
----    -   -           --    --  -   -- - -      -   - -- -  --- -  -- --      - --   -  - --- - --
-     -   -  - -    -         -  -      -  - - -- --  -   -       -       -      -    ---  - -     -
-- -   - ---   -      -- -  -  -  -   - -- -     --- -- --- --  - -  -          -     -  -    --  --
-   --  - -- - -  -  -       ---     - ----- -  -     - - -- -   -  ---       -            -     - -
-   - -     -           -  - -   -       -  -- -      - -   - -               --  -      --  -  -  -
-  - -            -     - - - -- -  -        -   -  - --   -   -  --     -- - -  -    -  - - -     -
--     - - -   - -   -         - -    -- -  --   -      --- - -   -  - --     - - - -- --        - -
- -      --    -   --  --        - --  - -      -  ---  -       -    -   --       -- -         -- --
-  -     -  -         - --              -  -  -       - -     - -     - -  -- - -  -  -- -        --
-    --   --      -   -    ----   - -   -        -    -      -- --       --   -  -  -  -    - - -- -
-- - -- -    - --  -   -  -  - -   - - -     -      -   -     -    -  -       -          - - - - - -
-  - - - - -  -   -    -- -  --    - --  --- -  --  ---     -     -      -       - --    --  -  -  -
-  -    -  --- --     -  -     - -- -- -  -- -   --  -  -    --- - -  -         -  --     -- --   --
- - ---   -   - --         -- --       -  -- -- -   -   --   -  - -- -    -  -   -    -         -  -
--        --   -     - -      -    -     -    ---     --  -    --       -- -     - - --   -  -   - -
--   -  -- -       -  - -   -   - -  --  - - ---- - -  -   - -  -  -  --   ---  - -         -    - -
-  --   - - -      -  -  - -   -    -- -  --    -  -     -   - - - -  -  -       -- - -  --     -  -
-        -   - - -     - - -     - -  -- ---       ---   - -   -      -  -           -  -        ---
-- ---  -      -  -   - -   --     - --- -  -  - -  - -    - - ---  -- -        --      -- - --    -
- -         - -         - --    ---       --  - - -- - - --- -  -        - -   --    - --  - -    --
- ---    -- -      - --   - --            --  -   - -  -- --  --- -   - -  - -      -    - - -   - -
-  ---     -  -         ---     -      -   -      - --  -    -     --   --  --    -   - --    --- --
-  - - -- --   - --  -     -   -  --- -     --    -  -  -  -  --  - -    -      -  -   -  -  -   - -
-   -   -       -     -----   -    -          -- ---   --      - -      - -    -   -    -    -  -  -
-      -  - - - -    -  --- -      - --     - -     -   - - -       -- - -   ---    --  - - --  - --
-         -  - -        --     - --       -   ----    --- -      ---      - - -  - - --   -   -- ---
--  -       -   -    -   --                        -   - -     -      -             -- -  -        -
-           -  -   -   -   - --    -  -        ---  -    -  -             -      -- - --   --    - -
- - -  -    -  - -  -  ---      -   - --   - - --  --- -    - ---   -  -    -      --    -   -   ---
---         -        --     -     --  - -  -     -    --  - -  -  - - - -  - -  -    -         -   -
-  - -         -- -            - --   -  -  ----  --- --   -        -     -  -- - - -   -   - - -  -
--   -       -    -   --  -     -  -    --- -   - -       -- ---      -- -    -      --    - -- ----
-    -- - -   - - - -- -    -    -    --   -   - -  --   --   -  - -- --  ---   -  -          -    -
-   -             -   -    -      -          -   -   - --   -- --   - -       -  -   - -     -     -
----------------------------------------------------------------------------------------------------
