100
100
----------------------------------------------------------------------------------------------------
-         -  - --     - - -   -  - - -    -- -  -  -     -  - - -------             -      -   - - -
- -    -     -- --        --  - - - --  -    -  -    - --  - -   ------ -   -  --    - -  --- -    -
-  -  -  - - -  - -   -        -- - --   --- - --        --    ---  -      -  -    --          -   -
-   --  - --  --    -    ---  -  --- -  -  - - -   -      ----         -  -     -     - -    - -   -
- -- -- --   -  --           -     -   - -  --- -  - -  - --- --       -    --   -- -    -     -  --
- - -  -  -   -             -  -- --  -  - -  - -     - -  -     ---  -    -  --   --- --  - -- -  -
-   -     - -  --     - ---  -  --- ---   - --   -  -     -         -       -   -              -   -
-  --      -  -   - -   - - -   -  -  -   - - - --   -   -  -   -  -   -  -   -   -  -    -  -- -  -
-       ---   --    --   - ----- -   -  -      - -     -- ----      -  - -         -   -  - -   ----
-   -     --   - --- -             -        --  - ---  - -       -   --  --   -     -     -   -  - -
--  -  --- -- - -   -      --                  -   -   -- -  -   -      -              ----  -  -  -
- - -   -    -      - - -   -  -   -   ----    - -   - -    - --- - -      --- -  -         ---- - -
- -   -   - -       -  - --      --  --      -  --     -- - --  -   -    -     - - -   --       -- -
- -  - -- -  -  - -  - - -       -   - -    -- -- - --    - ----    -   - - -        -       -  - --
-   -  - -   -     - - -- -- - --     -  -    -  - - - - - -     -   -  -   --  -- -  -- -- ---- - -
-  ---  -   -  -- - -  - -   - - -  --    --   - -     -   -  - -   -      - -     -  -  - - -  -  -
-- -  -  -          -  -  -             - - -     - -    ---  - -  -  -     --      ----       -   -
-    -  -   - -      -  -  -     -   - -      - -  -- -  -     --         -       - --   -   -    --
---  - -     - -  - -     -  - -  -- --    -- - --     -    - -     -  - -  - --  -  -  - -  --   --
-  -- -     -- - -   - -           --  -            - -  -- - -- -   --   --       -  -    - -   - -
-     ---          - ---     - -          -  -    -    - -   -     -     - -   -         -   -   ---
- -  -          -  -  -    -  -   --  -   - -           - --         - -     - -     --    -  - -  -
--  -   - -        ---  --  -  ---   -  -   -   - -   -    -    -   - --    -        -   -  -    - -
-       - --           ---         - -- --  - --     - -   -   - -                    - -  --- -  --
-  -      ---  -     --  - -   -  - -    -   -- --      -  -      -   --  -- -      -    -  -  -   -
-- --      -           -   - -           - -      --  -      -   --            - --        -     - -
-      --  -       - - -   -       -   - -  -- - - - -     - - - -   - - -- -        - ----   ---  -
--- -  - - -   --  - - -    --  --- --   --  --    -  --    -- - -   -  -  --             --     - -
-  -    --  ---  -   - -  -   -  -           --  -        - - - -  -  -   - -   --   -           - -
--    - -       -  -   - -         --  -  --   - -  --  -       - -   ---- -   - -    -  -   -   - -
-- --    -  ---  - --- -  -- -- - -- -        -- -        -   -      -   --  -     - - - -  -- - ---
-    -        - --    -   -- - - - -    - -- -   -     --   -  -  -    - -      -    --      -    --
-     -  -    -- -- ------   - -  -       - - --   - -   -      --      -  --      - -    -  - -- --
-   - ---  -     -         - - -    -     - -   -   -  -   -      -    - -   - --  - -   -   - -   -
-   -  --   -  -    -  -   -- -     - - - - -        --- -    - -  - -   -     -    - -   - -    - -
- - -- -  --    -    -  -    --   - --   -- - - - - -    ---    -  -   -   -     - --   -- -  -  - -
-   -   -   ---  --   -- -     --  - -    -     -     --    -   -    -   -     -      -   -  ---   -
---     - - -      -    --  - - -- -                 - - ---      --- -      - - -- -   -   -   -  -
-- - -        -  -    -    -  -      -  - -              - -----    - - -    --   - - -    - -   - -
-  -   --   -- -     -     -   -   -  -  -      ---- --- - -   - -          - -  -- -  -  - -  --  -
-       - -      ---   -       - -  --   - - --       -   -   -        - -   - -    -   - -   - -- -
-  - - -  - --         - -          - -      -     - - - -       -       -            -  - -   -- --
-    - - -- -  -  -  -            -- -   -         -     ---   -  -  -  - - ---   -         -  -- --
-  - -  -  -   - -    --   -          -  ---   - --    --  ----  -  -  -       - - -  -      -- - --
-        --   -   --  -    -- -  - - -   -      -   -- -  -   -              --   -    -  -     - --
- -  -   ---- - -         --  --  - - --  ---   - --     - ---   --  --      -     -    --  - -  ---
-- -   -   -       -        -  - --  - ---   -  -       --    -     -  - - --      -   --     -    -
-  --       ---  --   - -   - - --    - - --     --   - -  -      -  -   -      -   --     -   -  --
-      -  --     -  - -  -    -       ---    -     - - - - -    -     - -   -      -  - --  -  -  --
- -  -        - -  - -  - --     -- -       -  - -    -    - - -  ----- -        -     -  -  - - ---
--      --  - - -  -  -  -          - -   -           -        -  -    -   - - - -    -    --- - ---
--  -   - -   -- -          -- - -        -  --      -    - -  -   -  -   -   -  --- - -     -   ---
-    -   - -          -   - - -   -  --     -  -  - -   ---       -   -  -   - ---  -  -  -   -    -
-       ---    -  -  - - - --  -  -    - -  -    - -    -     -    - --    --       -  -- -        -
- - -- --  -     - -  -  - -       - -   - -     - -     - -  --       - -    - -  -        --- ----
-     -      ---  -    - -  - --   -      -       -             -        -  -   --   - --   -      -
-    -           -- --   - -     - - -     -  - - -   -      --  -    -  - --- - -  -    --  - -   -
- --   ---   -- -  -        --      -     -   -      --    -   -    -      -  -    --   -   -   -  -
--  -  - - - -    - -   -  - -  - - -          -   -   -   - -  --  --  -- - --     ---         -  -
- - -   - -- -   - - -     -- -     - - -     -        -      --   -   -       -   -    - -        -
- -- --  --      -  --  --   -    --- -- - - -   - -   -   --   -     -   ---   --   --       -    -
-      ---  -   ---      - -   - -  --     -    - --  - -- --      -    - -  -- - -- -   -  ----   -
-  -      -- -    - -       -- - -  - -     - --        -  -  -              -- -  - -  - --    - --
-     -      -  -     --- --       -   --  -  -    -    -  -    - -  -      -   - - -     ---  -   -
-  --          -  - - -- - ----      -   -    -- - -       -        -  -- -    --  -        -  --  -
-  -  - -  -   -    - -  -   - -  ------- ---   -     -    -- - --           --      - -     - -   -
-      --    -   --  -  --  --  -       -     - -     -  -   - -  --  --   -  -     -- - ---- -    -
- -  -      - - -       ----- --  --  -  - --- -  -  --  --           -  -  --   - -    -   - -- - -
-   - - -  -  -  --  -     -      -         -      -  --        -   - -   -  - - - -- -    -  -    -
- --  -   -- - -     - -  - --  -          -      --  ---    -  -          - - - -  - -  -  -- -  --
-  - -  -   -          -- -       -  - - --    -    -   --     - - ---  --  -  -      -         -  -
-   - --  - -  --   -  -      -   - - -   -       - ----    -  -              -   ---   -     --- --
- -           --      -    - -    -   - -- -  ---  -   -  - - -       -     - - -    - -        -  -
-       -- -   -- --    ---   - - ----    -  --  -       -- - -  - - --    -    -   -  ---- -    - -
--   -      - -  -   --     -    -   -  --      ----- -   --  -     --   - -    - - ---      --- - -
- --  -   --      --   -   -       ---- -   ---     --   -        -    --     -- -  -   - -        -
-      - - - -     --  -      -     -   -   - -    -- - ----   -  --        -     -        -       -
----  -  - - -    - -     - - - -            -         -      -      -  -- -  -- -      -      -   -
-  -     -  -- -   --   -        - -       -  - -        --   -  - -- --  -  - -  - - -     - - -- -
---  -    --    -               -   - --  -- -  --- - -      ---  -    -  --    --               - -
-         - --  -  -   --    -  - - --  -    -  -    - -         -  -    ---  -- - -   - --   -- - -
-     -   -   -   - -   - -- - -   -   -   -   -   -      ---   -      ----  -- -     --    -      -
-        -     - -   -       -  -  ----      -  - --     --   --    -     - -   --- -     -  -   - -
- -    -          -- -  - -  --   -   -    --      - - - - --   - -  -        -       ---    --    -
-    - ---    - -- - -----     - -  -        -  -----     - --         -- -               -  -   ---
--   - -  -      --  -  - -  -     - -   -   -   - -      --    --   -     - - -    -  -- -     -  -
-    --    - --  -    -    -- -      -    -  - -  -    -    -      -    -- -  -- -    -  -     - - -
--- --   - - -   - -       - - -  - -   -    -- - -      -       -  - - -  -           -  --       -
- - -       -  ---  ---   -     -    -      - -   - -  -  - -      - --  --- -    --   - -  --   - -
-   -      - --    -  --  --  --           - - - - - ---                       -   -- -  - -     ---
-  -    - -    --           -   -  -           -            --    --   - --   - -   -- --  -    -- -
-    ---  -  --  - ---  --- ---   - -  -  --  ---  ---  -     - --  -      --   -        -  - -- - -
- -       -   -      - -   -   -   -      -- - - -     -  -  -    -       ----- -       -  - - -  --
- -   - -   - -       - ----  -- --  -  - -     -  -  --   - --     --      -  --   - -         -  -
-  -  - -  -        -  ---- -   -- - - - --   -   --  -        - ---  --     -   -    - - -  -  -- -
- -       --  -  - -    -  --    - --     -  - -  - -     -      -    -   ---     --  -- -  -  -   -
- - - -----    -- - -     -  -  -     - -   -           --  -   -  -  -    --  -- -  -        -    -
- -  -     -            ---  ---    -     -                - -  - --  - -    -    -           -- - -
----------------------------------------------------------------------------------------------------
