100
100
----------------------------------------------------------------------------------------------------
-   - -     -  -   -          -  -     - - - - - -  - -             -  - - - -    --    - - -      -
- -    --   -    -         - -- ---   -       --   -     -  --  - -   -     -           - -      - -
-     -      -    -     -- -    - - --      --  --    -     -   -  --   --   -     - -  - - -  -   -
---  - -  -   -   -- -       -  - --  -   - -     -  -     - --      --           --        -    - -
-  ---  - -          -  -           --  -  - ---  -  -     --  -  - - - -  -   -    -    --   -    -
- --  --   -- - - -- - --  --    -   --- - - -   -  -  --  -  -   --- -      --   -  - -     - --- -
-   --        --    -   -   -       -- - -  -  -             - --   -        -        --  -   -    -
-  -    -    -  ----  -- - -  -  --      - - ---    -  --  --     -     --- -  - -    -     -- --- -
--      - --        -     - -  - --    -- -    -   -      - -  - --   -   ----- - --       -       -
- - -    --  -      -     - --    - -  -  -         -  ---    -- -      -         - - -- -   -- ----
-    -     -  --  -   -  -  -   -     -   --- - - -   -  -  --  -     -     -   --  - ---       -  -
-          -      -- -    -  --         - -  -      -     -    -   --   ---    -              -   --
- -  --    --        -- -  -           -- --   -- -   --   -  - -  --   --  -   --  -          - - -
-  -  -  -   -          -  -- -   -- -     -    -  ---    -  --  -   -            -  -    -  --    -
---  --- -     - -                    -- -  -     -    - - -   --  --        - -    --       -   - -
--   -   -  - --  --   - -  - ---- - - ---      -    -      - -         - - -     --   -   - -     -
-       - -        - ---     -  -  -  -   -   -  -    --        -         -  --    --  ----    --  -
-   --  --  - - --       - -  -    - -    --      -- -  --             -  ---   - -  --  -  -   -  -
- -   -   ---      -  -      - --           --- -      -  -      -    - - -  --    ---  -   -      -
- -    -   ---             - -    --- - - -- -     --      - - -      - -   --  - --    - --   - ---
-     - - -  -   --     --      --  --   -    -     -   --   ---      - ---   --  -  -      --- - --
-  -   - -- --  -           - -       --   - -   - --- -- - -     -    -        -  -     --   - -  -
-   -      -      -  - -  -  - ----   -   -- -  - -- - -      -      -     -  -     - - -     -  - -
-  - -  --      -  - -   --    - -  --  -  -   - - - -  --   --   - --    -  -  -   -   - -  -  -  -
--        - - --   - -      --  - -          -       -          --  -  -- --  -    -  - -  --  - ---
-    -  -     - - -   -     -    -    --  -    -- -       --     --  --    - - - -      -       - --
--  ---    -- -  - - -    -  - -         -  - -  --     -    -- -       -   --   -     -           -
---  -- -   - -   - ---     -  --- -- -   - -- -     - -  - -   -  -    - --   -   --  - -     - ---
- - --          -     - - -      -        - - -    - -- -   - - - - -     -          -    -  - -   -
-  ---- ---      - --- -  - - -  -   --  -   ----     - -    -    - - -  -    - - -   -   --       -
-     --    -  --           -- - -  - -    - -     - --   -    -    --       - -    -  -       -   -
-  --   -    -       -   -     -   - -   -    -- ---    -   --  -   - -   - -          ---     -   -
-- -- - -  -      -  -  - -----  -      -    -- -   - --  ----    -  -    - - - -  - -       -- -- -
--     -  - ---       --    - - - -             - -         ---  -  - -      -   - - -    - -- -   -
-- -  --         ---           -  - -       -  --   -- -  -- - --      -  -  - - -     -  --       -
-  ---  -- -   -  -   - - -     - -    - -  -    - -  --      - -  -- -  -- --   -    -   -     ----
-      -  --          - - -  - ---   -     - ----- -  -   -  -         --  -   --    -     - -     -
-  - -- - - --   ---- --     -    - -   -   -    - -    -   -    --     - - -    -   -  --        --
--  -   --   ---     - -   -     - -   - --   --  - -          - - -        - -   --- -   -- - - - -
-       --    ---  ---         --- -     -  -    -    - - ---      -   -    -        -  -   -      -
--  --- -   -     -    -        -         -      --  - -  -  - - - -          ---        -       - -
- ---    --  -     --    -  -- -     --   -  -  -   -  -          -   -   --- --  -    - --  - -   -
-     -  -      -     - ---      - -   -- - -    -   -    --- --- -              -              -  -
-- - - -  -   --  - -     -- -  - --  -    --        -     - -      - -  ---   - -         - --    -
-   - -    - -      -           -      - -  --  - -   -  - -      -  - -    -    -    --- - - -- - -
- -     --    -  ---    --  --   -- -- ---       -  -  -  -  - -    - -       ---   - -    --      -
-  - -- -   - - --  - -  - - -            -   -- --  -----  - -   -- -          ---    -  --   -   -
-   - - - -       - - -  - -  -   ---- -    --- -  -  -     -   -   -- --    -  -      --  -   --  -
-  -           -    - -   - -   - -              --    -  - - - --     - - -     ---  - - - -- -  --
-  --- ---  -     --   -    - -    --- - - -  --- -     -  - -    --    -    ----  ---- --- -      -
- -    - --   -            - -           -  -- - -      -  -   - -  -- -  -   -  -  --        - -- -
- --- -    -       --       - --    -  ----    --- -  -     --  ---- -- -  --  -    - -    ---     -
- -     ---        - -    -  - -  - --      --   -------  -    ---  -         - - - - --    -   -  -
-         -  - --  - ----    - -        -    -              - - -  ---    - -   --    - --- -      -
-      --  - -    - - -  -   -   -  --   -  - -          - -  -  -           -        ---  -  - - --
- -  -            -       -       -    - - --   -      - -  -      --- -- -- -  - -  -   -  - - -  -
-   - - -      -- -- -    - --   - -- - ---  -   - --  - -       --         -     -   ----   ---   -
- -         -          -    - -   -- -         -        -  -  -  -     - -   -           -  - ---  -
- -   - -  -   -  - ---- -      --   --  -- --  ----         - -- - -  --  - -   --  -- -          -
- -      --   -  -    - --    --   -   - -  -   -          -       --          --  --      - -- -  -
- - -  -    - -  --    -    -    ---  ---    -                 - -- -   -- --        -         -- --
-   -    -  -  --     --       -   -       - -            - -   -   - --      -     -          - - -
- --   - -     - -- -     - -    --   - ------- -       -  - ---            - - -    - ---   -  -  -
-     -                   -   -   --    -     - - ----  -  -    -  -        -- - -- -  - -    -    -
-      -       -  - -- -  -  -   -  - -- - --- -     -  - --  - -         -  --             -    - -
-   - -- - -    - - -  --  -  --  ---  -    --- --    -       -  - -- -     --   - --     --  -    -
-  --   --  -- - - --    -  -    -  - --           -    -- - -        -- -  -    ---   - -   - --  -
- -   -  -  -           -  -   --- -   - -   --   -  -   ---  -      - -  ---  --   -    --  -   - -
-    -    -  --  - ---    - - -  -   - -           -   - -   -  -   -             ----    --- --- --
-    -   -    - - --  -  -      -        --  -         - -    -- -  - - -   ---    - - -         - -
-   -   - -   ---    - -  -       -    -      ---   --    -             -    -   -- -  --       -  -
--  - ---  -     -      - ---   -- - - -       -  -   -   -  -  -   -        -               -- - --
- -  -   --  -  --   -- -           -  - ---- -       -  - --      - --     -      - -     ----  ---
-   - ---      -  -  - -- - --  -  -   -  - - -        --    ---        -     -    --  --     -   --
-          - - -        -           ---        -    -- --  -- -   -    - - -           -- -    --  -
-  --    -                 -- - -- -       -     - -     - -  - -   -    -  - - -  -  --- -   - -- -
--   -      - -    -  ---    -  --     -- - - - --   -  --        -  ----  -- - -   - --    -      -
-  - -- -- -   ----    - - - -- --     - -  --- -  --  -   -        -   -    --  -         -   --  -
- -        - -     - -  - -        -     -  -    -       -     --  - -     --  - -- - -  --     -- -
-- - ----     - --   -    -    - -    - -   -     --       -   -  -  -  -                 - - - - --
-- -   -      -  -    -   - - -    - -     -- - -    -        -     - -   - -  -  -  --  -    -    -
-     - -  --- --    --- - ---    -      -   -   -           -      - ---    -   -  -   -         --
-   - - -  -  - - - -  -- -  - - -   -       -       - - ----        --   -- -     --     -   -- - -
-  - -- --- --          -     -     -  --  -       ---- -     - ---     --    - --   -       -- - --
- ---  --  -    --   - -  ---            -  -   -       -- -- -    -- - -  -  -              -- -  -
- -  -     -     -   --  -   ---     - -   -  -    -    -  -   - - -  - --  -         -  - - -     -
- -   - -- - -    --        -  - - -   -     -            - - -     - - - -  -----          -    ---
-- - -      -  ---   -        -  -- --- -     -  -  -   -    -    - -  -  --    -  ---   -- - --   -
-     ---    - -   ---   -  -  -  - -   -   -           - -- - -  -   -- -    -- --     -          -
- -  - -     -   -  - - - -       -    -     -  -      -      -- --     --     -   - - -         - -
-     -  ---  --        - - - -  -   -   -- - -     ---  -    -- -- -  -   ---  --    -- - - -  - --
- -- -- -     -        -        -  --      -   ---    - -     - -    - -       -   --- --    - --  -
-   --   - -   --   --   - -  --            -    -   -   -     -    - - -- --- -         ---  -   --
- --         -   --     --- -   - - - -   - - -  -         - -- -   -        -  -- --  -   -     - -
-   --  - - --  - --   -    -   - - - -   -  -  - -  -   -        -   -  --  -     -        --   - -
- -- -- -   -  --     -   -       -      -  - - - -    - - --  - -              - - - ---  -     - -
-- -   -  -- -- --  -    -    --- -- -- - -        -  -  - --  -- -  -    -     -- -  - -    --   --
-     - -          -   -   -     -  -        -   - - - - -   -   -  - -  - -    -  -        -      -
----------------------------------------------------------------------------------------------------
