100
100
----------------------------------------------------------------------------------------------------
-   -     - - -      -   -   - -      -      - -- -  - -----  -   - -    --  -   -  -  -   -   -   -
- -  -  - -   -- - -      -- - - - -- -     -     -- - -      -- -  -  - - --   --       -     -   -
-  --        -   -       -                - -   - - - - -    -  --   -   -     ---        - --- -  -
--         -   -         -    - -         - - -    --   - - -     -      -  -      -- -  -   -    --
- --  - - - --  - -     --  - --- - -  - -     -      -  -  -  -      - --     -          ---   - --
-        -  --- -- - -  - ---      --     -       -   -  -  -  - -  -      -  - -     -- ---       -
-      --       -            -- -    --    -      - -  -     -   -- --       - - - --   -- - - - - -
-  -  -     -          -      --  -       -   -   - -     -   -   --- -  ---   -   -- ---    -     -
- -      -  --      -       - ---   - - -  - -           -     -  -    - - - - -  -   -    --- --  -
--    - --       -- --  -         -- -  - -    -    --- -- ----    -  -- -   - - - --- -----       -
- --       --  --     -  ---      - -           -  --                    -  -          -    -   -- -
-      - --  -    -- -  -  - - -     - --  -    - --    -  -- --   -- - -  - -  -   -   - ---   - --
--     -   ---  -   -    -- -  - --  --      --  -- ---  -        - -  - ---           -      --   -
-        --    -      ---   -       - -  -   - -           -     -      -   -      - -    --  -    -
--      -  -   -  -   -       - ---    -   - -    -     --- ----     -  -  ---- - -- - - - - -  -  -
-  - - -    -  -   --- --  -    - -   -   - - -  - --  -    -   -    -    -         -  -        - --
- --    -     -   -      -  - -- -    ----- -                 --   -   - --- -  - -  -    - -      -
-   - - -   -  -- -      -       --       --  -  -    -      -  --    -     - -     ----           -
---         -- -     -  - -  - - -    --   --  -  -   --  -  - -- -      --  -  -- -    -    -    --
-  -- - - -        - -- -- -   - --- --     --  -  -    -   -  -    ----      -- -  --  - --  -    -
-- -          -        -  - -    -    -        -       -  - --      - --   -      -    --    --    -
- -  -   - --        --- -    --  - -   --     - - -      -  -   --- -   -  -   -  - -  - -    -   -
- -- --   -  -    -   -  -  -- -              -- -   ---  -  -      -  - - - -     - --- ---       -
- --  -  - -- - -   -        - --  --   -  --   - --  -  ---    - -  - -  -   -     - -  -      -  -
-  -     - -- - -    -  -           -- -   -  - --- - - -         - -  -          -- -- --       - -
-  -     -  - - --- --      -            -  --      -     --  -      -- -    - - -    -         -  -
- - -  -    -    - - -  - - -     -  -  - -  -   - -   -  --  - -   - -  -   -      -     -  - -   -
-  -   -- -       - -    - - -        -   -- --         -          -  -        --    -  -  --   -  -
-     --   -   -  -   -  -       -       --   -    - - -   - -  - --   - -- - -- - -  - -  -- -    -
--   - -    -  -    --        - -      --   -- -     - --       -- -        -  -    --    -  - -   -
- -- -   -  -  - - -   - --   -   -  -  --    -- -   -   --         -   -  -  - -      - - -  -    -
-    --        - -- - -     -   -    --     --   - -- ---  --- -   ----   --   --     -        - - -
- --   - -  -     - - -      --  ---  - --- --- ----      - -  -  -     - --- - ---  - ---- -    - -
-    -        -     -  -     - --   --       -  --  --          -- -  --    - -    -- -  -    - -  -
-        - -         - --  - -- --    ---- - - -         -     - -   --  - - -  -- - --    - --    -
--- -- - - -    -   - -       -    -       -  - -- -     -   --      -         -   --  -     -   - -
-           - - -   --  - -    - -  - -    -- --     - ---   -  -        -   -- -       -   -- -   -
---  -     -  - - -   ----   -      - -         -     --- -       -          -  -      -     -    --
--     -- -  --      -     -      --  - -  -- -    - -    -     - -      -- -   -     -  -  -  - - -
-  -         -  -  -  --  - --   -        - -        -   - -- -    -- - -    -         -   - -    --
- ----- -    -       -    -  - -- -       -  -   - -   - - - --       - --  -   -  -     -     --  -
- -- -----  -      -    -  - -  --  - -         -  -    --  -- -   - -       - - --   -  -    - -  -
- --     - -  -  -    --- -         -  -    -- -    -  -  -   -    - -      -- - -- - --    - -    -
-  --        -      -- -  ---  -  -- --  -    -   - -    --   -   - -    -         -        -      -
--   -- -  -  --      -     -- - -      -       -     -        -  --  --  - --  --  -  -      --- --
-  -   -   -  -  - -       -- ---      - -      -  --  -   -  - -        ---       -  -   - -    ---
-  -       -  -    --  - -  - -        - -- -    --    --- - --    - - - -   --    --   -  -   - - -
-    -  --  -   -     -          -- --- -   --      -            -  -   -- -        -  - -- -      -
-  - -   - -         -    -  -        -  -        -  --    --  -  -- ------     --  -  ---  - -  - -
-- -   -   -   --  -   - --  -  - ----  -   -   -      - -           -    --  - -         -  -     -
-   - -       -   - -  -- - - - - --- - -  -     ---- - -   --   -   - - - -  -  -- -   -  -   -   -
-  -  - - --    -    -   - --  -- --- -  --    --       - -- - - ---- -     -  - --  --   -   -   --
-   -  -    ---  -   -- --- -    -        -     -   -    -     --        --  -  --    -   -- --  ---
- - -    -    ---  -       -  --  - -    -    ---- --    -  --    -   -     --    -  -   - -    -  -
- --  -   ---     -  -  -       -        - - -    -   --- -   -     -   -   -   -  -- - --  - --   -
-     -   -     -- - - -    -  - --    -    -   -         - --           -   -   -  ---       - -  -
-  - -  -     -     - -    - -      - - -    -        --  -         -     ---   -  -  --  -  -- ----
-  -   -   -- - -- -      -  - - --     -- -  -- - - -- --   ----           -  -   ---      - -  - -
-    -  -       -   ---  - - - -      --    -     ---    ---  -- -  -      - -  -         -  -  -  -
- --- --- - -  -       --    -- -         -    - -   ----   -    - -     -  - - --          ---    -
-    -  -   - - --  -- - -    - --- - - -   --            -   ---- -- - -  --  -    - -            -
--   -  - -  -             --      - -               --  -  -   - - -  -  -  -        -       -  - -
-       - - -  -  -  - - -  --         -- -   -    -          --     --  -  ----   --     --      --
- -     -  -        -         ----- -   -  -      -   - --    --  ----    -     -  -- -      -   - -
--    - -  - - -  --  --- --       -- - -     -  --     -- - -   --   -      -  -  --   - - -      -
-    -     -   -      -       ---      - --       - -        - --  -   - --       --   --   -     --
-   -  --         -   -        -     -     - -  -   - -    -  -  --  -    -    -  -   -   - -    - -
----    - - - --- -   - ---     -    -   - -----    - -    - -    - -- - -  -  - -   - -     -     -
-  -   -          --      -- - -  -            ---        --  --   -     - -  -  -    -  -  --  -- -
-   -- -- -   --   - --     -    -  -       -  -   - - -       -  -      -  -          -  -    - - -
- -  -  -   --     -    -  --  - - -   -- -   -    -  - -    - -  -    -- -  -- -  -  -        -  --
- -       --   -- -    --         -       - -   -    - -    -  -   -     --    -         -     - - -
-     - - -      - --    - ---          - --  - -     -         -           -  - - -           - - -
-     - - - -    --  -- -   - ------ -     -    -    - --         -   -  - --    --   -       -    -
-  - -  -  -       ---  -    -     -  - -   - - -             -   - -          - -    -   --    ----
-- -    -  -    -     - --   --- --- -  -       - -    - -  - -    -  - - - -      -- --    -  -   -
-    -        --         -    -      -   - - - -  -    - - -   -      - --   -     - -- -- -    -- -
- -       - -  -- -  --   - - -   - --   -   - -      --- -   -   -       -- - -   -   - - --    - -
------    -   - -  - -    - -     -  - -        -- - - -  -- -     --- -- -    - -- -  ---   -  ----
--    -  - -- - - -- -    -   - -       --  -       - - ---  -   -- -  -   -     -        -  --    -
-   - -  - - - -- - -       - -      - --  - -   ----  --    ---    --- -       ----  - -        ---
-  -  -- - -    --  -            -    -   --- -  - - -           - -   -           -     --   -  - -
-  -         - - - -  -     - ----  -- - -    -- --    --   -- --- - -  -   -  -----   --   -   -  -
--   --   --     -  -   ---  -    -    - -- - -- -  - -    ----   -- -  - -      -   -- -  -    - --
-   -   -    - -     - -   -  -- -         -   -  -  - --        - -     -  -     --  -  -  -      -
- -   - ----  -   --   -- --      -  -     -  --- - - -         -  --   --- - - --    -   -- - --  -
- --  - -  - - --   --             -    -           - -  -   -- - -  -    - -      - - -- -      - -
- -   -   -- --  --- - -   ---   - -        -  -- -   -  --    - - --   ---  - -  - - -    --      -
-     --  -- -- --  -  - - -    - --  - -    - - -   -       --         -  ---     -- -  - -  --   -
-   -   -  -     -           -   -  -- -  -   -   - -       -  - ---  --  -       -  -    -  -  - --
-    - -      --        --     -   -   -     -    --    -- -     -     -  ---    -       - - --  - -
- -  --    --        -    --           --   ----  --           -        --  - - --  - -   - -- -   -
- -    - --     - -    --   -                     -        -    -  -  -        -  --      --     - -
-- - --          -- --  -  -- --      -- -  -  -- -  - ----  ---      -     -    --  - -     -     -
-- -      - -       -   -      -   -- -    -     -    -   - -   -- --    -   - -     - -       -   -
- - -        --  ---     -  -   -  -  -   -  --- - -- -      -    - -           -  -   --- -       -
-  --  -  -     -   - -    -     -   -  - -             - - -           -    -  -  --      -       -
-  -- - -  - ---  -  --- -  - - --   -    -  - -   --  -  -       -   -        -    --   -   - -   -
----------------------------------------------------------------------------------------------------
