100
100
----------------------------------------------------------------------------------------------------
-            --- -  -  -    -        -   -      -- --  -- - --          -           --    --  - -  -
--      -        -    -  --- --            --- -  -            -   -       - -    -  -      -     --
-  -    - ---   --    -   -    ---   -   - -   --   -   --   -  -   -     - - - - -  --   ---- - ---
--  ---- -        ----   - -   --- -- - -  - - -  -  -    -       -  --  --    -        - -   -    -
-     - -  - -   -  -    - -- - -      - -- -    - -    -  - -  -  -   -  - -     -    - -  -   - --
-  -     - -  -   -  -- - -  -   -    -   - - --  -   -- - -- -      -   -- --- -    -     -- -   --
-  - - - - - ----   -  -- --   -- - - -    --- -   --   -  - -- - -   -  -        --     ---   -- --
-     - -   - -    -  - -   --    -  -    -   - -         -     -  -  -   ----  -   - -  -- -  -   -
-  --- -  --   - - -  -- - --   -- - --  -  - -  -- --      -- -- -   -            -         ---   -
- -    - -   -       --    --   --  - -       --  - -  --       -   - -   ---   -  - -  -  --  - - -
-      - ---        -    -   -          --   -    -    -   -  -   - -- -   -  --     -      - -    -
-   -  -       - -    -           - -     -   -    --   ----- -       -     - -    -  -- - -       -
-        -     -        -   --    -  --- -  ---       -       --   -----  -  ---    --       - - - -
-        ---  -     -   -   -  - -         -- -     -  --  - - -          - -     -   --- --   -   -
-- -     - - -   - -  --- -   - - - -----       -       --- -   -   -- -       - - - -      ---    -
-   -  - --         --        -      -      -       -        - -   - -      - --    - -  -      - --
-  -       --  -----   -------  --  - -   -   - -   ----       --     -     -  -  -       -  -  -  -
-  - - --    -- -   - -   -           - -- - - -   - - - - - -  --- -- --     - - - - -- --    -   -
---            -  --  -  -  -     -- - ---  -  --   -          -       --   -     - -  -     ---  --
-  -  - --  -     -      -  -  --        -     -    - -  -  - - -- -  --   -- --  - --    --  -  - -
-- -  -      --   -   -    -- -  -   -     -  -  --   -       -- -    - -  -       -    - --   -   -
- -   - -- -  -       - -                -  --      -    - -     - -  - -   - -     -   -  - - --  -
-  -- -    -- - -- -  -  -       -  -  -  -     - - -      -  - -       -   -    - --   -- -----   -
-- - - -   -   - -      ---  -  -  -    -   --- -  - - - ---     ---   - -   - --- --            - -
-    - -    - - -  -  -- --    - - -      - -  - ---           -   -  - -  - --   --     --  -   - -
-  - -   -     --- -- --     - -     -  - --- ---    - --  -     - -     -   -  ---     - -        -
- - -   -- -- -      -   -                   - -      - - - -- -    ---     -   -     -   - --     -
-     -  -  - - - --   -     - -  - ---  -  --   -  -- --  -    -      -  --- --          -     - --
- -     -       -        --   -   -      -    --       - -            -  - -   -  - -         -    -
-   --      -  ---- -  - ---     -   - -- -  -   --  ---  - - -    - -       -       - -- -- - - - -
-     --  -  -       --       - -  - -    - -       --   -   - -   -   - -  -    -       -    - -- -
-   - -- -    -- -      - - -    - -   -   - -   -- -            - -     -     -  -  -    - --    --
- -     -- - - -    --       -     -        - -  -    -   -      -   -     - - - -  -    - - -  - --
- -            -     -- -   -    -    - -     --   --       - -  -  - -   -  --- -- --    -  - - - -
- - -  ----      -     --       --   - -     -    -    -  -     - -    - --- -      -   -     -  - -
-   -     -  -  - -- -- -        -  --  - -    - - --  -      --     - -   -- --  -   -- -  --    --
- - -       -- -     --  -   -  --  - - - -      - - -  -       - -     -     -   -  -  - --      --
- -        -   - --  -     -  - -     -- -   - -- -    --- -- --  --  --     -     -      -        -
--     - -   --  -  - -  -      -   - -      - - ---                -  -  -   --- -  ----  -       -
-       - -  -  -    -   -  - -- --- -        --           --     - - -  -  -  -   -     -  -- -  --
-   - --- -   -  --     - - -- -- -     - - -- - -  --    -- -  -     -    -     -   -  - --   -  --
-   -     --        - -   - --  - ---   -   -  - --  - --  -         -      -  -   -  - -  - -  - --
-     - -    - -   - - -- -         -   -  -    -    - -  - -  - -         - - --  ----        -   -
-    -          --   -     -      -    - -- --     -   -    -  -    ---      -    -    -   -    -- -
-   -    ---  -  - -   --            - -  - -          - - - - - -- -  --   -   -- --    -  -     --
--    --   -   -    - -    --   -     --- - -     -    --  - ---               -     - -       --  -
--  --  ---  -  - -    -          - -   --     - - -     --   ----- - -- -  - -- ---          -   --
-    -     - - - -- -            -   -     - --  --    - -     -   -- -  -  -        --- - -   -   -
-      --  -     -   -- -- - -   - -    - -      - - -   -- -    -  -     --   -  - -    - - -  - --
----   - - -              -         - -    -  - -  -  -           - ----   -  - -  -- - -- -   --  -
-   - - -      - -  -- -             --- - -  -  -  -      - -        -    -        -- -  -  -   - -
- -      -    -   - -         -     - -      -    - - - -    --    - -  ---- -    -    --          -
--   -      --   -  - -  - --    - -  --   - -      -  -       -- - -   - -          --  -   -   ---
-   --  -      --  -  -   - -   - -  -    - -   -    -     - -    --  - -   --    -   -      --    -
- -  -   ---         ---  -   -         --     -   - - - - --    -   -- --  -----  - -   -    - -- -
-   -  -       -     -- -  ---  - - -  - -          -     -   - -     --   - - ---  - -- -   -   - -
- -   --           -   - --     -      --     - - -              -  --  -      -  -      - --  --  -
-  - - -    - -  - -  -   - - -    -- - -    -       -   - - - -  - --    - -   --   --   --  -    -
-  -   - -  -  --  -    -                          ---- -- - -   --- - ---- -       - --- - -- -   -
--   --   -   -  - ---   --   -  - -  -  --- -  - -- --        -   -  -     --   ---  -   -  -- - --
- -     -  ---   - - -- ---      - -    -         -          -   -   -     -      -  -   --   - -- -
-       -  - --  -   -           - - - - -    ---- --   - - -  -  - -      -    --- -  -  -   -    -
-- -   -- -- - -  --   - ----    -- -  - -   -    - -  -    -  - -                      -   - ---  -
- --  --- -      -         -  -      --- - -          -      - - -      - --     --  -  - -        -
-  - -- -     -   - -  -       --  -    -    --    -     -- -   -    - -  - -   -  -  -      -     -
-      --  --           --  -   -     -  -  - -    -    -  -  - -  - --    -    -   -    -    -   --
--  - -   -    -    -  - -  -   -      --  -  -       - -     -- - -    - - -       - - - -      - -
--    --    - -  - ---  -  -   - -  -  ---- -       -   -   -    --- -  -  -         --  ----    ---
-    - -  --  - ---    -  --        - -         -   - -  -  -  -   -   - --  - -   -- -   -- --    -
-  -   - -  ----  -  - -        -    --  - -              -   -  -   --   - -  --  -    -   -      -
- -  -  -  -  - --    -    -    -        - -  -   - -   -    - - -   -            -  -  --  -  - - -
---- -      - -  - - - -  -       --  -  -  -  - - - - --    -  -- - -  - -    --   -       -     --
-  - -  -  - -         ---  -- - -   - -- -- --      -   -- - -- --  - -   - --         -  - - - - -
- - -  - -- -  -   - -  -  - -   -   -     - - - - -    --- -   -  -   - - -   -  --- -  -     - - -
-  -  --   -    - - -  -  -  --   -   -  --      -   - -  -  -  - ---      -        -  -  -  -     -
- --  -  - -      -                 -     -    -  -   --  - -    - - - -     - - -- -    -       - -
-   -  -- -  --   -- -   -          - -    -   -      -       -      -       -    - - --      -    -
-  - -      - -      --       ---  -     -- --  -----   - --    - -- -      -  ---- -  -  - --     -
-   -   -   -   - --  - -        -   - --    -    ----          - - --  - -   -    -         -    --
- - -   - - - --   --    -  -   -  - --     - -  --       --   --      -       -     --  -         -
- - -  - -- --             -    -    -   --   --   --    --    -      --   - --    -     -  - -  - -
-    - - -     - ---   -  - ---   - ---- --    - -    --           --    -         -        - -    -
--- - --  - -  - -  -     -      - -       - -- -   --    - -      -        ---  - - - -        -  -
-     - - -   - ---   -  -    ---- -    -     -    -   -    ---             -   --   - -    -- -   -
--    - --   - -  - -    --   -   -  -   -   - - -- - - --            -  --               -    -  --
-        -- --  --    --    -  -    -          - -    --    - - -    -   -  - -- - -   ---- -- -   -
--- ---     - --   -         -   --     --  -   -   -     -   -           - ---- - - - -   -       -
-               -   -    - - -- -  --   --   -      --    - - -  - -   -- -        -      -    -  --
-  -- --    - --    -  - -  -    -   - - -  - -    -     -   -  -- ----   -- --   - - -     --   - -
--     - -     --     ----     --   -- --   -    - -    -       - -    -    --   - --     - - --   -
-  - --     -    --   -      -    - -  -      ----  ---         - - - - -      -- -        -       -
--   -       -  -            -  --  -      --     -            -  --        -   -    -      -      -
- -- -  --        --      --      -             -   -  -   -        - -    -   ---   - -           -
-  ---   - - --- -   -- -  -  - -       ----  -  --       -  --  --  -  -   --     -  - --     -   -
-       -      --       -     -   -  -    - - -  -  - -    - --    --  - - - -       -       -  - --
-  --        -    - -  --  --  --       -   -           --  -  -- -      -        - -  --  -- -    -
---    - -   --   - -   - -   --       --- - --  -    - -        - ---  -   -    -  --   -  -      -
-  -      ------  --   --  -       -   -   -   -  - -   -   --          -           -    -   -  -  -
----------------------------------------------------------------------------------------------------
