100
100
----------------------------------------------------------------------------------------------------
- -    --    -- ----      -            -          -           -  -   - - -    -  --  -    -    -   -
-   - --  -   - -   -   -     - -     - --  -  -   -  ---   - - -         --   --     -         -  -
-   --    - -   -   -    - - - -  -     -  --     -  -      -    --   -  - -- -   --  -     - -  - -
--   --  --           --- - - - -     ---- - - -      -         --          -   -  -      -   -    -
- -  -  --   ---      -- ---   -- - -- - -  - -      -      -          --     -   ---   -- - -   - -
-               -  ---- -   - ----     -     --  ----   -      -          -  - - -   -- -          -
- -    --- - --  -     - - -     - -  -    -         - -   ---  -  -       --- -   --   -   - - -  -
-- -            -  -- --     - -    - -- -   - ---  -   -     -  - ---  - - -  ---- ---    -    -- -
-   --   --    - -  - --   --   -   --        -     - -   --    - -   - -         -   ---    ---   -
--   -  -      --       - -  - - - - -  -    -          - - - -   -        -  -- -  --    --  -  ---
- - -   --   -   -  --      -    -   - - ---- - --   --      -       -  -          - -     -    -  -
--    - -   --- -        - -   - - -        --      -- -    -    -  --      --  -     -     - -  ---
-   --   -     -   - - --    -     -- - --- -   --    -- - - - --     -  -   -      - -  ---      --
--  - --  - ---  -      -   - -- -  -         - - -      -  -    --   -  - - - -   -         -     -
-     -  - -    --     - -          -      - - -  -   - -    - -  ----     -- -  ---  -  -    -  ---
-   -   ---  -- -- ---  - ---    - -  - -  -   -     -        --       ----    - -  -      --- - ---
-        -- -   -  -      -  - - -  -- -       ----    -   - -   -- -- - -    - -  -   - -- - -- ---
- -    -   -   -    ---     - - -  -    --  -     -- - -   - - ----   -  - -      -- -     -       -
- --      - - - -- -    -   - -     - --      ---        - - -  -  -         -  -  -    -  ---  -  -
- - - - -   - --   --    -  -          -   -     - -    -   -  -      -- --      --- -- -- -   -   -
- - - -      ---  -   -        - - - -   -    -  -  -- -- - --  --    - - --   --      -   -   -   -
-- --  -       -  -  --      - -- -- -   ---       -     --  - -   - -      -     -     --         -
- -  - ---    -    --  -- --   -                 - --- - -      -    -----     - -  -     -     -  -
- - -  - -   --  -  --   -  - ---    --   - - -  - -   -        -- -   -  - - --  -  - -       -   -
- - - -  -   -   -      -           --       -- --      -  -   -    - - -- -     -- --  -- -  -  ---
--       -  - --   --      -  -  -  -  -   --      - - ---  -  -  -  - - -     -     -- - ---   -  -
- -- -   -  -----   - -   --- - -             -    -  --   -- -  - -   -        -         -   -  ---
-     --    - -  -           ---    - -          - -     -     - ---    - -  -   -- -    -- - ---  -
-   - --    - --  -   - -  - -       -   - -  - - --  -             -   --  - --  -   -  --   --   -
- -     - -- - -       --- -   --  -   -   --     - -   -       - -       -     --   -         - - -
-  - --      - -  --       -     --  ---    -  -      -     -  -   -  -  -    --    - --  - - - -  -
--- -           -    -     - --           - - ----- - ---    - -    -     -    -   --       - - - --
-     -    -     -- - - -   -  -  -- - -         -  -            - -         -- ----     ---  -    -
-    -- -     -      --   -- - - -- ---  - - - - - - --   - -  -  - -   -- -                - -  - -
---  -  - -     -    - - - --  ---    -  -     - - -         --        -   - -  -- -   ---        --
--   -    -   --   -     -  -        -   -- --  -   - --   -   -            - - -   -- -- -  -  -  -
- -  -    -     -   - -  --    -----  - -- -     -       -- -    --   - --    -   -  - -          --
-    -   -  - -   --- - -  -    -      -          - --    -- - --- - -    -    - -   - -    -  -  --
-- -- -  -  -  - -   -   - -      --      -- -      -     -       --  -      -  -- -  ---  -  --   -
- - -    -    ---        -    -   -- ---  -   - --   -  -    - - -      - - -     --      ----  - --
-  - -  --  -   -         ----  -     -   - - --          -- -   -   -    --         -       --   --
-       -       - --  - -     - -  ---    -       --      - - ----  -   -  -   - -- - -  - -- ---- -
- -     ---    - -  -   -   -    - -       -  -         - - -- - --  -- --               -         -
-  -       -     --       -  -   --    ----   -- --   -  -   - -           -    -- --    -         -
-- - -   -   - -  -   -    - -  - --           - -  --       -  -  - - - -       -    --    --   - -
-   - --   --  -    --          -         - -  - -    ----        -   -       --       -       -   -
-  -    -       -- ---   -----  - -   -   - - - -     -  -  -- --  -- -  - -  -   -     -          -
-   - -   - -    --            --      -      -  --     -     -  -     - - - -  --  -  -      - -  -
-- -      -          -  --   -  ---       -   - - - - -  -  -  - -    -       - - -- -- ---    -   -
-   --       -- -    -    -  -     --  -     -     -- - ---  --  - -       - -     -   --          -
-  -   - - --      - - - ---- -   -   -- - --- --  -     -  - -  -   - -    - -  -        -   -  - -
-     -  - - --- - -     -  --     - -   -   - -- -    -  --   -       - -     -   -    -        - -
--- -  -                - -- -    -   - -     ---   -       -    ---- -     -  -  -   --  ----     -
-  -          --    - -    -         --  -  - - -    - - --     -    -   -   - -- ---     - -     --
-    -  -  -- -    - -   - -    -    -   -   - --- - - -- - ---    -    - -       -  -   -      -  -
-       - -     -  - - -           --  -   --   --   -- -   -- -- --        - ---  -     - --  -   -
- -     -  - -- --   -   --   -   -  -  -    -    - - --  -  -    - --    --        -   -- -- -  ---
-       --   - -    -   - -- -- --    - -    -   -   - -   -  -   - -       ----  --      -    --  -
-     -   -- - -----     -   -      -- -   - -    ---   - -    -    -      -    -        -    -- - -
-      -      -   - ---     -      -- ---  - -  ---  - -  --   -         -  -- - -  - -- -  --  -  -
-  - --    -                  -  -      - -   ---  --   --   -  -   - - - - -  -  - -  - -  -      -
-   - - -     -  -   -  --        - -     --   -  --  --- - ---- --   -   -- -       -        --   -
-- - -      --   - - - -  -- --   - --   -                    --  - --     -- -  -    -  --  -     -
-     -- --   - -  - - -  - -  - -      - -- -    -      -    - -   ---  -  -   - -   -     -  - - -
-- --   -      - - -   -   -    -        -   - - -- -  -     - -- - - -- --        -    --- ---- - -
--  -- -  -  --     - -      --  ----   -          - -  --    -       -- -       - --- -----  - -  -
-  -     -  -   - -       --  - -    -       -           - -   - -    -- -      - -        -   -  --
-  - -    -   -      - ---  -  -  --  - -    -   ----   -   -  -    - - -    ---  -   -   --      --
-    --     -- - -    -    - -  -  - -  -   -- -        - -    - -   - -         -  - - - -   ---  -
- -      --      -   - --  -  --  -    -  -           --      -- -      -       --      -  -       -
- - -        - -    -    - -- - -      -  -         -  -  - --      - -      -            -  -  -- -
--     - ---- --  - - -   --     -    --     -- -    -- -    -  ---       -      - -       ---  -  -
-                --  -  --    --  --         --  -  - -   --- -  -  - -        --   -        -     -
-                   -       -  -  -  ----  -     -  -  --    - -- -     --   -  --  ---- -  -    ---
---- - - -   - -    --    ---      - --         -  -   -               - -        --     -   -  -  -
-  - --   -   --      ---        - -- --   --    -- -      -   -- - -   - -  -   - - --- ----   - --
--    - -  - -  -  -    - -     -    -- --  -- - -    - -  -     -  -   -    - - --             -  -
--  - -   - -         -  -    -    -  -     -    -   --  -  -      -- -     -- -       -          --
-   - - - -      -  -  -     - - ---  -- -- - - -      -  -   - -      -    - -   -  - -     -   - -
---  - ---    -   -   --- ---    -  -       -    - - - --      -      -    -  - -    - ---  - ---  -
-      -  --  - - -    -- --         -    -   --- -        -    -     -   -    -                   -
-    -   --  --  - --  --  - -  - --     -    - -        --  -   - -                   - - ---     -
-      -          -     -        -   - -   --    -- -  -   -   -  -- -     -   --    - -   -  --- --
- --   -           -----  -    --   --      - -- - -  -  - --    -- -    - - --   --  -      -     -
-      -  -  -          -   -     - -- - -        - -  -   - - -  -- --    --  --  - -  -- -     - -
- --- ----  -    -    -          -  -  - ----  --   -  -- -- ---    -     --     --    -  -   -  ---
-    -  -  ---    -    ---        - - -   -    - -   -  --   ---- - -- --- - -   -- -- - -   --   --
----  -   -  --  - --       -              ---   - - --       ---  -    -  --       -     - -  -- --
-   -   -      - -       -    - - - - -  -       - -    -- -   --  -- -              -  --     -   -
-      -  -  --   -    - - - -    -   --     -     -       -    - -   -   -  -- -  -- -      - -   -
- -       --    -  - - ---      - -    -         -  -     --   -       --      - --      - --      -
-   --   ---- -- -      - -         -   - -  - -    --    - -     -        - - - -       --        -
-    -    -    - ----     -    -     -----   ---- - ---- -     - -  -    - --   -  - --        - - -
--   - -  -  -         - -- -- - -  -    - ---  -             -- -  -     -   -    -- --    ---  - -
-  -- -  -       - - --   - -   -     -  - -       -  --  - -    -       - --    -     - -- -    ---
-      ---  -   - - - -- - -- -     --  -    - --    -- -           -  -      ---  -- -    ---  -  -
-  -      - --  -  -             -   -  -   --   - -               -     -  -    -       --   -- - -
-    ---    -       -  -     --   -                -    -          -       -     -- -  -           -
----------------------------------------------------------------------------------------------------
