100
100
----------------------------------------------------------------------------------------------------
-    -  - - --            - -- -   -        -   - -  -          - -          -         - -      -- -
- - -         - ----  - ----   -    -         -  - -     ---    - -  - -- -    - -- -   --      -- -
-    ---  - -      -    -    -  -  -     - -    -  ---      -    -- - - --  -    - - ---  -  - -   -
-   -          -  -- - -        -        -   --        -  -  -- - -  -- -    - -   -  --  -   --   -
- -   -  --   --  - - -  - - - -   -         -  -   --     -   -    --   -       --  -  -   -      -
- -      -      ---    -         --  - -  - --         -     -  -   -  -- ---  -    - - -   -      -
- -   ----    -    --   --- --     -    -     -       -       - - -  - -      - -      -          --
---   - --           -     - -         ----- --  -- -        - ---    --   - -   --     -- - -- -- -
- - -       -   --        -  ---- - --        -   -     --    -  ----- --   -- -   --- -     -  - --
-   - - - - --       -  --  -    -     --   - - -      --   - --       - -- - -    --   -- -   -  --
- -  - - -  -     -   -  -   - -  - -    -       -      -         -  -    - ---  -  - -  -- --  -- -
--  - - --    -- - - --  -- -    -    -    - -       -      --    -- -- -  -  -     -    -     -   -
-       -  -   -                 -  -   - - -- --   -  -    - --  -  -  --   - -  - - -   -- -    --
- - --   - -        - --    -- -- -  -   -    -      - - ---  -  - -      - - --  -       - - -  ---
---     --  --   -   -  -     - - --   -       -- - -    -      -     --- -- ---   -    -   -- --  -
--    --   -    - --       -   --   - -   -- -- - -  ------   - -  -       -- -         -  --  - - -
--    ---   -      --  - --       -        - -     --     -   --       -  -   - --  - - - - - -    -
-  -    ---  ---- -    -  -   - -     -- --- ----  -- -  -        --    --    ---  -   -  - -  -- --
---         ---   -      -- -  - --    --       - -       -  -- - -   - -           -   -- --  --  -
- --   - -     - - --- -   - --      - -  - - - - - --      -   -   --   --      - - --- -   -     -
-  -  -- - - -   - -- - ---      -    --  - - -  -             -   -            -        --    -  --
- -      -       - -   -      - -  - -  - ---   --              --   - -- -    - - ---             -
- -  -   - -  -   -   -    - --  -    -       - -   -  -- -  --    ---           -   --   - - -    -
--    - -    - --- -   - --    -   -  -   --- -  - -    -   -- -   -  -  - -- - - --   --  -- -    -
-   --- -  - -   - - - -     -    - - -  -   --         - -    ---   - -      -               -    -
-      --  - -     --- - -   - - -              -       --     -  - -    -  -     -    - - --   -  -
- -  ----  -  ---         -   --  --- -    --       -                    -  -     --- - -   --   - -
- -   - - - -  -   -   -    -          -    -         -   -   - - -    -  - --  -        -  -   -  -
-   -    -  - -       -   -    -  ---     --  -   - -   -   - - -  --    --   -     ---  --  -    --
----- -   -  - - -  - -   ----  -   -  --   - -    -   - - -- -   -   - -  -         -   -  -   -- -
-    -    -- --     - -     - - -    --  -          -      --  -  - -  -   - -     -  -   --    - --
- -  --   - - -    - -   -        - -   -     -  -  - -     -   -  -  -       -   -  - - - ---    --
-       -      -  -         -   -   -   - - - -        -        - -   -   -  -   - -          ---  -
- -     - - -   -  --        --   -      -     - - - -  -  -- - -   -   -  - -   -    ---  --- -  --
-          - -- --   -        -     -   - --       -   -      --              -  -   -    -   - -- -
-  - - -     -   -  -      - --  -   - - -- --  - -    -   -     - -  -  -  -      -- ------   --  -
-    -            -  - -     -    -- - -   -  -  - -  -- - --- - - -   --    -              --     -
-    -       --- -      -  --     -  -  -      -   --   -    -  --    - -  -         -- - -        -
- - -    -   - -  -   -    -- -    -- --  -       -    ---  - --  -  - -   - --  -        -  --  - -
-      - - -- -  -   -  -- - - --        --  -  -  --      -  -          --  -   - -  -     - - -  -
-  --  - --     -  -   - --  ---      -- ---      - --    -            -- -    - -   - -  -  ---  --
-       -        -  - --  - -  - -  -  -   -     -    - -     --   -- -   - -      -       -  - - --
- --   -  -- -- -    -   -    -- - -    -- -    -    --     - -   - --        - -  -       -      --
-       - -  -   -    --  -      - - - -   -    - --      - -  -     --- ---               - - -   -
---     -   -  -         ---  -   -  -  --- -  - -  - -    -  -  --   -   -       -- - --    -- -- -
-    -  - -- -  - -     -    -       -  --- - - - --- -   ---   - - -     -    -     -     -    -  -
-   --    -      --       -   -- - --           --  -   -     -        --        --     --    --- --
-   --  - -   --- -    - -  -   - --   --  -- -   --  -   ---     -   -  -   -  -   --- - -  -   - -
-   -  -  - -- -   -        - - - -         - -   -           -   -  -    - - -  - -    --- -     --
-   - -  - --   - - - --        -   --  - -- -  -- -  -  -- --- ---  - -- ---       -  --   ---   --
-     - - - -  - -  -   - -- - -- -         - - - -  - -  -   -   -   -        --     - --    - - --
-- -  -               --    -      - -  ---  -         --  --  --      - -            --- -- -     -
-  --  --   -  -    --     -- - -- -  - -    --  --- - - - --  -     --   -  -   - ---   - -    ----
-   -   --   -  --        -    -    - -   -     --  -- -       -     -   -    -    -  - -  -       -
- ---  -     -- -  -  - -    -  -   - -    -- --- - -    --      ---  --  - -- ---- --  --  -     --
-     - ---  -  -  - -  -- -    -  --      -          --  -    -- - -- --- --- -   -          -    -
-   - -     -  - - -   -  - ---   -  -   -  --   --  - -- -    -  -           -  -  - --  - -     --
- -- -    -  -   -        -   -       - -- -  ---  -      -     -  -     - --   -  -             - -
-    - -       ---     - -   -           - -                  - - -       -     -    - -     -     -
-    - -    --  - - --   - -- --   -       -  -- --   -    --       -   --        -- ---   - - - - -
-   --           - - - --   - -  -    -  -       - - -  -- - - -  -             - --   ---  - - -- -
-  -  - - --     --       ---     -     - -   -  - -             -  -   --    -      -    -        -
-  --  -  -   -  --     -    -      -  ---  -                - -  - --       -  -- - - -           -
-        --          --   ---  ----- -       -- -- -   - - -    -  -    - - - -       -       -- - -
- -  - -    -  - -  -      --          - --    -  -- - -     - --   --  - - - -   - -   --   -  -  -
- -      --  -  -   -- -  -- -    ---        -  --  -   - -   -  ---     -     --  --    - ---  ----
- - -  -- - - -   --     - -  -  - - -- - -     -  -   -  -  -             -  -   - - --   -    -  -
-  -   - -   -  -    ---  -       - -    -     -   -        -               -- -   -   -  - ---    -
-  - - -   --    --    -    -        -  -       -  -   -- -    -      -   - - --   -  --   -  -    -
-    - -     ---   -    - - -- - -   -- -      ---  -   -     ---- -      -          -    -- -     -
- -     -     --  -    -  -   -     -     - -     -     --        --   - -     -  - - -    -  -- - -
- --- -    - -      -  -- - --  -          -  --- -- - -  -- --    -    -    - --       --  - ---  -
--   --         -- - ---  - - -  -  -    -   - - -       -       -     -      -      -       --    -
-       -  - -    ---   -- -    - - - - - - -    -   - -   --- -  --   -      -  --  -- -  -       -
- -  -    --          --     ---  -    -   - -       - - -   - - - - -   -      -      ----  --  - -
-    -  -- - - -- -  -  - -     -   --   -          -- -   -  -     - ---  -       ---    ---    - -
--- --    -     --  -   -       --- - - -  -  -             -  -    -   - -  -    -  -- -    -  - --
-     -     -  -    -    - - -        -      - -  -  - - -  --     - --       ---  -- - ---- --    -
-- ---          -    - - --   - -  - -   -      - -   -   -   - -- -    -  -  --      -  -    -   --
-          -  -- -    -     - -  -      -   ----    -- -   - -  -- -      - - -               --   -
-  --  - -   --    -   - - - -- --           -  - -       -   -  -    -     --   - -  -   -   -    -
-          -   -   - -      -  -   - ----    --- -     --       ---    -  --   - -            - -  -
-     -  --- -   -  -  -     -  - --    - --         -   --      -   --   -   -  --  -  -       -  -
-- - --   - -    -     --   -  -    - -  -   -          -   -     -  - - -- -  - -   -   -        --
- - -    - ----           -   --  -    - - -  -      - -    -  -       ----  -        - -   -   -  -
- - - --   - -       -  --- -       -   --    -   - - - -  -       --      -    - -      -  --   - -
-       -      - --  --- --- -- -- -   -  -    -   -   --     -    - - --    - -   -  - -          -
-      - -  --                  -  -   -   -       -      ---- - -     - -        -   -  - - -  -  -
-- ---   -  - --   -  ----   -  - -   -- - -  -     -- -  - -      - - -              -       --   -
- -  --          - -    -     -  - -- -- -   - -  - -        -   -- -    -    -     --  -      -   -
-- -   - -- - --   -- --   -- -   --   --   - -- - -   - -       --  --       -      -  - --       -
-  --  - - -- --   -    --     -            - -  -  - --      --     -    --  -   -     --  -- -   -
-  - -       ---- - -  - -- ---  -      - -   -          - -   -- -   - --   -   -   --    -    -  -
--                  --       - - - -     --    - -     ---     - -      ----       -    - --  -    -
- -- -   -   -- --         -    -  -- -    -  -      -     -       -- --       -  - -  -           -
- -   -    -     - - --      -- --      ---    ---- -  - -  -     -  ----    --    -      ---      -
-- -- -   - ---  - - - ----     - - - ----    - -   -   -    --- - -        -    - --         -    -
-  - -    --     - - -        -  -   - -     -   - - -  -  -    -- -          - -  -           -   -
----------------------------------------------------------------------------------------------------
