100
100
----------------------------------------------------------------------------------------------------
-  -- - - - -  - --    --       -    -          - -      -   -            --      -            -   -
-  -  -    -   -   -       --- -  --       -   ---  -  -            --      - -   -  -- --  - --   -
-- - --      -  -   - -     -         - - -  - -   --     --  -  --     - -         --  --- - - - --
- -    -  --  -    -       -       --   - --  -    - -  - -    -      -    ----   -   - -  -- -  - -
-   --  -     -  - -   --  -   - --  --  ---  -         -  --  -          -     -  ----       ---  -
- --              --   -   -   - - -    - - -  --      - -    -   --  - -     -   ----   -   -  - --
-    - - --  -       -         -  -         -   - - - --    -   - ---  -   -    -      -   -   - ---
- -   - --  -     -- -   -  -    --  -  - -  -  --  --     - -  -   -- - -  --  -- -  -    --   -  -
- - -   -    -  -      -     -   -    --    - -  -    -- -  -     ---    -  --   -    - - --   -----
- -  --        - -    --- -- - -  --         - -   -      -   -  - -           --  -     -     -   -
---  -   -    -    - -  - -    -- -   --                          -          -    -  ---  - -     --
-      -- -  --    - --     -   - -   -  -    - -  -- -                - -  -    - --   -     - ----
-  -      - -  -    -  -  -  -    - -     -    -  ---  -    -   - - -- - --  -- - - - --  -        -
-    -   --  - -   - -   - --   - -- ---  --      -    -     - -   -  -  ---      -  -  - - -- --- -
-    -   --   -   -    -  -  -         ---   -----   -   -      - -     -      --- -  - -   - -    -
-    -   -  -  --    -- -   -- -       -          -  ---  - -  --     --  -     -   -  -    -- - - -
---- -      - -   -- -  --      --   -  -- - - -   -   -    -      -  - -  -    -      - --        -
--   -- --  ---       -- -     -    - - -- -  -    - ---      --          -  - - -  - - -        - -
- -- - -   -   -  --     - -   -   -- -   --    --    --    --   --   -            -       --      -
-    --  - -----   -  -  -   -   -   --  -                 -- -       -    - -   - ----- --   -   --
--  -     -      ---     -   --    -- -- ------- -       --    - -       - --  --- -  --   -       -
-  --   - --   - -  - -    -    ----     -        -   -- -    -  - --        -    -       -      - -
-  - - -- -  -- -   -  -- -  - -     -   -  -------  -  -  -      -- --    --   -    -           - -
-   --    --   - - -  --  - -- --   -     -    - -  - - -   -  -- -      - - -   - - -- - -  -  -  -
- --  -     --  - -  - -      --   - -  -    -- --     --     -       -- - - - -   -   -    - -   --
-    - - -    - -  --- - -   -  -     --  -   -             -- - -   - -- - - - --   ----     ---  -
-   - ---     -- -  -      -   - -- - -  - - -     ---  -   - -  - --   - - -      -           -  --
--   -        -    -  - -  ----- -    - - -- - -  - --   --       - -      - -   -                 -
-   -    -        - - - -  -          -            -          -         ---     -        - -- -  - -
-  -     -- -  - -          -      -     --  -- -   - ---        -   -       -   --       -   -    -
-    -           -    ----   - -          --     --      - -    -- -    - -  -- -  - -     ---   - -
-  -          - - -         -  -   -  --     -  -     -    -   --  -       -   -  --       -- -  - -
-   ---     -        ---  - -- -   -  --  --  -   --   - --   -       --  -  - --   - - -        - -
- -      -     -        - --   -     -    -     --  --      -    - -   -    - - -     -    -  -   --
-   -        --- - --  --- - --     - -- -   - -  --    --  - - -   -   ---  - - -     -  -        -
- -   -  -   -  -  -  -    - -- --        - -     -  - -    -     -         -  -   --   - -    -  --
- --  - -  -- --    - -  --  - -  --     -     - -      - -- - -   -  ---   -- -- -   - ---  --    -
-  - -   --    -  -  -- - - -    -    -    -  -   --  -  -       - --      -        -     --     - -
-       -   -- -    -   - -- --    -         -- -  -  -- -- -  -     - -   -- -     -   --   -- -- -
---- -             - ---  -   -           -     - -  -      - -  - -          - ----  -   ---    - -
- -    -   -    - ---    -      -     --  --   --- - -     --   ---     - --         -      - - -- -
-    - - -  -           -   --- -      --        -      - -   -       -      - - - - -  -    --- ---
- - -    -     ---    -    - - - - -   -  -- -   - -----         -     - -     --  -   --    -  -  -
-   -     -  -- -    -- -  - -      - - -- -  -  -  - --   -  -- -- --    -   -   - - -  -    -    -
-    --  - - --  --- --          -        -- -  - --   -   -  -      - - -   -   - - -  -  -  -    -
-- --- ---      -   -   -  - --  - -  -       -         -   -      -   -    -  -   -   - -  -    - -
- -    -     -        -    --  -  -   -  - ---  -  -       ----  -  -- --       -   - -- -- -   - --
-      - - -                  -  --  --  -     -- -  - -  -          -   - -  -      - - -        --
- -          -    --   -  -        -    --       --     - - -- -         - ---  - -- -    --   - - -
--   - -  ---  -        - --   - -         --       -  --   -   -- - --- -   - -  -     --    - - --
- --                - -      -       -       --- ---   -      - --   -- ---     -------  -  -      -
--  -   -     -    -- -   - -      -  --   - -    -     -     -   - - -   - - -     -  - - -- --   -
-  --     -   - -   -     -         --  --     - --   -   --    --   -   -   -   - -     -    -   --
--  - -   - -     - --  -      - -       - -  --        - -  ---  -  - -    -  - -  -     - --     -
- --    --    - -  --          -  ---   - -   - -- - -  -  ---  - -  -  -       - -   -- - - -  -  -
--   - -   - -           - -       -   -    --  -  - -   --      -      - ----  -   --    -       --
- --   -      -- -   -       -  --   --   -   -      -   --   ---      ---    -        -- - -   -  -
-          - -         - ---  -   --- -     --   -  -- -  -    -   -    --- --      -     -  -    --
--     ---    -      --   - --  -- -- -    -       ---  - - - - -         - -  -      - -   -      -
-    - -      -   -        -   -      -       - --    - -    -   - -  -    -  -   -   - --   -  -- -
--    -            - -   - -  -  - -  -     - -  -     --  -      - -         --  --  - -  -- - -  -
--  --- -     -   - -    - -  -          -  -   -  -    ---              -  --   -        --   - - -
--      -         - -      -   - -  ---- -- -  ----  - -       - ---- ----       --   -    -     - -
- - -  - --  -  -  -  - ---  -   - - -   -     -  - ---  - --       -- -  --- - - -   --  ---   -- -
-  -  - -  -   -   -- -        -  -   - - - - -    -         ---    -- --      -    --         -   -
-  -  -   --- -    - - ----      -    -- -    - --    -- -  -    -         - -- - - - --      -  - -
-          - - -- --    -  --  -- --        -   --  --  --   -  -  --   -- -      ---  - --    -   -
- -   -  - -  -      --   -  - -  -     --      --- --    - -    --   -    - -     - -  --- -  - - -
-- -  - -   -   --  - - -- -  ---      -         -  -  - -  - -   -      --         -- - -   --    -
- - --  - - -    - --  -  -- -   - -  -   --     -   -    -- ---   -    --    --                -  -
-- --     - -   - -  -    -  -  -- - - - -      - - -------    -        -   -         -           --
-   - - -  - -    -     -- - -     -    ---            -  --   -      - -----   --       -         -
- -      --- -   -  -      -  ---     -     - ---  --   -      -  -    -  -  - -  -   - -  -- --   -
- -   --    - -- --    -    ---- -      -         - -     - -  -   - -- --- -     -   --     -   - -
- --      - - -                -   - - -  --    --          - -  -  -      - -  -  - -  -   ---    -
- -     -     -- ---- - --- - -  - - -   -   --         - --  ------   - -       -     -       -   -
-- -            -   --       -    - -    ---  -             -     -   --  --     - --  - --    - ---
-  --    - -   -    -  -  - --    -   - - --       -   - - - -    -- -     - - -   -  -   -        -
-   - -    - -   -    -     -     -    - -    -    - -  -   -  - --   -     ---  - -   - - -     - -
-      -      -  -  -  -   -      - --   - - --- -    -  - -        -     -    -     - --  -  - -  -
-    - - - -  -  -  --   -   -  -  - - - -  -     -         -   -  --       - - --  -    - -  - ----
- -     -   -  --       - - ---  -- -   -     -       -  -                -  - -   -  - --    - -  -
-    --  -- - -  -         -    -    -    - -          -  - -  - - -  -- -  --    -    --- -  -   --
-      - -          - -       -- ---- -   -  -   -    - --- --       -  -  - -  --    -   --   --- -
-  - -   -  ----   -    -  -- - --    - -   -  - -  -  -   -        ----     -   --      -  - --  --
--       --     -   -     - -   -- -     -    - - --    ---  -    -      -      -  ----  - -- - - --
-       -  -- --- -     ---   - --             -- -- -    --   -   - --  -         --    - --- -   -
--  --   - - --    - -       -       ------  -      -  --     --- -       -             - -   - - --
-   -      -  --            -    -  -          -     -  --- -   -  -  - - -  -  -  -      -     -  -
-  -             -         -  -   - -    -     - --  -    -       ----   -   - -  -      - -  - -  -
-        --    -   -  - -       -  -  - - -   - --      -- -  -       ---- - --   - ---  --   - -  -
-   - -    - -   - - - -    -  - -  - -        - - -  -  -   -   -                 --    -     - - -
-     -----  --   - --- -- --                  - -- -    - -  - - -- -     ---  -           --   - -
--   -  -  -- - -      --   --   -  --     --  -        -    -        -  -                --  - -  -
- --          - - ---           -- - - -      --- --- - -- -  - -  -  -- - - ----     - - -- -  -  -
-      -                  -- - -       - - --      -  -    - -    -   --     -       -  -    -     -
- -  - --  - -  --- --    -     - -  - -   --    -    -       -      -     -     -  ---     -  -  --
-  - - -       -  -       -     -      -       -          - --   -        -  --    -      - -  -   -
----------------------------------------------------------------------------------------------------
