100
100
----------------------------------------------------------------------------------------------------
-     - - --   -  -               -  - -     -      -   -        -     -  -  -     -     - - - -   -
-  --    --      -    -       -- -    -  --    -      -        -     - - - -     --  --   -    -  --
-  -  -  -  --     - -  ---   -    - --    -  -   - --  ---    -      - -    -      --  -     -    -
- -     -  --  --    --- --    --     -         ---    -   - -    --     -- --  ---  -- --  --    --
-      - -    -             ---- - -    - --  -  -  - -   -- -  -     --  - -        -    -  -     -
-  -   -    -  -  -    - -  - - -- -   -  - --  -  --  --  -  -     ---      - - -       -    -   --
--       --  -- -    -- --  -           --   -  - -- -  -  --- -  -     -   -  -       --  -   -   -
- -   --         ---   -  ---     ----  -  - -   -  -   --  -    -  - -   --    -  -- -  -  ---- ---
-    - -         -       -  -      -    ----      -        -  -  -  -    - - -     - --         -  -
-       -   - --  -     - -   - -    ---  -    --   -    --  -- --- --            - -   -   --   ---
--    -   -     -  ---- -------    ---  -- --   -     --   - - -      -        - -     -           -
-       -- -  -   -   -       -    -   -      - -  -           ---   - -  - -            -    -  ---
- -     -   -    -    - --- --        -   -- -   --  --- --       - --- -  - -- -   -- - --- -    --
-  -- --  - -    -   -   -  -         -  -   - -   ---  -    -     -         - -   -   -    -  -   -
- - -  --  - ----   - --    -      --   -  -   -  -    -  - -     -            -   -- - - - -    - -
-  - -    - -        - -  -   - --       -     --     - - --- -- -     --    -    -   -  -      -  -
--  --              -  - ---          -- -    -- - - -- -      -   - --   --    - ---    --- - - - -
-   --     -                    -   -  -   -- -  -  -  -   -  -  -  -      - -       -    -    - ---
-- - ---       -   -   - -      - -  -- - - - -  -  - -- - -       - -  --  - -     -           -  -
-- ---  -  -             --   --- - -   -    -   --  - -   - ----- -     --   ---- --  -- - -- - ---
-- -  -     -     -  - - -          ---  - - - -      -     - --  -       --   -    -              -
-     - - - ---- ---   - -- - --- - --           - - ---    -   ------ ---  - --- -  - -     -  - --
-   -               --         --  -  - -     --  -         - -   -    -  -    -  -  ---  - ---    -
- --  -- --    - - - -        -   -  - - -  -   -    -  - - - - -   --    -   -           -- -     -
-       -   --   -       - - -    -                -    -     - --   -  -  - -   --  --       -  - -
-  -    -- -  ---  --  -     - -   -    -   ---     -     --   - -       ---   - -  -      -     - -
- - -   -  -   -     -   -  -     - - -   -  -     -  - - -- -     -  - - -     - -  - -           -
-          - -        -   - -      -      --- -   -  - -      - - - -    -  --      - -   - --  -  -
-    - -- -     --   -  -      - - - -  -- - - -  -    --      -  -   -- - -  ----        -     - --
---- -   -  -      -- - -  --    ---- ---        - - -  -  -- -      -     - -  -    ---   -  -    -
-    - -        --      - -  -  -       -  -  -  -- - -  -   -  -  -  --        - - - -    -    -  -
-      -    ----                - -  -   -   -   -  -  -  -      - -        -     - -    -- - --   -
- -- -  -- -  -- - -- -  --  - -----   -    -  -- -   -  - - --  -  -   -   - - ---     -       -  -
-    -  -  -     -  - ---  -    -- -     -  -   - -  -   - -     - -    -    - - -  -  -   -   --  -
-   - - -    -   -        -            - - -   -   - -   -    -    --  -    - - --   --   -  -------
-  -  -   ---    -            -  -   -      -   --   - -    -   -   -- - -  ---   -  --- -   -   - -
--  --  - -   --      --  -  --      - -      -     --- - -     - --    -  -   -- -         -      -
-      --   - - ---- - - ---   -     - -   --  ---  --  -   --  -        - -- -     -  -- -  --  - -
- -   -    -  --  -  -- --    - --    - - --        -          - - --   -      -  -  ----  - -  -  -
--     -    -   ----            - -    -        - - -      - -   -    -       - -  - --  -    -   --
- --  - - - -- ---  - -   - - -   ---- - -   - -   - -  -  -  -- ----        -    -  -  --  - --   -
- -   -  -  - - -     -   -   --  -   -     - - -   --- ----     -    -    -          --  -- - -   -
-  -      -       -- -  -  --    -     --       - - -  -     -       -     - -   - ---- -     -    -
----   -  -     ---   -  -   - -    -   -  --  - - -  --     --     -           -       -        - -
-    -  -         -  -- - - -   --    -       - -        - -- -   -      ---   -- ---- --   -  - ---
- -    -- -     -- -          --  -    ---  - -   -- -  - --  -     -       - -  -   -  -   -      -
---- --    -- -        -   -      -       ----- --     ---  -        -   -  - --- ---  -    -- -   -
---     -   -   -     -      -        --       -    -    - - -- - - -     -      -       -    - -- -
-     -----     -  -   ---    -    -     - -  -   --    - -    -  -  -    --- --  -  -  -   - -   --
--  -  -       - - -        -  ---     --  --  --    -  - ----   - - -  ---  -  --  -     -   -    -
-- -    -   -- -      -   - - -  -  - -           - -    -       -   -     - -  - - - - ---  -   - -
- -   -    -         -  -    -- -  -     - -  ----  -    - -   -        - -     -  -      - - --  --
-   --       -     - -   - -  --  ---     -- -    ---    - - -       -- -   -    --         - -   --
- -    -     - ---       --           ---    - --  -  -  -   - - -   -  -  - --   - -        -- -  -
-  - -      - - - - - -  -    -   --   -     - -    -     - -  -   -- - -   -  --                 --
-- - - ----- - -       -  -    - -      - -  -  --  -  - -          --   ---- -  --  -  --- --   - -
---   - - -  - - --  -    - - -  -  - -   -     - -      ---   -     -     -    -  --        - -   -
--  -- -   -  - ---    --    -      --   -  -  - -   - -   ---  --  -    --    -     -  ---      - -
-- -   -    - - -- - - -- -    -  - -  -   -         -  ---   -  -  --- -- --    -      -   -     --
- --   - -  - -    -   - - --  -         -  -   --      - --- -   - -- -     - - -     --     ---- -
-    -- -  -  -   -      -  - - -    -  -  ---    --  -   -    - ----  -    -   - - -       -  --  -
- --    --- -       - - -        - -          - -       -   -       -   -      -- -        - --    -
-   --  - -  -   -- --     -      - - - - - --    -         -  -- -    -      -      -           - -
-     - - - -   -     --       --  -    -   -  - -     - --              - -           -         - -
--     -  - - - - --   - -              --    -- -   ---     -      -  -    - -  -    -            -
-  -            --    -    -  -        - - --  -      -   -              -      -  - --  -     -  --
-    -     -- - -    -               -    -- -     -      -- -     --- - -   -  - -    -     -  -  -
- - -  -   - -    -      -  -    -  -   -  -- -  -  -          - - - -  -      -    - - -    - --- -
--  -   --        - -     --     -     -  - - --  -  -    -   - - -- -   - -     -   -  -- -- -    -
-     -  - --- -   - -   -  -   -     -     -- - -- -    -  - --      -         - -  --   -- - -   -
--  - -  -     -- -- - - --   - -       -   -         - - -     -  --   -- -    -        -  -      -
-- -  -     -    -     - -     -  -   - -    - -    --  -  -    - -  -    -        --   --      -- -
-  -  -  -  -  -- -       -  --    --   -         - -       -       -   - --- --    - -       -    -
- - -   -    - --      ---    -- -   --       - -     -  -                   -  -- -  -- -    --   -
-    --       - --   -- - ----       - -    -- - - -  -    -  -    -- -  -                 -     - -
--   -    -  - - - -   -    -- - -   --- --    -    - - - - -- - -  -    - - -    -      ---- -  ---
-   ---   ---- -     --        - --  -- --  -  --           -    -  -  -       -  - -    -   -     -
-   -         --     -  -        --   - -- -    - -  -   -   --                      -  - -- -     -
-     -  -   - -    -  ----   ---   - - -  -  -  -   -      -    - - ---  -      -     -  -  -     -
--    -    - -    -    - - ---    -   -    - - --  - -  -  - -- -- -    --    -  -     -    --- -- -
--   -   -       - --  --    -      ---- - --  --  -           -   -   -- -    -   --- -      --   -
-    -  -  -   -     --   -     -  -        -        - - -     -  -   --    --   --     -     -    -
-  -- -    - - - --  - -   -   -  -    -  - - -  -   -   - - -      -        ----  - -    -- -  -  -
---  -    --     - -    - -- --  -        - - -  -  -   --     -- - --- - -- -    --  --  -  -     -
-     -    -     - -    -  --   -- - --  - -   --- -     ---      -  - -- -  -- -    - - - - -- -- -
- - ---   -       -   - -  -    -  -     ---    -  -    - -     -    -- --   --  - - -       -     -
--  -   -  -    -  -     -- --      --      -           - -       -       -   -   -   -   -   -    -
--  -        -    -   --   --  -   ---- -   -   -      - -  -  - -----   - -   -    -      -   -   -
- -      - --           -- - ---       -   -  -   -  --     -         - ---   - -      - - -- - -  -
- - -    -    -           -    -   -  ---     -         -    -   - ---  -    - ---    - -- -       -
-      - - -- - -     - - - -- -   -    - - --  -   ---  -  - -   -- -    - -      -         --- - -
--  -- -    - --    --- -    -     -     -  - - -  - -   -- -        -- - - -       -- --  - -  -  -
- -     -  -   -  -      --  -- ----- -  -     -      - -   -                  --- - -   -  - --   -
-   - --      -- -     - -   -    -      -      -      -     --  - - - -- -                     -  -
-  -  - -- - -      -     ---    -- - -         - --       - ----- - -   -  -  - - - -  -    - -   -
-      -  -- - -   -  - -     -            ----      ---- -  ------       -      - --    ---  -    -
-  --   -- - -  ---        -         -  - --  -               ---- ---  -     - ---  - - --- - --  -
-   -  -      -    -    -      - - - -  -- --  -    -- - --- ----     -   -    -    -              -
----------------------------------------------------------------------------------------------------
