100
100
----------------------------------------------------------------------------------------------------
-  -  -  -- - -       -    -              -     -         ---  -        -- -  - - --               -
-   -        --   -  -  - -   ----    -   -  - - -  - -       -  -    - --     --    --   - -     --
-     -   -- --   --   -  -         -    - -    -    -     --   -  - ---  -    -  --      - -      -
-                -   -     -  -  --   -  - -    ----   -   -  -   -   -  - -- - - -   - --  -- -- --
-    --  --   --  --  -- -   -         -- -  -   - - - --  -----    -       -   -     -  --     -  -
- - -     -  -  -      -   -  - - - ---  -   -   - -  -  --      - -  -    --  -- -  -  -    - -  --
--   -  -  --      - - -       -   --  -- -  -  - -    -- -   -- -  - -  -  --      - -  --     -  -
-   -  - -      --    - -   -   --  - -       -    --- --- - -          -  -   -  -  -    - -   -  -
-      -   --    -   -        -     - - - - -  -   -    -     -  -   --     - -   ----- -- - --    -
----  - -    -  - - -     -- -    -  -    --   ---   - -   - -  -       ----  -   -                -
- - --    -     -   -   - - - --    --    -  -  - -- -  --      -  -           --- ---     --  -  --
-- ---        -- --  -  --   -    -        - -         -   -- -   - -     - - - - --    -   -      -
-                 - -- -       -     -      -     -   -  -     - - -  ---- -- - --     -  -     - --
- -  - - - - - -  - -       -     -  - --- - ----   -      --- --  - -  -   - -- - -    -    -   - -
-  - -  -   -   -      - -   -          --             -    - -  -  --  -    -         - -  -   -- -
-   - - ---  -   - -   - - -  -  -  - --       - -   -   - -  -     -  - - - - - --  -       -  - --
-- -       - -  -   --  --   - -      - ---- - - -  ---    -   -    -  -   -     - -  - --         -
- -  -   -- - -       -      -      - -  -      --    -    -      -- -   - - -  -     --- -    -   -
- -  -    --    ---   --- --   --- -        - -- --  -- -       -     -  ---     --     - -  - --- -
- - -   -    - -    --        -    -     -- -- - -   -      - - - -  - ---- -    -    - - -   -  - -
- --     -  - -   -- -   -      --   --    -   --        -  -        - -   -    - - -  - ----- --  -
-        -      -    -    -  -    -            - --  -  -  -    -- -  -  -    -     -      -- -    -
-        - -   -  - -  ---      -  -   - -      -        -   - -        - - --  -         -      - -
-- -  -  -     - -   -   -    -   -   -     - -   -    -   - --       -    -    --  -   - --- - -  -
-- -- -   -- - -  ---      - -  ---      --- -    --  - -- --  -   -     --  -   -           -   - -
- -    - -   - --    -        -   -  --      -  -     -  - -- -       -   --  ---  -       -  -    -
-  -  -     -- -  -    ---   -----     --- - - -  - -     -  -  -        - - -       - -  --       -
--   - -   -  -       -    - --   --- -     - -  -   ---   -  -  - - -      -    -- -         -- - -
- --   - -     - -   -  -- -         - -  --- - --  - -   -- -  -  -    --   -   -       ----- --  -
- - --            -  -   ---   --  --  - -   -    - -    -  --         -- - -- -  ---              -
-            - --  --  -   -       -  --      - -        --  -     -   - -  -   --      ---   --   -
-- - --  - -- -   --   - -         --     -     --    -      -  -- - - -- - -   -- -      -        -
-   -  --  --- - -   -  --  -    -    --   - -    -  -   --   --    - -  - -  - -              -- --
---       - - -    -      -     - -   -  -   -   -    - -   -          -   - --- -- -  - - -       -
-- -        - --       -              ---  --  - -   - - - -         -   - -      -  -     -  - -  -
-    -         - - - - ---- --     - -   - - -       - -     -      -   -    -     - - - --      - -
----    -     - -   - -     -  --    -      - -  ----       - -  --  -    ---   --  - -    -  -    -
--         -- - -        -   -     -- -  -   - -  --  --     - -    -     -  -  -         - --- - --
-             --     -        - -         -- - --                -     -- -     - --    -    -    --
--- -    ---        - --      -- -   -----  -         -   -  -    -     -  -    -  - --          - -
--        -- -      -    -      -  -- --- -  --  -    -      -     -   -   -  - -      --        - -
-- - -- -    -   - -             -     -- -       -   -     -   -  -   ---- - - ---  -   - ---    --
-   - - - - -          - - - -- - --  -   -   -  --- -  - - --        -     - -   --   - -  - -   --
--- -    - -  -    -    -   -- -    --   - --       --        -  ----- ----- -- --   -    ---    - -
--   -   -       -- -  - -   - - --   --  -  -    - - -  ---            -             - -  - -   - -
- -  --   -  - -     - - ---         -        ----  - -   -    - -   --  -     --        --  -  -- -
- ---     -     - - -    - -         --    - ---   - --     -    - -      - --     --   - -        -
-  -  -- - - --   - -- --   - - -    - --            - --    --      --    -      -   -  -  -      -
-                    -  -- -    -     -- -- - - -  --   - --     -   -  -     ---    ---  --       -
-- ---   --  -  -       - -  ---    - -   -    -  - --  - -   --   - - -          -  - - - ---    --
-      - - -    - --     - -          -  -  -- --  - -    -      - - -   -       -  -    - -     - -
---   - -  - - --    -   -- --  -       -    -    --   -  --  - ----   -   -      -- --- - - -   - -
-   -   -  - -- -   -- ---     ----- -  - ----  ---  -    - -  -              -- -  -         - -  -
--  -  -   -     --      -  -   -  - -             -    --- -  -    - -  ---      -    -  -    - - -
-     -  -    --- - -  -  --  - --          -   - - -     --      - - -       -- - -      - -   -  -
--  ---- - - -        - -  - ---       -     -    --         ---  -   - - -   -   -         - -  - -
-  -    - --   - -   - -        -  ---  --   -- -  - -  --  -  - -  -        -    ---  -  - -  -  --
--      -  -     -  - -  -     -- -- -  -   -       -   ---  --           -- -        - - - -  - - -
- -    -  --      - - -          --  - -  -  -- - -  - - -        - ---  -     - -- --   --  -   - -
- -- --     -  -          --    - -   --          -    -           -       - -- --  -  -      - -- -
- - -       - -     - -   -    -   --- - -         ---      -  -       -         -  - -      - - ---
-  -- - -   -   - - -  -  -----   -  --      -- - -    ----- - -  -  -   -   ---   -- ---      -   -
-- -- - -  -  --    -     -         -   - - --      --  -      --     - --- -    --  -   -- -      -
- - -       -      -  -- -  --     -   - -    -       -    --    - ---     --  - - --  -      -  - -
- -  -  - --- --     -      -  -    -   - -  - -    -- - - -   -  - -   -   -  -      -        -   -
-  -  --   -- -- -  -   --- - - --     -    --   -  -- -- -  - -         -      --  -  ---   - --  -
-   -  --  - -        -       -     -- - -      -         --  - -- --  ---  - -  -  -     -    -  --
---  --   -   - ---- - ---     ----          -       -   -  -- -     -   -  -- -- - - -     - - -  -
-    -      --     -  -       -  - -  -- -          --  - -    - -  -    - -- -      -         - - -
-- - -              --         -             ---   -  --   -- -  - -  -  -   -     -  -  -   --    -
- -  -  - - - --         - -   ---     -----  - -- -     -        -         - - -   -   -- - ---   -
-   -   -  --  -- --- -  -        - --   --  - ----   -- - ------ - -   -   -  - - - -    --  -    -
- -   -   -         -   -  -    --        -          --  - - -   ---  -   -   -   -  - ---  - --   -
-         -   - -     -  -     --   - -    - - ---- -           -     - -   --  -  -    - -  -    --
--  - -         -       -  -- -  -   -       - -  -  - - -    -   --- -      -   --   --- --       -
-- -         -      -- ----  -  -   - -      -            -    --       - -- -  -- -  -  -   -     -
-   - -- --- --  -     -    - -   -  ---            --   - -     --    -  - -       --          -  -
- -   -  -     -- --       -   -  --  -         - --  -- -  -  --        - - -            - -    - -
--  --  -             - --- --- -   - --    - -    -    - - - -    - -   -          -   -- --    - -
-- --  -      - --   - - -- -  -      -          - - -- - - --          -- --    - -        - - -- -
- -- --      -     -         -    ---   - -- --- --  -    -   ---     -   -     - --- ---   -      -
-- - -  --      ---         - - -    -- -      -         - --   -             --        -     -  - -
-        -         -   - -          -  - - -- - -  - -  - -          --    -     - --      --  -   -
-   -  - - -          - -    - -          -   ---  -  -  -  -- -           -- -  --      -- - -    -
--   - -   -   - ---    -       -     - - -  -  - -  -      -      -  - - -  -  -- --  -  -     -- -
- -     --   -       - - -  -- -  ----    - -   - -    --   -  - - ---  - - -  - -    -  -         -
- - -   - --   -   --  - -         -- - -      - - - -          -  - --   -- --    -- -    -    -- -
--    -   - -   - -         --   -   --   --      ---                       -   --- -  -         - -
-  - -  -  - - - - -    -       - -   - -- -  -   -    - -       -  -        -    - --     - --  - -
--  -- -   -     - -- -    -  - -  - -   - - -   -  -     -    --       --  -       - -- --   -  - -
- --    -  - -           -  -     -         -- -   -   -  -  --  -    -  - -     -- -  -    -- --  -
-    - - --   -   --        -       -        -   -          -- - --   - -  -       -    -        - -
---   - - -   -  -- - -   --    --   -  ---  -     -    -           -   -- -      -      - -   -  --
- -  -   - - ---      - -     -      -      -   -     -  ----   -   - -    -    - - -     -        -
- - -       - - -    --      -- - -   -  ---- -   - - -      -   - -     -   -    -  -       - -   -
-      -- -  - -   -- -   --   -    -    -  - -     - - -  --- -   - -    ----  - -- -    -   - - --
-  -     ---   --    -      ---  -     -  --- - - - -   -              -- -     -    -   -  --  -  -
- -   --   -       -    - - -   -  - -  --     -     -     ----           ---       - -  --    -   -
----------------------------------------------------------------------------------------------------
