100
100
----------------------------------------------------------------------------------------------------
-     ---     --     -    -   -     ----  -   -  -   - --   --               -      - - -      - - -
-----        -  -- -         - -    -- -       - - -  -    -  --  -  --  -  -  --- -- -  -         -
-     --    -- -  ---     -   --        --         -   -          - -  -- -     --    -  -   -  -- -
-- -- - - --  -      --      -    -   -    --  - -  - --    -- ---      -   - - -- -      --  - -  -
-         -  -     - -  -   - -  --    - - -  - -        -- - -   --    - ---- ---- -    -  --     -
- -        - - -     -        - --  - - - -        -      - -- ---  - -  -      -   -  -     -     -
- - -  -   -         -   --  - -   --    -      - -  - -  -        -    -   -    -  - -- -  -    ---
-  -     -   - --  -  --       -    -   - - --  -      -   - --  -   --     -- -   -- - -- -  - -  -
-    --        -    ---  -      --  -  -----       - - - -           ---  -      -  -   - -  -- ----
-   -    -   -  -- -    -   -           --    - -           -- --     - -  -     --  -    -    --  -
-      -                --       --   --   -    ---- -   --    -     - -            -      -  -    -
- -     - - - -   - -      -- -  - - -   -            - --  -- - --  -- -      -  -    -- ---   - --
- -  -      - -  ---  -  --     -      - -    --  - -    - -  - - -         -- - -     - - -    - --
- -       - -- -    - ---   ----  - -             - --      ------- - -- -     -  -   -  - -       -
-     - - -- --        - -    - --  --   -  --- --     -  --      --- -     -     - ---       -    -
- -   - --  -  - -- -   ---  ---   -  -   -         - - - - - ---  - -  -  -  ---  -    ---- ---- --
-     -   -  -  -   - -   -  --   -     ---   - --     -    -    -- -     - -  - - -  -- - -  -  - -
- -  -- -   -           -     - - - --         -  --   --    -- -    -    - -- -   - -   -         -
-  -     --  -   -  -   --      -    - --- - --    - -   - -   -  -     -   -- - --  -- -   --     -
- ----     - - -       -   -     -  -  -    -        - --    --     -    - - -   ---               -
- -  -   - -        -      -    -  - -  - ----  -- - -- --- -  --              -    -  -        -  -
-     - -   - -    -- -- -- --    -  ---    - -  -    -     - -  - -- -  -   -   -  - --  -   -   --
-   ---      -- -     --     - -  - -- -  -   -  - - -     -  - -        -  - -   -           ---  -
-       -   - ---     - -  -  -       -   - --            -  -  -     -- -  -- -   -    - -        -
- -    -- -     - -   -    -   -    ----  --  -  --  --      --  -     - --  - - - - -  - -- -     -
--         -  --       -      -  - -             - --   -      ---    -     - --     -       -  - --
- -  - - - -  - --   --  - -   -    -     -       -           -      -- -    -   -- -    ---   -   -
-- -     -   -     -  - -     -   --   -      -   -   -  -          -  -- -     -    -   -   --- ---
- -          -  --       -    -    -  -   -       -               --    -   -     --- -- -     --  -
-  ---   -    - --    -  -   - -- -     --- --      -  -    --  - - - - - - -    --  --  --    - - -
--     - -  -  - -  --  -- -- - - -   --    - - -  -    -     --          -   --   - -- -  - -     -
--   -  - -   ----   - -         -  - - -  -  -   --  --   - -   -          -   - ---   -- - - -   -
- -   -     -     ---  --    - -  -   -  -   - - -       - -  - --- -   - -   -     ---  -   --  - -
-      -  - -  ---   - --  -        -      - -  -  --      - -     -  -      -   - -      -   ---  -
-     -  --  -     -  -    - -   -        - -  -  -       -  -      - - -    - -  ---       --     -
-  - - -  -- -       - -  -  - - -  ---     - ---      ----- -- -  -     -     - -  - -    -  - -  -
-- -         -   - -  -       -   -     --- -    -  -   -       - -          - - --    - - -- - -  -
-  ---  -      - ---   --            - - - -   - - - -   ---  -- -           -      - --           -
- --      - -  - - -  -      -    -   - - - -      -        - - -- --  -      - - -     ---- -     -
- --- - -   -  -- - -        -   -  -          - -  -   --- - - --   --  -  -- -   - - ---  - -    -
-- --    -  - -  - -   -   -    -  -     --- - - -  -- --- - -     -  ---  -   -    -- - - -  -   --
- -    - -- -       -   -  ----  --   -     -  -  -  --     --  -  --      - - -      -     - - -- -
--  -- -  -  -    - -   -      -   -  -   -  -  - -   -  -    -        --    - -  -  -  -  -  -  - -
-     --- -     - - -  - --  --  - - ---      - - -  - -    --  -     ---- --   - - -    - - -  -- -
-      ---  --  -    -     -- -     -  -         -    -  - -      -          - - -  --    -  -  -  -
--    - -   - - - -  -   -   -     -  --    --      -  -     -  - -     -- - --  --        -  --  --
-  --     -  -  -   -   -   -    -  -  - --    - - -      - --           -  -  -- --  ---   -- -- --
-     --- --       -- -  -     -   -  - - -        --  -- -  -  -   - -      -             -    - --
-  --   ---       -   -    - -  ---   - -    --- -   -      --- -   - -      -    -   -  --   - -  -
-- -  -     --  - --- -  --  -    -    -  -  -  - --- -  - - -     - -   - -          -     - -- ---
--   - ----   -  -     -    - ---       -        --    --          -     --   - - ---  - ---    -  -
-     - --      -     -   -      --  -   - - -    -   -     -         -   ---   -     - -    -- - --
--           - -      -   -   --   -     -    -- -  - - --      -      ---    -    -  -   -     ----
-        -  -    - - -   -  -   -   --   -       -- - ---  -     -  -    -- --                -    -
- -  -     -- --   -   -- ---   -   --   --  -  - ----       -    --  ---     -     -  -  --       -
-- -  - --  -  -- - --- -      -  -   -    -       -        --- - --   --  -   -     -       - --  -
-      - --  - -- - -      -     -  -   ---- -  --  -  -      -      -  -  -    -         --       -
-     - -  -  - - -    -     ---    - --      - - ---  --   - -   -   - --        -  --    --      -
- -  -    ---          --- - -  -       - -  -   - - - --  -   -  - --   -- -  --  ---      - -  - -
-  -- --     -   -  - -   -      - -- -  -    ----  -- --    -- -     --     ---- -      -         -
- -          -  - - - -  -  -        - ---- -  - ---   -- -    --- --   -  -  -  -   -     --  -   -
-    --      -   - -  ---     - -    -     -   -            -          - -      -   -    -  -  -   -
-      - --   -      -       - --   -  - --  -  - -   ---   --         -  -- - - -  - -  -    -    -
-  - - -      - - -   -  ---   --   -- -   -- --   -      --   - -   - -     -       - - -  -    - -
-     -- -- -- - -          --          -      -              ---   -              -  -         -  -
-   --    -- - --        -  -      -  -   -  -            --  --  ----        ---- ---    - - --   -
-      --      --  --- - --   --  -   -     --    - ----   -    -  -      --       - -  - ----     -
-  -   -        -   -  -  ---   --  - -   -      - --      -  -  --  - -       -  -   -  -         -
- -  -  -   ---- - -    ---  --  -   --   -   ---   -                        -  -     -  -- -  -  --
-     - - - - -  -  -  -   --  -  ---   -- ----  --    -    - - -   -      - - -  -   - -    - -   -
--- -     --  -   --  -   -         --  --- -- - - - -   -          -      - -  -- -     -   -   ---
- -     -    ---    -     --  --- -- -    -  -   --       -      -  -  - -     - -     - - -    -  -
--  - - - -          - - - -    -   -  -        --  - -       ---         -- -- --   - -           -
- -     - --- -     -      -      - - -   --       -   -    -  --   -  --  --    -  --  -  -  -- - -
- --- - -  -  --    -   - --  --         - ---- -   - -    - - -  -  - - -     --  - - --         --
-  -       - -      - -- -  -     - -- ---  -      --    -        --  - - -   -    - --- -   - -   -
-   - -   -     -   ---     - - -         --  ------    -    --         -   -  - -- -   -    --  ---
-  -     --   -- --       -   -     -    -    ---     --   -  - -             -   -- - -  - -   -- -
-   -  -  -- -  -  -  -  -    -    -  -- - ---   -  -   -   ----            -- --       -   -    - -
-  -    -  -- --  - -    -  -  -   -  -    -  -    -      - -  - -  -    -           --   --   --  -
- -  -- --     -      --           -     -  --     -  - -  -  - -  -   -   -- -    --      --      -
--        -  -     --  - -    -- - -       -  -   -   -    -    -  -   -   --       --       --    -
- -        --               -   -   -  -    - - -  -      - -  --   ---            --- -  --  -    -
- - -   -  --  -     - -         -  -     -- - -   -   ----  -                  - -      - --    - -
-- --  -  -  - -   -- - ----  -    -  -     -  -     --          -   - - - -- -  - -   --   -    - -
-     -      --       --       -  ---     - -- - - - - -   -             -     -  -       -        -
- ----           - - -     - --     ----   - -  - --  --       -  -    -  -  -- -   - -  - -- -  - -
-  -   -  -   - - - ---- -     -- - -   -  - - -  --     --- - -     - -      --- --           -  --
- - --  --      -           -       --         - --     -    -             - - -    -    - -    -  -
- - --- -- -  -- --  - --    -   -             --   - -  -    --     -  -    -      -    -   - -  --
-      - -  --     --      --  -     -   - -   -  -  -  -  -     -- -     --  -   --    - --- -  ---
--       - -  -  --  ---   -   -   - -         -      -  -        -   --       -       -  - -  -  --
-   - - -  ----     -         - - - -  --      - -- -    --- - - -  - -    --      --         -   --
-       -    -        ----  -   -     --  ----  -       - -  -      -   -            -       -  -- -
-- --      -   -    --    -- - -    -            - -  - -  ---   -      -      - ---       --      -
---      -  - -         -   - --   ----   -   - -            -    - --         - -   -       - --  -
-  - -  -- - -  -      --    -   -  - -   --  - -  - -   -  -  -  -      - - -       -    -   -    -
- -   -  - --  -  -- -         --      - --    -      -   - -    - -- --       - -  -        -     -
----------------------------------------------------------------------------------------------------
