100
100
----------------------------------------------------------------------------------------------------
-  -  -   -      - -   -      -    - -       --   -- - -  -   -    -         - --     --           -
- -  - -  -      -   -    -  - -       - -  - -    --       -  -    -   --  -    ----          -   -
-- - - --     -- - -    -  --          -    --     -- -- - - -   -- - -  ---    -      --  -    -  -
-   - - - ---- - -  -     - --- --       --- ---   --  -   --     -   -   -  --  --  -  -    - -   -
- -   ---          -   - - -    -     --  - -  ---     -    -      - - -  - - - -    - -    -      -
-        -  -  - ----  -  - -    -    ----      - -- --    -                   -- - - -- - -     ---
- ---  --      -             -  - -   -  ---     -    ----  -- -          ---    -   -  -   -      -
-- -      -     - -- -         -- -    -     -- - - -   -   -     ---     - - - --- -   -    --- - -
--    - - -- --  -   -- --    -           - --  -  -        -    -  -  -                 - -- -    -
-  -      --     -        ---    -  - --     -                    --   -   -      ---          -----
-- -     -- - --     -  - -       --  -     -- --     --         -       -  - --      - -     - -  -
--    -       - -  - -     -   -     -   --  --  -   -   -    -    ---   -       --  - --      -   -
- - - -  -   - -       - --   -       -        -    - --- -       -    - -     --     -   ---  -   -
-  - - ---  - -     --  ---- -     -      - -  - --           ---       -   - - --  - -- - - ----- -
- - -    ---       - --         --    -  -      -     - -        -- -- --      -   --    -  -   - --
- -   -  --    - -    -  - -  --    -  -     -    - -  -   -  -     - -   -   --- -    --       -  -
-   -   -  ---     -        --  -      -  -    --       -     -  -    -    - -   -          - -  - -
- -   - ---   --    ---          - -    -  --- ---   -- -- -      --    -  --      - ------- --   --
-  - -            -        ----   -    --     -  - -  - -   -     -  - --     -- --   - -      -   -
- --     -    -      -  - - -  ---      -- -- ---  --- - -      - -     ---  -  - -    - -     - - -
-- -    -         - --  -    --   -  -          --- -    - -  -   -       -         -  - -      ----
-  -- - - -  -  ----  -  -    -        ---  --  -   - -  -      ---  -     -   -          --       -
--  - --   - --        -  -    -  -        -   -      - -  -        -  --  -          -     - - -- -
---    -   - - --  ---- - -  --   -    - -    -  - - -      ------ -      -  -       - -- --   - - -
-    -   -- - --  -    --- -  -- - - -   - -   - --- - -- --   -  - ---  ---   - -    --     - -   -
-  -   -          -- -      --     - -    -   -     -  - -   -  ----  -      - - - -     --     -  -
-    -- ---        -     - - --   - --  - -    - - -       - - --  ---         -  -   -  - - -     -
- -       - -  - -   -  -   - -            -     -    -    -      -  --  --  --  - --  --  -  -- - -
-  -  -- -  --  -   -    -             ---      -       --  -   -  -    -   - - - -  - - -    - ----
-- -- -     -   - -    - ---   -      -   ---- - -     --   -    --  --   --- ----    -  - - - -   -
-  --    --   -  -  -- -     -  -      -    -       -     ----     --      - -  - - --   - -   --- -
-   -    - -  --  -  -    -              -   -  -   - --  - --           -    -        -      - -  -
---- -     --  - -   -  - --     ---   - --- --   -  -  -- -   -   -  -     -     - -   -    -- -  -
-   -  - - --         - -- - --    -   - -     -  - - --  --  -  - -     -  - -    -  -- -   --    -
----   --- -  --  - --    -   --  -   -        -     -      -     --   -  -  -- - --      -    --- -
-    -  - - --    -   - ---- -   -  -- ---  -- -  --   -     - - -     -- --  ---    -     -  -   --
---    ---    - -  -   - -   --              -   -   -   ---  - -  --    -   -     -- - -   -     --
-  - -     -    - -  - -        -    - -          -- ----  - -- - - -   - -- -  - --  - -     -  - -
--- --  --    -     ----  -  - -   -    --   -          -- -  --  -- -- -    -  -      - -   - -   -
--- -     --     -       -   - -  - - -  - --   - - -  --   -      --   - -    -    -  - - -    -  -
-   -        -        - - -    -     -  - - - - ---            -- - -   -     -      -     --   - --
- -       -   -  -    -- -- --  -    -  - -    -   - --  - -    -    -     -   - -  -  --       -  -
-   --   --  --     - - -   -     -   --  -  -  -      -    --   - -       - --- -  -    -     --- -
-  -  - -   -- -  -   -    - -  --        - -   --     - -    -     ---     -   - - - -    -      --
- -    -     -   -   -- -   - - -   - -  -- -     -    --   -  - ---     - -  -       - -    - -  --
-    --  --  - -   -   -  - -  - - -   - - ---      -  - ---- -- - --    - --     --        - --   -
-- -     -       - -  ----       -     -  -  -  -    ---  --  -            -  -- -   -  - - - --   -
-      - ---   --    -   --       -  -     -            -       - -    - --   - - - - -  -- ---    -
--- -     - ----  ---      -           -  -- - - - ---  - -    -   -    - - -   - -     - -  - -   -
-   -  ---       -        -  --  ----  -          -    -- -    -     --           - - -           --
-   -   - -    -    --   --    --    -        - --   -         --   -    - -          --  -   - -- -
-  -   - -  -    -- -       --  --- -     - -- ---  -  - -      -- -    ---  ---  --               -
-- ---  -  -      - - -- - -  - -   -   -- -  -    --  --      --  -  - -    - --- - --   -        -
-            --      - -     -        -          --   -     -  -       -   -  --- ---   -   -  -  --
- -  -   -- - - -- -- -    -         -    -   -     - ----  - - -            -   -  -  -    -      -
-    --     -  -  -      - -   - ----  -      - - -- -     - -- -  -          -  -- -  -           -
-   - -     -   --- - -       -  -        --    - -    - --  -      -  -    -- -       - -    -    -
-   -     - -   -    -  - ---  -     -                    -   -- - -    --- - - -    -  --  - ---  -
-    - -       - -           -   -- ---      -   -  -      -    -      --    - -  --  --           -
-  - -  -   -- - -   -    -    -       -     -  - --- -      - -  -   --    - -  -      ----- -- ---
- --- -         - -   -     -   -    -  - -  - -   ---  -       - -   - - - -   - --  -         -  -
--     -  ---   -     --    - --   -   -  --    -    -    -   -- - --     --   - --    - - -    -  -
-   -  --          -        - -   - -     ---    -    --  -   --      -     --       --  - -     - -
- - ---    --      --  - --    - -  - - --     -   -  -       - -  -           -----   -    --   - -
- -  -  --       -   - -     - -        -      -- -    - - --   --- -  -   --    --       --    -  -
-     -  -      -     -  -- -       -  - -- -       -- -  -  --- -  --   -   - --   - --    -- -- --
-- --   -  - --   - - -  - -     - -    -- -      --    - ---   -    -      - - --- -    - -- -    -
- -  -       -- - - -  - - - - -- --  -  - --  -----  -       -   - --                  -       -  -
-   -   - - -- -  - - -- --   --     - ---    -      - - --- -     -       -  -- - -   -  - - -- - -
--   ---  -  - -   --  -  -  -  -  -  -      -  --- -    -  - - -    -     -    - -- -      ---    -
- -      -           - -    - --   - -  - -   - -         -    --   -      - - -             -   - -
-    -      -     - -  -   -    -  -  -- -            -       -  --        -- - --  -  - -     -- --
-     -  -            -  - -  -     - -   --              -  -   - -  -  -   - -          ---   -- -
-  -  -- -              -  -   --  --  - -   --     --  -    -  - - - -   -    -  -            -   -
- --      -                  -  - -  -   -     - --  -    -   -       - -      - -   - -   -  - -  -
-- -     -  - -    -   -   - -  -  --- -   -  -      -     -- ---- -   - -  -     --  -   - -  -   -
- -       - - -- -   -  - - -        -  -    -   -      -    --          -             -   -  - -  -
- ---   -    - --   -   -- --   --         -  -  ----- -  - -                 - -       - - - -   --
-- -  -  -- - -   - -- -- -    - -   ---   --     - -    -  ---     -     - -   - -    -  -   -  - -
- --  ---      - -  - -  --  -        -- - -- -      --        -       -  - -      --   -   - -   --
-    -             -    --   - -- - -   --        -- -   -   -  -  --      - --   -     -  - -     -
--     -      -              -          -   -      -  -  - -   -      -- -   --  - ---   - -    -  -
-    -   -  - -  -  -     -  -   --  -      ------      -  - ---  -   - -    -         - -  --  -  -
- - -   -  -         --- - - -   -    - -   -            - -- -- -  - -  - -    --- -  -- -  -  - --
--  ---  -  --  -  - --      -  -    - -   -      -    -  -  -  -      -- - -  - -     --   -    - -
- -  --   -  -       -  - -          - -  --  -    -           --     -          - --- - -   -     -
--  -   - --   -- -- ---- --  -     -- --     -     - -- --     - -       - - - -      -   - --   --
-         -    --      - - -       -      -  -      - - --- --    - -   -  -- - -- - -   --    -   -
---  - -  -   --  -  -    -    -        - - --  -  ---  -        -  - -- --    - -     -    -  -   -
-   -  -    -  --      ---   -      ---  -     -      - -    --     -           -  -         -  -  -
--   - - -   -   --- -  - - - --    -   -  - -  - - -     --   --      --   -   -          -   - - -
- -      -- -    -          -    -  -- -  -  --      --  -    -  -    -  -            -    -  -   --
-  -  ---  -       -     --  -     - - ---            -  -  --  --  -  -- -- - -   --    --     -  -
- ---  - -  - -          -          -  - --   -- -  -  - - -- -  - -  - --  --- -      -  -       --
--   -  - --      -   -      - - --          -  - - --   -    - - --    -- -   -  - - -         -- -
-  -  --    - -        -  --     - - -  -   -  -  -   -   -   -     - -   --  --  --    - - -      -
- -   - -- - -    - - -        -    -   --     -    -- - -  - --   -  -  --  - -- - -   -        ---
- - -  -  - -  -   -  -       -   --    - -      --   -  -   -   - -     -    -  -   --     - -    -
----------------------------------------------------------------------------------------------------
