100
100
----------------------------------------------------------------------------------------------------
-   --- -     -   -   - -        -         -      -     -     -   -   -  - -     -     -           -
-  - - -- -     -    -         -     --    - -   -           - --   -- -  - -   - --  -  ---  -   --
--  ---  - -  - -  --  -     -- --- -    -                -      ---   -   -    --  --- --   - -  --
- --    -    -  - ---   -   --     - -   -        -- - -   -  - -  -- --    -    - -- -     - - -  -
- - --     -      -  -   -  -- -        --             - -  - -      --  ---   -           -     - -
-    - - -   -   -    - - -    - -- -  - ---      -   - ----  -      -- -      -- - -    -    -- - -
-           -      -  - -   --         -    -  --  - -     -- -        -- -- -  - --   -  -- - -  --
-    - ---  -    -   -     -   -         -   --  - -  -- -       --  -- - -      -           --  - -
-  -      -- - - -         -    - --  ---        - ---- - - --          -  ----  -        ---     --
-- -    - --    -   - -    - -    -        -  --  -   -  -       -  - -   -   -           -    --- -
-     -- -  -      - -  -   - -  ---- -      - - - -  -   -    --    --    - -    - -    -  ---    -
-            --    -   -  - --    -  -     - -- -  -   -       -         -- -   - - --  -      --- -
- -  - -      - --     --  -         - -- -  -   -  -      - -      -     - -     ---   -    -- -  -
- -     -----      ---  - -       -  - -        -      - -   -    -- -          - -    - - --  -   -
-  -  - -  -  --  -  ---    - - -   -      ---       --- -       - -  -   - -   --    -   --     ---
--- --       - ---        -      - -   --- -         -  - -   - - -       --  - --      --      -  -
-  - -  --   -     --   --      -   - -  -- --    -- -   --     -        -     -  -        -    - --
- -  --  -   -  - -   - - -         -  - -       -    - -     -  - - -    -  -  -     -            -
-     --     - --     -  -     - -    - - -- -   -       -       -    - - -   -  - -   --       -  -
-  --    - -   -     -- -      -- - -- - -  -  - --  --   -  -    --   - - -  -   --     -   ---  --
--     -      -    - ---  - --  -   -  -  -  ---    -     - --          --- - -- - - --    -      --
--    -  - - - -               -  -   -    --      --- -    - -  ---                         -  -  -
-- -   ----     - - - - -  -  -   ---     -  -- -         --          ---- -    - - -    - - -   - -
- --     -    - -       - - -    -   --           --      -   -- - --    -    ---    -- - - -  - - -
- - ---  -   -   -   --  ---    - --  -   -      --         - - - -  - --   -   -      -- -   - - --
-    --  -  -- -     - ---   -- - -    ----- -     -    -      -     --    -    -      - --     -  -
-- -     --  -   ---   -   -  --   -    -        -  -    - -     - - - -  --     -  - -      -- -  -
-   ---   -   - -   -    -----  -    --- -- -   - -   - -         -- -      --    ---  - --    -   -
-- -        --          - -  -   - -    - -  -  -   - -   -- --  -         -    --- - -  - -- - - --
-     --      --   --  -      -     -          - -   -- --  -      -  -    - --   -- --       - -  -
--    -   -  -      ----              - - -          -       -      -        - -- -      --  ----  -
-  -  - - - -     -- -    ----    - - -- -  - --    -  - - -  -       - --- -        -  - -  - -   -
-   -- -   -  -       --     -         -- - -  - --  -   -    -  -- -   -   -  - --   - -  -   -   -
-    -    -        ---   -   -  -        -  --   -              -  -    --        - --         --  -
- - - -      -     -       -      --  - -  - -     - -  -  - -       --    -   - -     --- - -    --
-     -    --   - - --  - -- -   - --         -  - -   ---               -- --   -      -   -      -
--- -- --      -  -  ---  - --      -    -  ---   -    -      -  -- -- -      - - -   -- -        --
-   -- -              - -  -   - -  - - -        - --    -          -    -  --    -    -       --  -
- -     -      -  ---- - -      -  -   -       --      -- --         - -- - -   -- - - ---       - -
-   - - -           - -      -     -  -     -- --   ---     -   --       -  - -   - -     -  --    -
-  --  ---   -- - -     -  -  --              -  -     ----  --     -  -     - --         - -    ---
--   -     -  - - - - -  - -- -   - - - -  - -  - - - - - -         - -      -        - -  -   -  --
-- -     -    -   -         ---   - - - -- -         -- - - -     - ---    -      -   - --   -     -
--   -     - -     -- -----    -     -   -      --- --   - -  ----   -       -   -   -     ---  ----
- -   ----   --   - -         - - - -   - - -  - - -    -        - -        - -   -     --     -   -
-      - - - -  - -   --  -     - - -- -   -   -  -  -     -  --  - -- - -   -  --   -  - - - -  - -
-   -    -        - --  -  --       -     - - - -     --- -     --  -   -  -   -  - - - -    -- -  -
-   - -    - -    -      ---  -       - -- -  --            --     -  -       -     - - --- -    - -
- -  -   ----    -- -  -   -                    -    - -   -   -   - - -       - -  -    -   -  -  -
-- -    -           --    - -     - -  --- - - - -- -             - - -   -- --       - --  --     -
- -  -  -  --- --   -   - - --  - -   -    - -   -  -          - --   --    -  -  -- -         --- -
-  -  - --  - -      -  -      -        --    - -           -    --    -     --              -    --
- - -     -  -- --     - - -  - --  - -- -          -        -    -  -- -   -   -- --   -- -    -  -
- -- - -   - -      -      - - ---  -    ---  -   --  -       --   --  -     -  -   -    -  - -    -
--           -  - - -- -  -  -    -  -  -    - -- -- --    -  -    - -  -   -  - -- -              -
- -   --          -  -      -     -  - - - -  - - --       -  -     -   ----       - -   -       - -
- -     -- -   - - ---   -- -  --        -- -    -    --  -     --  - -     -    - - -    --   - - -
- - --- --   -  -- -    ---  -    - -- -         -      -  ---      -      - - -  - -    -     -   -
-- -  -  - - -  - -     - -      ----       -   - - - -        - - -  --  --  -- -       - --      -
---      ---         --  -  -       --  - - -  --  --     - -  --     -  - - -  -  ---   - --    - -
-    - -  - --- --         -     -     -     -   -   -  - --  -  -  ---     - -   - -    - --     --
-  -  -   - --  --   -    --  - -   - -     -    -  -- - - -- -- -       -            -       --  --
-----  -   -  - --  - - --  ---- -  - -  -    -  -     - - --      -   --              -   --     --
-----    -----  --  - -     -       --          -   -    - -  -           -      -- -  - -  -- -   -
----    -  -  - -  -    ---   -  - -  --       - - -  --  - -         ---           -           - --
------  -     -   -     -  --     -  - -       -  --    --  - --  -  -  --  -         -    ---   - -
-  --   -      -  -   -   --  - -  -  -     -  - -        -  - - -    -    --        - -   --  - - -
-     -  -   -         - -  ---    -   -   -      --   -- -       --- - - - -       - -  --   -  - -
-   -- -  --  -  - -    --       -  -     - --   -- --- - - -  -     -- -  - -                 --  -
-     --        - -  -           - - -  -   -   -   - -      - --  -  - - - -      --       ----  --
--  - --  -- --   -    -  -  -- -  - -   --     -       -     - -   - -    -     -        --   -   -
--   -      - -   -- --    -  - -         - -    --    --  - -   ---   -       - -      -   - - -  -
-    --     -  -    --   -     -- - - - - --   -  -  -      -  --   -  -----    - -  - -     - -- --
- -  -  -   -     -         -     - -  -    -  -     - --        --  ---   -     -     -      -    -
-   -   -     -- -   --  -   - - -- -  -  --    --   -   -  ----   -  - -- -  -    --     --  --   -
- -       --           -      - -- -    -      --   --  -   -  -  -  - --   -   -        -- - - -- -
-  -- --     -   - - ---         - - -  -- -  - - -- --  -    -   -      - -  --  -          -   ---
- -  -   -  - - -  --   - -   -- -   - --       --    -   - -- - - - -    - -        - -    -   -- -
- -  - - --     -    -   --  -    -  -   - - -       -            - ---       -- -  -  --  -  -  - -
- ----   --      ---    - -  - --  - ----  -   -      -  -  ---- --       --   -      -  - - ---   -
-  ---  -      --      -      -   -   -  --    -           - - -     -  -- -     - --   -  -   -   -
-  --- - -   -          -- - -     -     -   -   - -   -  - -   -- -    ----     -    -     - -  - -
----    - - ---- -  - -    -      -  -  --  -  --   -       - -   - - -  -  -  - - - -  --    -  - -
-        --   --  -   -   - -    ---    -  -   -- ---  --  -    -  -    -   -  -  - -- - - --- -   -
-   - -             -  --    - -  - - -      -- --            -  -       - -            --       - -
-   -     --    -    --         -   -    - - -    -- ----   - ---    --   ---  ---  -   --  - - -  -
--     -      -    --     -  -     -     -- -  -  -   -  -   -   -      ---  --        -  -  -- - --
-        -- - --   - -       - ---        - -  ---- - --  -    - -            -       -- -  -      -
-  - -  --       -- - - - -- -  -     -  -  - - -   -   - -- -       -      -     -          --   --
-   - --   - - -    -- --- -    -   -- - -- --  --   -  - --       -   --   -   -- --  ---    -    -
- -  - -  -                    -  -           - --- - -  -     -    --   --     -   -     ---- - ---
----   -     -     - - --- -        -   -    - -- -  --- --   --  - -        -- -     ----      -  -
- -   -- -  -  -    - -  - - -      -     -   -       - -      -     -      -   -   -    -   -    --
-   ---    -  -- --  ---  - - -  -   - -           -  -     -   -    --      -     -  --- -    - - -
- --   -    - -   ---        -  ---    - - -- - - -   - -     -      --  - - - -       -    - -  - -
-- - -    -- -  -    -- -   -    ----   -      --  -      --- - -     -   ---    - --  -  --  - -- -
- --  -- --   - - -            -    - -  -- --  -       --- -- -   --  - - -    -- -  -  -    -- ---
-     -    -  - -  --  -     -  - -    -             --       -     -   -   ---        -   -       -
----------------------------------------------------------------------------------------------------
