100
100
----------------------------------------------------------------------------------------------------
-       - - -       - --         -    -   - -    -           -    -    - -  - ---  - - -- -- - -   -
---- - -              - - --- -     - -    -    - -   ---  -  ---   -   -   --    -       -- -    --
-       -      - -                -    -   - -    - -      -        - - --  --       - --    - --  -
- -       -   -       -   -        --  --    --- -  --- -  -----  -     -  - -    - - -  -  -      -
-  -   - - -  -  -- -- -  -  - -  -  - -   - -         --     -  -  -   -   -  -    -    -      -- -
-   --    --- --- -     -   - -   --     --      ---- -  -  -    - --            - -   -         - -
- -        - -     -- - -     - -   - ----  -   --  --   - -- ---- -  -- -  -    - -  -   - -  --  -
-  - -  ---- - -    - -    ---- -      - -     -  --  -  -    -     ---  --      - -     -   --    -
-   --   -  -- -- - - -   -  -   -   --       - - -     - -       -- -   - -  --       -  -- -    --
--                         -     -  --- -       --        -  --       --  --  -  --     -   --  -- -
-  -- -   -  -- --  -   --- -       -  ---  ---   --  -  --    -- - --    -         --  --      -  -
- -      -  - -  -   --    - -       -   ---- -  -- -      -    -       - -  -        ---  -  -  ---
-   -     -  -   - ----  -     -   - ----- - -          -  -  - -    - --     -                    -
-     -   -- -       --    - --    -           ---   -    --       - -    -----  - -     --   --  --
-      - -  - -    -         --      ---  -   -     -    -- - -  ---     -    -- - -  - -    -  -  -
- -    -   -    ---  -   -       --    -      -    -     -  -  --  -  -  - - -  ---    -    - --- --
---   -   - -    - -    - ---  -     -    - -      -  -  --     - -     -  - --    --    -      - --
-  - - --   -  -- - -         -       -  - -   -    - - -   -      - -         - -   -  - - -  -   -
-   - - -    -      - - ---    -  -    -   - -   -  - -    - ---    - -      - -- -- -    --  -  ---
-             -   --   -    ---   -- - - -- -        -  -  - -  --- - - -     -  -     -   -  -    -
--  - -- - ---  -             -  - -  -      - --  --   - -  -     -  -- -   - --  ---- - -        -
-            ---       -        - -  - -  ---    -- -  --  -  ----  --    - -          -    --    --
- - -     ---        -     --   -  -    -     -- -    -    - -             - -- -- --        ----  -
-       --     - -  -  - - - --  -    - -  -      -   - --  -   --- -    ----   - - -  - -- - ---  -
---- --  ---   --    -  -  -  -    -     -  - -  -- -  -    - -   -  -    -     - -  -     -    -  -
- --          -  - -    -   --  -        -  - - -      -- -  - ---      -  -- - - --  --   - -- -- -
- - -      -        -  -  -    --  - -   --    - -     -     - -  - - -   -     -   -          - - -
-- -   -     - -       - -  --  - - - -   -  -   -  --     --  - -    - -  -     -     -  -     -  -
--   --  - ---  -   --   - -    - -   -     -    - -  --- - -    -   --      -  -  - --  -      -  -
-- --  --    -    -  -  --   --    -  -   --  -            -      --  -  ---- -    -  -   -  --- - -
--         --  - - -  -   -           --  -  - - -    -  --      -    - - -      -  -  -           -
-   -  -- - -  --     -  - -  --    -   -    -    -- -  -              - - -     --  -    -- --  - -
-     - -- -- -      - --   -    - -     ---   - --    -   -    -- - -  -  --        - - -       ---
-      -    ----  -      -   --- -   -  -    -- - -     -        -  -   -   - -        --  --   -  -
-   -             -   ---- --   -  --       -     - --           - -    -    -    -   --  - -  -  --
- -      - -    -    - -     - --   - -  --   --   -- -  -   - - -   -  - - ---      -         -   -
- -  - - - -   -  -   -   - -   - -  -   -         -   -  -     - -  ---   -  - -- -  --    - -    -
-  -        -        -  -     - -      -   - - -  -     ---  -   --     --- -     -    -   -      --
- -  -   ----      -  -- - -   -  -  -- --  -  - ---    --   - --  -  -       --- -- -      ----- --
-- - - - - - - ---      -  ---   - -       --  -          -       -     -  -    - -     - - -      -
-   - - - -  - -     --   -        - - - -     -    -       ---  --- -   -      -  --       - -- ---
-  --           -   -- --  - - -  -   -     -         -        -- -   -   -  --  - -- -  --- -     -
-    --  -       -   --  -   -- -  -      --     -  -- --    -   -   -     -   - -   -       -     -
-    -   -  -- -   -   -- -  -   - - - - -   -         -    - --  --  -    - -- --- --    - -      -
-   -- - - --  -   - --- -   - - -  - --  --     -   - -   -  --  - -  ----      -       -     -  --
---    -   -  - -  -       --- -  -       - -----  -    -    -  -  -  - -   -         -     - --   -
--- ---   - -     -  - - -  - --- --   -    -      -      --- -   -      -   -      --          -  -
--- - - - --   --  -- -    --  - --    -   - -  --  -   --  - - --     --  -  -         -   -    ---
-  --- -    -  -  - -    -   -  -  -  -  - - -  - -       - -- -   -    - -  -  ---- --  ---- -    -
--   -           -        - -  -  -   -      - -   --   -     ---     -   -      -     --   -    - -
-   --   -       -       - --           - -     --  --    -     -  - - -   -    -     - - --  -  - -
-  -  -  -      -  -   ---       --   --   -- -         -   --  - -   -      -   --  --            -
- -  -     ---   -  --   --  -  -  ---       -  - - -  -      -     - -            -      - - -    -
-- -  -  -        - -  ---  -     - -  - ---  --       ---  - - --  -     -- -  -  --  -      ---  -
--   -- - -    -  -- -       -   --           -   -    -- - - -    -       --  - -  -             --
-      -  - -- --         -- -- -  -   -   - --               - -  -      - -  -      - -- -       -
- -  -   ---     -  -- -  --  -   --  - -     - - -  - -   -    -  - -------    - --      - --   ---
- --             - -         - ---        -  -      -- - --    --        -  --     - -     - - -   -
--   - -  -    - - -  - --        -        -         -            ---                - -   -    - --
- -    --   --     --  - - -   -   -  -  -  -- -   -- -- -     -  --    -  -        -   -       ----
-                -  - -- - -     --     -      - ---         -  --  - - - -     ---         -   ----
- -  -    - -   -    --   - - -- - - -  -  -   -         -         -    -  -  -  - - --   -    --- -
- -  - -   - -      -   -   - -   -   - - --   -   --   -       - -      --- -    - - - -- -       -
- -   -      -   -  -     -  - - -    -  -      -  -     --    -- -- -   - --- -- -     - --  - - --
- - -- -  -  --   - -  - -         - - - ---  -  -      - --    -  -   --               -     -- ---
-    -  -  -   -   --         - - -    -     -        -      - -   -       -    -- ---- - -  -     -
- -  - -       - --     -  - -    -       -  -     -  --  --     -  -  -- -         -- ---  -     --
-   -   -  -  -     ---  - -  - - ---     -   -    --  ---     --  - -    -  --   -   --       --  -
-  -   --       -     -  -   -        -- -      - -        ----   ---- --  -   -- -     - -      - -
-   - -   -  --- ---   --  --  -         ---         -  -      - - -                -  -- -       --
-    -   -  - -    -  - -    -   -   -- -     ----   --   -      -       - -      -   - -- - - -   -
-  -- -   --      --- --  - -    - --  ---  -  -   -  -  -     -  -- - -   -- - - - -   - -        -
---     --  -    -       -   - -  -   - ----   -  --  -  - -  -  -  --    --  -                    -
-    -- -  -      - -  -  -   -  -      -   -    -  -     -     - -    -- - -       -     -   --  --
-  -       - --  -   -                       -   -- -       -  - --      - -- - -   --      -   - --
-   -      --     -   --  - - - -- -  -      --    -  -  -         - -      - -- -  -    -  -  -   -
-   -       - --- --     -   - -- -   -           -  -- -     -  --   - ---  -   -    -            -
-   -    -      - - -    -   - -  - - --  -      -  -      -   -    -  -     -         - --  -   - -
--  --- -      --   -  -    -- -- -  -- -   -- --      -  -  -        --  -  -            - -   -- -
-          -      -  -    --   - -    --    -    -  - -  - --  - -  - - -   - - --  -  --  -  --   -
--  - - -  - - --- -        - ---    -  -    - -  --   ---               -- - - - - -  -     --  - -
-  -   -- -    - - -     -- -- -   -      -  -   -  - - -  --       --   -   -   - - -   -     --  -
- -  -       -- -     --   -     - --  --  -  -   -   --  --    - -      -  -   --   --     -    ---
-   -   --    --  -      - -- -  ---         -           - --   -      -    --     --   - --  - ----
--  - - --    - - -  ---        -   - - -     -      - -     -   -  -    -  -    -   -    -- -- -  -
-  - - -    - -   -       --  -      -  -  -    - -   -   - -   -   -  -- - - --   -       - --  ---
- - -     -   --  - -  -   -  -   - -    -    - -      -     - --   - -   - - -       --  - -      -
- -    -  -  --      -      -     -    -  -  - --- - -  - --     - -         --  - - -      - -    -
-   - - -           -  - -   - - - --  -- -   --- -   -- -- -- -    -  ---     -- ---      -    - --
--   --  -  -    - - ----    -     -      -    -      -     - --    -       ---      -    --       -
-         -   -  - -      -- -- -    -      --    -  --  - -  -- -  --- -       --   -      --     -
-  - --    -    -- -    --  -    - -  -   --- - - - -  --       -    -    -       -   -  -    - -- -
----  -  -- --  - --  -             - -  -  -   ---  --  -- --      --        -  -    -            -
---  -  - --   --   -  -    -       -       -      -    -----      -     -           ---  -   -- - -
-- -  -     --    -- - - - --  - -  --       -- -   - -- - -   -           ---  -         ----   - -
-      --    -   -   -    - - -          - -  -      -  -   - - -   -   -  --  - -   --  -    -    -
-   - - -   - - -  -   -      --    -  --  --    - -       -     --    - -- -  -   -   -    -   - --
- --- -           -      - -     -            -- -    -                --  -  - -  ---  -       -  -
----------------------------------------------------------------------------------------------------
