100
100
----------------------------------------------------------------------------------------------------
-    - -   -           --  - -   -                      - -       --   - -              -     -- - -
--  -     -     -   - -       -     - - -     - -             -     --  -   --- - -  - -  -  -    --
--  ------ -   - -    - - - - -    - -  -    -   --  - - --- ---- -- - -      - -   -  -    -  --  -
--   - --      -         -    ---      --  --     -    -----     --  --   -     -    - -  -  --    -
-        ---- -  -  - -  - --       - -      -  -   ---    -   -- - - -    -        -     - -  --  -
- - - -       - - -  -       --- -       ---    ---- -    -           -     - - --    - --- --  -  -
- -   - --   -   -  -  -      -  --  -- -        --- -   - -   -  - - - - -  - -           --  -   -
-    -   -    -   -   -            -    - --  -  -     -   -    --  -       --   -   --  --  -    --
- -   - - - -  ---  -- - - --   ---  -  -        -           -    -   -  --   -    --    - -- -    -
-          -  - -  - -  -   --           -  -      - - - --  - --  -    -         -   --  -  -   ---
- -             - -- - - -  --  - -   -- -  --  -   --             -     -      -  - -  - -   - -  -
-        - -        - ---   --      -  -   --  - ---  - -     -   - -  -  - -   - -     -   ---    -
-  --     - -  ---   -     -          -          --  -  -- -   -- - - - --     --  - -   -- -  -   -
--   -   --  --    --  - -    -          - --   -   --   -   --    -     -   -       -    -   -  ---
- ---    -        -  -  -   - -- - -          - -      -     -  -         -  - --  --   --         -
- -   - -  -      -- -- - -  - - --    -   -  - -  -  -   - - - -- -      -   -   -  --   - ---    -
-    -- -     -- -  - - -  ---    -   -   -      - - -- --     --     --- -  -               -   - -
- -  - -   --- -- -      -  -  -   -        -- ---     -          -  -    - - -    - -  -    -  - --
-       ---        - -- -- - -- - - -  --                     -  -  --       --     -        --  - -
- - --         - -  - --    -   - - -   -     - -   -   -    - ---   -  ----   --  - - - - --  - - -
--       ---    -     -    -    -  --     --- -       - --      --  - -    -     --  - -     --    -
---    -      -     -    - - - ---       -- -       -  - -- --      - - --   -       - - - -  - -  -
-      -- -         - -- - -  --- - - -      -- - --   -  -     - -- -       -   -- -    - - -     -
-            -    -- -  ----   - -    -  - -        -   -     - ---     --    -       -   -      - -
-       - -  -  -     -       - -     - --  -  --     -  -     - -    -  -  - - -  -  -- - -    -  -
- - -   -      -  -   -- - -      --   -  --   -      -  -  -- -      -   --    -   -      ---     -
- -  --   -  --    -   -  -  -- -      --- - -   - - - -  -   - --     - -  -         -    -       -
-     - ---  -   -  - -    - --    --   -   --   - -  ---   --      - --  --      -  -   -- -    - -
--  -  --   -- --  -    --- -       - -     -      - -    -  -  - --     - --- -  -  ---      -    -
-  -     ---   -  - - -   -- -    -    -  -   ---    -      -   -         --               -   -   -
- -         -      - - -   - -   -         -           ---   -  -     -   -  --   -   -   -  --  ---
--  -  -  -        --   - -    -        - - ---     --    --   - - -- --  --   -  - --   - -    -  -
-       - - --       -- - - ---   - - ---       -         -- -          - - -- -   - -   -       ---
-  - -   -       -- -    -      -     -     ---    - --     -    --- - - - -     -         - - -   -
-     - - - --     -- - --    - - -    - - -   - -  - -    -     -     -   -        -   ---        -
-      - -- -  - -    -- - -      - -   - - ---    -   -      -     -  -  --  - -             ---  -
- -   --   - -     --- - --   --  -   - --         -     - --- -        -     -        - -       - -
-  - -  -- - --- --  --    --  -   -   -      - - - -   -      -      --  --  ----   - -      --  --
- -  - - - - -    -   - -        - - -   ---   - - - -- - --  --    -   --         - - -  --  - -  -
- ---   -     -   - -- -  -----  --  --    -- -    - -   -     -   -   -    ----      -   -  -    --
-    -- -    - - --  - - -   - -  -        - - - ---  - - - -   -        --- -   ----  - -   --   --
-    - - -      -  -  --- -- -    -     - - - -         -   ---  -  - -  -- -  -       -----  -  - -
-     -  - --      --     - --           -  - -          --     - -   -      -   -  - -   - ---  - -
-   --     -    ---   --  -   - - -        ----  - - -   -    - - -     -  -  -        --- ---   ---
-  - --    -      -    ---   --                   -    -      -  --           -   --  -        --  -
- -   -   -   -  --  -   -   -   --- -   -  -    -     - -  - -   -   ----  - - ---    -   -- -   --
- -  -  -   -           -  -   - -     -- - -             --   -  - -               -      ---   - -
--   - -       -  - -       - - - ---  -- -       -   -  - -  - -    - --       ---    ---      -  -
----  -- -- -- -    -   - -   ----   --  -    ---       --       -   ---- - -    -   -- - -  -     -
-   -   -    --        -   -    -  -   -   -    -    --   - -- --   -       -  -   - -  - -    - ---
-    - -          -   -   --  -  -     - -  -         - -    --  -- --- ---   --  --- --    - -    -
- -   -- - -   - -    --   ----   -   --    -        -       -  -           -    --     -    -  -  -
- - -   -- -     -    -  -     -   -     - --   - ---     --   - -   -     -- - -     -    - -     -
-  - -- -   -    -  -       - -  --       -    -  -           -- --   -        -            --- ----
- -  -   -   - -  -       - -  --    --- -- - -  - - --   ---          -     -       --- -  -      -
- ---  - -  --  -         -   -  -   -- -  -    -   -  -   -- -   -   -  --  -  - --         - - - -
--  -   --    -     ---- -  -  -- -    -      -     -         -      -     - -  -   - -   - - - -  -
- ----    -   -  - - -  - - - --   -  -- -- -   -    -  -  -             -  -- -   -  - - -   -  ---
-   -   -   -  - - -     -     -   -    -   - -  - --  -        - -  - -- --     - - -- - -  -     -
-   - -      - --   - ---     -   -    --- ---- - - --  --  -   -     -   --  ----   - - - -   -   -
--   - -   -         -      -      - -            - -  -    ---  - - -    --    -- - ---   - --    -
- --     -- - -  -  --       -  --       --            -      --    ---  -   --    -     -  --- -  -
-     -          - -  --   -         --         -  - -  -- - -        -   -  -       - -  -    -- --
- -        --     - - -  -        -   - -     -    -        -    - -  - -   -   -   -  --   - -    -
- -        --   -  -   -- -- - --    - - -      -       -  -    -- - -   -           -  --        --
-  -   - -   -     -    - --  -   -         - -  - -   -     -    -         - -   -- ---  -      - -
- -    -          --    --          ---           - -     - -    -  -  -     -   - --- -   ----    -
--  -  -  -      -     -   - - -     --     ---  -- -      -   -  --   - - -    -     - - -      - -
- - -- - -   - -   --- --   -  --      - -    - -      -- -     - - -  -   -  -----  -    ----- - --
----    - --  --   -         --   ------   --  -      --    - ---  - --  -        --  -  - - - -   -
- - -- -      -   -    --   ---  -          - --    -        -  --       -- - -                  - -
--  - -  - -  --    - - -               -     -  --  - ---- --     - -  --    -   -    --   --     -
-- -      --            --- --    ---   - -  -    --     - - -  --     -     -  -     - - -  -- -- -
- -   - -   -       - - -   -   -   -  --  -         --   -   - -- -    -       -  -   - -  --   - -
-  -  -    --     -   -   --  --     -         -                --  - - - - -  --  ---   - --- - - -
--    - -   -  -  -  ----      -  -                - --    -   - -  -   - -       --  -           --
- -- -  - -        ---          -  -  -  - -  -  - -     -        -  -  - - ---  -     --    -   - -
- -   -  - --   -      ----  -- - --    - --     -  -- -   -  -- -    --            - -  --   ---  -
-  - --  - -     -- - -    -   --- -       -   --   ----- -  - - ---       --  -  - -       - - -  -
-    --      - --   -     -- - - -      --- -  -  --  - - - -    - -  - -             -    -       -
--- -  -  -   - - -- -    - -   -    -      -    -  -   -      - --     ---  -  -   --    - -  -  --
-    -   -    -  -  -  - -                -  --   -           -- -       -       -      -       -  -
-      -      --  -- -       -- --     -      --  -  - - -      - -   -  - -  -- ---       -- --- --
--           -    - -           - ----    - - -  -        --   --           - -     -- -           -
- - ----      -  --     -   --   -     --    - -    -- --    - -- - -  -  - -    --      -- --  ----
- - -      -- - - -   -  - -  --          -     - -      -  -         - - --   -   - --   - -  - - -
- --            -    -- - - -    - -   -- -   ----  -  --    --- -     --  - -  -  - -        -  - -
-    --    - -  -       -      -  -    - -   -  -    -   - --      -  - ---    -    -  - -         -
----  -    -- -    - -- - -    -  - --   -        - -   - -   - - -        -    --  -    -   -   - -
-- - -  - - -  ----            - --    -    - -    -  ---   -      --   -  -  -      -   -         -
-- -  -   ---     - -    -- --  -  -  --  -    -  --   -     ---- -     - - - -----       - -  -   -
- - -   -  - -  - --    -       - -  -     -   -    - --  --  -    - -     - -   ----   - -   - -  -
-  - -       -  --   -- - --  --       - -    --       - - - - -  -  - - -  -  -  -             -  -
- --   -  --- -  - --   --   -   - -     -     -     --  -  -    -  - -   -  -  -   -    - - - - - -
-     -       -   -- -- -  --  -     -- -          --     -- -  -  --  -   -    - --       - - - - -
-  -  ---      --       -    - - -  -     -  - - -   -- - -   -   - - -   --      ----  --  -  --  -
- -- --  - - - -        -    --   -   -   -    - -    -  ---     - -- -    -  --   -  - --  -  -   -
-   -   - -  - -   ---  -       -          -        -        -      -    -         -         - -   -
----------------------------------------------------------------------------------------------------
