100
100
----------------------------------------------------------------------------------------------------
-    --    -         -   -     -   --  - - -   -      -  - -     -   - - - - -  -     --  - -   -  -
-  --        - -  --   --    -- ---   -- --       - -   - - -- -  -  -  -      -   -  - -- -  --- --
- -  -      -  -    - -       - -      -                         -   --       - -- -  -   - -    - -
- -   --   --  -       -         -       --        -- --      -  -   -   -- -- --     -  - - - - - -
- -   -- -         -            -  -      -   - -  - -  - -       -          -    -    --   -- --  -
-    -   -        -  -  --  - -  -  -   -      -- -   --   -- ---      -  - -  -  - -     - --   - -
-- -   - --    -       -    -   -   - - --- -- -   --  -      -          -     -   -  ---      --  -
--            - -      --   - -   -           -   - - -- ----  -  -        -       -   -           -
- --    -- -     -  ---   -    - - -        - -    -- -      -- -    -    - -    -  -   --- -  --  -
-     - -   -  - -  -  -   ---- --        -     -----   -- -       -   - -  - - -  - ---    - - - --
-- -   - -----      --- -  -     -     -     -  - -  -       -  -     - -      -- -   - --         -
-  - -     -  - - -  -  - -- -   -        -- --     - - -   -     - -  -        -          -     ---
-      - --      -  -       -- - - -    -     -    - - -     -  ----        - - -        -  -  -- --
-  -                - -    -       -    - - ---   -  -    -    -      -   - -- - -    --- --  -  - -
- --          - -     -- -- ---    -      -    --    -     -  - - - - -  -- - - -      - -   -   - -
--  -- --   -    -  -  -  - -  -   - -   ---  - -   -- -   -         -     -        -    -   - - - -
-   - -        --           - -     -  -   -----  -   - -  --       -        -  -   -  -   -   -   -
-  -   -   -      - -           -    - --- -     -   -          -          -        - - -   -  -   -
-       -     -  -  -  -  -     -  --- -- - -     -    -- -   -  - -  ---   ----      -  -        --
-  - - -              -  -   -     - -   -  -   -     -          -  -     -    ---    - -- - ---   -
-         -- ---- - - - -  -  - --       -       ----  -   - -  - --  - -     -       -   -   - ----
- -      -         - -         -   - -      -  -- - -     - -         -  - -  --     -  -  - - -   -
--   -       ----   - -        -- --                   -      -      -   --        -   - -- - -    -
-  -  - -    - - - --  - -- - -  - -  -           --     -             -     -    - ----      --   -
-- --- - --   - --    --   -  -  -  - --   -  -       -- -   -  -- -     --  -   --       -   -  ---
- - -   - --- -       -  ----   -   -     --   -   -   -    - -   - -    ---     - -    --   -  - --
--   -   - -  -- -   -  -  -   - --   - - -  ---  ----  -  - - -- --- - ---    -       -    -    - -
-  -   - -- -  -    -  - -  --      -   -- -    -  -- -      -     --  --   - ---     -   -  --- - -
-  - - -   - - - - -  -            - - --              ---       --    -     -  ---- --     -   - --
-- -   - -    - -        -   - - -   -      ---                 - -  - -  - - --     --    -  -- - -
-    -- -     - --   --    ---   - --         -      -  - -- -     --- -       -      -  --   --  --
-  -     -   -  --      -  -     -   - - - - - -    ---          - -   - - --     --   -   --      -
-        - --  - - - - -- -        -    -  -- - -         - --     - -        - --  --  -  -     - -
-         ---- -   --          - -   - - --  --   --   -   --- - -         -- - -             -   --
-  -- - - -        --  -- -      --  -   -  - - -   ---       - --   - --  -  -  - --  -- - - --- --
--    -    --    -      -   -  --   - --     - -          - -- ---       -  ----   -     -- -- -   -
-- -  - --  -    -   ---    - -   -    - -  - - ---          -    --- - -- -  - - - -   -  -    - --
---  -  --   -  ---   -      --   -    -  -           -  --   - -- - -       -- - -  -     -       -
-  -- - -      -  -     - -    ---  - - - - --   - -    --  -         - -       -     -   - - -  - -
-     -   -     ---            - -  -  -  -         --  - -- -- -- -   -            --    -  -     -
-   -- ---- - -   -   --    -   - -     - -  --   -      - -  - -  -  - -     -- -    - -   - ---- -
- -      -    -        -    -     --- --- --  -    -                    --    --   ------  - -  - --
-      - --    -   -  - --    -           - - - - -    -   --  -  -  - -   -    -        -         -
--     - - --- -         - - -  -   -  ---   -   - -     -   -   -- --  -- -  -  -- -       -   -- -
- - - - ---  -- -  -  ---   - - -- --- ---          -   -  --   -  - - -     -  -    -  --    -    -
--    - -           -    -    -         --  --               -   - -    -      - --  -         -  --
- -       -    - --        - - -    -   --   -   -- -    - -  --    - --  -  -   -   -  --     - - -
-   - -  -   - - - - -  --   - -  -   --      --  - - - -   -    - - -   - --   -     -   -  -  -  -
- -       -  - --    -     -        -    -- -     -   - -    - -       -     -  -     -  -- ---    -
-   -  - -  - -   -     - - --     -      -           -     -      - --   ----  - ---- -   -  --   -
- -- -  -          --  -  -      -- -    -- - - -    -    - --     -    -         - -  -- - --  -- -
--    -- -- - -  -     -     -     -   -    --      - -   - - -    --   -   -    --     - -   -    -
-  -     -  -- - --     --   ---  -  -          -     - - -  - - - --  -  -  - -     --   --     - -
- -  - -- -           -     ---   -      - -- -  -- -   -  -     -   -  -       --- -   -          -
-  -   - -  ---- - --  -  -  --- -  -     - - - -      --  -  -    -- -  ---- - -   -     -   -    -
-   -        -    --  -    -  -    --   -           ---      -    -- --      -  - -    -    -    - -
-  - - - - - --  -   -   --       -  -  ---    -    -   --         - --     -  -         -     -   -
-  -   --      - -    -   -- --- -  -       -  -   -   -     -   -    - -        --------  -   -  --
--   - -   - - ---    -    -  -  -  --- -- -    --  -   -       -  --    -  --  -- --  -   ---- -  -
-    -  - - -  -             -  -   -       -  -  -    - -    - --    - -  -    -    - -   - -   - -
---   -  - -           -- -  -    - -  --     --- -  --  -    -         -  - -    --     -    ---- -
- -    -    --  - --        -   -       - -  --  -           -     -   -    - - -     -      -   ---
-  --        - - -  -    -    - -  - --   - -       - -   -  -    -  -   ----  - -     - -         -
- - -    - -  -    - -   - ---   -      -    - -    - -    --  - --  --      -  - -  -   - ---     -
-       ---   -             -  ---     - -- ----  -  -  - - - -  -   -    -     --     -- - -   -- -
-      -  - -  -       -- -  -    - -       -  -      --  -         -    - -  -     -     -   -    -
- -  -        --   -      -    -  --  -    -            -     - - - - --    -    - -     - -  -- - -
---  - -   - -  -    - -    -     -  -- -  - - -  ---  -  --  - - ---     - - -        ----   -   --
-- -  -  - -   --- -   -  -   -    --- -       - --       -  - - --    -     - -- ---  -  --    -  -
- --   -     -  - - - -   -- - - -     --   - -  -   --  - -  - -  - - - --           -       - ----
- -    - -- - --   -- -   -   - -           - -  ---   -    --       -  -   -   -  - -   - --      -
-  -   - - --              -      -   -- -  --     -  -  -    -  --  -    -       - -  -  -        -
- ---  --    --     - -    - -      - -- -  -  ---  - ---   -   - - -  -      - - -               --
--   - - --  -----       -- -    ---- -    -    -  - - - -   --      -  -  -  - -    - -  --- -    -
-  -- - --     -       --      -- -  -   -  --  ---   - -- - -    -   -  --  -- -         -       --
-     - -    -- --  -      -   -- - - --       --  -  -      -   --   ---   -  - -   -  -   - -  - -
- - -  -    -     - -  -- - --   - --  ---        - -    -   - - - - --   -  --- - -          --   -
- -  - - ---  - --    -   - - -  ---       ---   -      - - -  -  - --  -      - - -- -  -- -- -   -
-  - -  - -    - -   ---- - - - - -    -           -    -  --- - - - -                  --    - - --
-   - -    -  --       -   - -     ---     --   ---  - - -   -  -  -  --  --         -    -- -- -  -
---   -   - - -- - - -- -  -     -        -     - -   --     --  - -- -  -   -    - -  ---  -  - - -
-   -       -  -- -  - -   -   -    --   --    --      --  -  - ---  - -     -   --  -      -      -
-- -- -  -   -  - - -  -      -        - - -  -    - -  -  -   - - --   -- -    -     --  -   -    -
-      - --  -      -             -   - -   -- -     -- -    -  -      -  - -    -   -  -  --   -  -
-- -         --    -  - -       - -         --     - -        -  -----    -  - - - --  -     -     -
--   ---  -   -  -- -    -           --- -    - -     - - --  - - -    -   -   -      - -    -   - -
-       - -  -  -    --    - ---  -  - --    --- -   -            -  --   - - --      -  --   -    -
--    ---  -   -          -        -   - - --    --  -      --  -  - -       - -  - - -     -  - - -
--   ---    ---    - -    - --    - - ---     - --  - - -  - --  -   -    -  --     -- - ---       -
- --   --    - -     -   - - -        -   -  --  ------       -    -  - -  -  -     -    --  --  - -
- - --     --  - -- -  --   - -      - - -    -   -      ---  - - - --  - --          - -       -  -
- -    -- - --- -   --  --     -   - --  - - -  -  - --     -   -- - -     -   - ----   -     - - --
- -   -   - -  -         -  --    ---   --- - -   -    - - - -   - - ----  - - --     -      -     -
-           - -  ----   - -   -       -  -      -   -----       -- -- - -     - - ---    -         -
-          -             - --  --   -      -     --  - - - --     --  -   - -   - -  - -       -   -
- -- --    -      --         -  -     - -   -     - -    - -   -   -       --   --   -  - -- -     -
-   -    -   - --   -      -   - -   ---    -    - ---  -    -       -    - -           --   -    --
-  -  -    -      - -         --    -  -  -    -  -    - -  --   - -    -     -   - --  -    - - - -
----------------------------------------------------------------------------------------------------
