100
100
----------------------------------------------------------------------------------------------------
- -   -     -     -          --  -   -           --  - -     - -    -  -   --         -   - -  --- -
-     -  -   -   -    -  - --   - --      -    -       -   -     - -- -    -   -     -  --     -   -
- -  - -        - --    - -  ---- -- -       - --   -   -   -    - - -       -   -    - -    -    --
- --    --   -  - -  - - -- - -   - - -- ---     -   - -       -  - -     - - - -- --    -   --    -
-  -     - --  -  --   --   --  --   - --  - --   --   -  -- --     -- --       - - -  -   -   -  --
- -    ----          -  -     - -       -    - -   - -   - -   - -   -   ---  - -  -   -------- -  -
-- ----   --  -            - -  -   -   - - -   -          -       ---    --  -      -         -   -
-       -      ---- -   -   -          -   - ---  -    - --  -   -     --- -    --    - -    --- - -
- --  --  -   -     - -     --   -  -- -  -     --   - - ---   - - - --  -    -   ---   -  -       -
-- -   -                    -     - -   ---  -- - -      -  -  - - -- ---   -   -  ---   - -     ---
-         - -  - --   -  - - -    -   -     -     -   --   --   -    - - -    - - -     - - -- -   -
--     --   - -   -  -     - --  -   -- - - - - -      -   --- -    -   -  ----   -  -    - --  - --
-        --  -      -      -     -   - - --     ---  -  --     -  - --    -     --     ---   -     -
-        -  -   -   - -     ----      --           - -     -   -        -         -     -  -   -  --
- - - --     -    - -   ---  -  --  -       - - -  --  - - - - -    -   -        -- -- -  -  - -  --
-  -     -   --- --       - - -        -   -    -  - -  - - - - -  -  - ----        -   -   -    - -
--    -     -                     - -    - - -   -   - -      --    - ---  -    -  - -- - - --  - --
-  -   -  -      ---    - ---- ---   - --- -  - -         - - -             --  -   - -    - -     -
---     - -- - -   --       -         -     -- -      -  - -    - -- ---- -    -      - -    -     -
-- -    -   -   --  -  --     --- -  --  - -      - -      -   - -     -    - --     - ---  - -- - -
-     -     -   - -   -     -   - - -    -    -   - - ---  - - -   -     -     -  --            -- -
- -   --   -   - -- - ----- - -  - -        --   -- - --         - --   - -  ----      ---- -      -
- --  --  --   -   --       -  --  -- --       -   - - - -  -   -    --     -  -      - -      - - -
- --    -   -- -   --         -      -     -          -   -   -  --     --      - -   -  - - --  - -
--   - --   -          - -  --   -   - -     -  --  -  -  -   -  -  -- - - -   --       - -       --
--   -    -    -- --     -- - - -- -      -  -     --     - -  - --  -   --           --     --    -
---  -   - -- - -   - - - -    -  -       -           -     -   -          ---  -         - --    --
-  - -     -   -  --      --     -  -   - - ---- -      -    - - -  --            -      -      -- -
- -        - - --      -       -    -   - -    -         - -   - - -      - -  - ----        -     -
-  - --             --     --  -     -  -   -    -----  -- -  -      - -  --- -   -     -     -    -
---      -- - - - - - -   -  --     - - -   - - - -- -- -  -- -   --  -         -   - -   - -    - -
-   --    -     - --          --       -      -  -         -  --    - -   --- --  -  -  --  - --   -
--   -  -   -  --    --  - -  - -     -     -  ----  --- --     -  --  - - -          --        -  -
-- -  -  -   -   -- -- - - -      -   --           ---        - --  -  -     -  --- --  -- -  -  ---
-  -  -   - -  -   - - - -    ---   -    --  -        --    - -        -- --     -  -           -  -
- -  -  -   - -   -    ---- -  - - -   -    -  - -       -  -  -----  - --     -  - - - -    -   ---
--    -  -  --  --  -    -     -- - -- --  -  ---  -      -   -  - - --  --   - -       -     - -  -
-- -   -  -       -    - ---   -    - -   -- -                   -      - -   -  - - - -       --- -
-    -   - -- - -   -  - -  -  - -  -   - --- - --- -   -  ------                  -    - -   -    -
--    -- -- -        - -   - -  -  - -  --  - - -           -     - ---      -    -                -
- -  -      -  -    --   --  -      -- -  - -          -         -   - - -- - -  -   ---           -
- -   -----     -        - --   -  -   - -  -  -  --   -  ---- --     -    -       -     - -  -   --
- - -   - -       --      - ---- -     -  -  -   - --            - --     - -  - - -      -  -     -
- -  --  -- -    -   ---  -       -- -- -  -    -            - -           - -   - -   -          --
-   -  -   -  -    -    -  -     - --   -     -  -  -       --    -- -- -    -- - -  --   -      - -
---       - -- - - -- -  -     -----       - -  - - -  ----- -- -      --     - -            -     -
-          ---   - - - --   --  -    -    --  -- -   -      - --  - --   -  - -  --   ----  - -- - -
-- --     --- -   -- -        --   --      --  -  -   ---  -  - -     - --  -   - -  -  - -  -     -
--- -    -   -      - --    -        --     -- -  ---  - --  - - -   - -   --     -       -   ---- -
-  - - --  -   -    -   ---   -- -       -    -  - -        -      -         --  - --  -     -  - --
--  -    --  - -       -   -     -- - -- - - - - -    -    -  -- - --   --  -   -    -    -   --   -
--- -   -       -   ----   - - -- - --   --- --       - -      -- -- -     - -   -     - -  -   - --
-              -      - -   -    --    -  - -  - --- -- ------ - -  ----  -  - --  -   - - -    -  -
-       ---        -  -      - - - - -  -  -             -     - --  -      -   - -         -  -   -
-- - --         ---    -  ---     - -  -- - - - -  -  --   ---- -- --    -    - --     -         - -
-      - --        --- - -  ---  -       -      -- - -         -  -  --   -    -- -  - -  -  - -   -
-   ---     -- -     -     -       -   -  ---  -  - --- -          --  - - -- - --  -- --      -   -
--   - -   - - -- -   -  -  -   --    -  - - --  - -     --       -            -    -  -     -     -
-     --   -    --   -- - -  --  -  -          --      -    -   --  - - -- -  -         -    -     -
- -      -  - - -- -  - -- - --    -   -   -  -     - - --   --    -- -    -    --       -  -     --
-      -  - - -    -      -  -- -     -- --- - -      -  -  -   - -       -    --    -      - -    -
----      - - - -- - -  -   - - -       -- -  - --  --   -  -      -  - - - -  -  - -- -  -   - - --
-      -- - - - -     - -       -     -   -    -   - -     -   - -  - --   -   - -- -      -    -- -
-- -- -                --      - -   -  ---     --   - -    -  -        -  -- --   - -   -- --   - -
--   -    -- -    --   -            - - - -    --  -    ---    -    ----      -     - -  - -  -    -
-     -  -     --  -       --      - - - - -- --    -- --    -   - -    - -             -        - -
- -    --   ---   - -    - -  -   -    --    -    --    -                  --    --- -      --- -  -
-   - -  - -  ---- - - -       -       -  --- -       - -          -  -  -             ---- --   ---
--  - -   - -   -   --   - -         - --       - -  - - - - - -   --    -- -     - -    -    -    -
-    -  -    --   -- --      ---   -  -    --   -       -      - -     --    - -- -       -  -     -
-   -   --       -     - -    -    --            -    -   -   - - -       -        - --    -    -- -
-   -       --- -    --    --- -   -  -    --  -- -               -   -  -- -  -   --        - - - -
-  -   -    -   - ---   -    -       - - - -  -            - -   -      - -    -   - -  --- --     -
-       - -    -    - -   ----     -      -              -      -       -  -  -       -    -   -   -
-   - --    - - -         -        -     -  -     - -     - - - -      -  -- - - - -  -  -     --  -
--    --             -      -  -  -   - - --- ---  -   --      - -   --  -     - -  -     --      --
--- - -       - - -    - ---  ---  - -       -      --  -       -  - - - --   --      --  -- --   --
-    -   - -    - - -       --         -         -      ---  --    -   --   --  --        -  -   - -
--  -  - - -    -  -   - -    --  -         --     -               -     -    -    - -  --      -  -
--  - -  - -- -     -  -   -  -  -   -  - -    -    -  - - -  --  -      --    -  -   --- -  -  -- -
-  - --     -   --       -     -   -  -  -  --    --          -      -  -       -  ---   -   -  -  -
---   - -  -                        --      -     -    -  -           - - -- -  -  -   - - -    - --
-         -  - -- --         - - --     -- -  - - -   -   --- - -     - --    ---             -    -
----  - - --     - -- --  --       -  - -        - -    - --  -     - -   ---    -- -        - --- -
-      - --      -      -  -  -- --   -       ---   -      - -   -    -       -  -   - --- - --    -
-- -       --- --- - - ----   - --  -    -  - -    - -   --      -     - --           -    - -- -  -
--- -   --     -            -     -- -- -  - -- --   - -- - -  -- ---     - -    -  -  - -   - - ---
-       -  -       --     -  - -  -- -   -- --      --  --    -   - - -         -     -  -  - -    -
- -- --      ---  - - - - -  --    --      -    - -   -   -    -- -    - - ---    -    --     - -  -
-   -      -- -  -- -      -     --               - --   --  -        ---- -     -  - -    - - -   -
-  - -   -  - -     --   --    --  -  - -   - --    - -- -   - - --  -   - - - ---     -- -   -   --
--  -  -  - - -    - --  -  -        -    -   - -   - - - ----  -   -  -              -            -
-  - - -    --  -     ---      - -   - - -   - -      -    -   -     -         --  - ----  -   --- -
-          -   - --      -- - -  --  - --  --   -----   -- -  --  -    -   --- -- -   -  --  -     -
- -  - ---         --  --    ---    -- - -            -     --     -          -              -     -
-  -       -  -   -   -- --  -   -     -  --        - - - -  -       -   -  -   -        -     - - -
- - -       -      -   - -- -   -- -  ---    -   -    -     -   -   -      - --  -    - -         --
-  - -   - --   -        -          -     --   -   -    - -         -  --    - -  ---  -     - -   -
----------------------------------------------------------------------------------------------------
