100
100
----------------------------------------------------------------------------------------------------
-    -   -     -  - -    --   -  --  -   -      -   -  -         -        - - -    -- -  -   -  -  -
--         -- -       -      - --          - --   -      - -  -    - --  -- --   --  -- -     -    -
-  -     -       - - -    - -     -    -   --    - -   -          - -      -- -  - - -  - -  - - - -
-  - - -  - -    --    ---    - -  - -  -- -  -     -  --  - - -  --   -   -   - --   - --   --- - -
-   -     -  -    -   -         -  -      -  -  - -  -   - -  -- -  --- -   --      - - -  -    - --
--        -    -        -    - -  -  -   -- --   - -  --     -   - --        -- --- -    --   -- - -
-    -   -  -   -- - -    -    --   -   -  --      -- -   - --    -  --      - -   -    -  -       -
-  - --  - - - - -   - - -   - -- --  ---     - -      --          --          - -     -   -  --   -
- -   - - ---    - -    -  -- -  --    -  --   --  -  -   ---  - -    -   --   --     -     --   - -
-   --   -  -     -                 -      ----    -   --- -     --    --- -  -   --- ---  -       -
-   - -    -    - -  - --  -- - --- -            - -- -   -  -   -    -       --   -- -- -    --   -
- - -  ----  ----   ---  - -      - ---   -- ---      -  -   - - -    -- -    -      - -  --- - -  -
-    -     -  -    - -       -     - -      -  -  -       -- -      ----     -     -     - -    -  -
--       - -       -   -  --     -     ----   - - -    --  - - -  -   - - -  -   -      - -   -    -
-- --      -     -  - -    - ---    ----       -  ----    -  - -   - ---  -   -   - - - - -      ---
-  -         -  -   -  - - -     - -    -   --           --- -   - -    - -  ---      -   - -  -  --
--     -       -   - - -  - -    -      -     -        -  ---  --  --           -     -   -- -     -
-  -  -  -  - -      -   - -       - -   -  -  -    -   -- -  -    - -  ---   -       - -- - -    --
-         - - - - - - --      --- --   -             ---  -    -- -       -  - --  -  -   - - -    -
-     -     -----       -       -                 -   --  - --  -   ---  - ---    -  - --  -       -
--  -  --           -- --         - -      ---- - - --     -   - -    -  - -  -     - --     ---   -
-         - -   --    -  --     -    --   ---   - -   -    - - ----  -  --     -   -        -    - -
-  - -     -       --      - -    -             -        -         -   -  ---    -    -      -  -  -
-- - -    -  -----  - -   -   ---    -    - -      -   -              ---   -  - --        - -- - --
- --     -  --       - --- -   - -  --  -    --  -   - - -      - -- -   --    - -    - -         --
- -                -- - - -     -  -  -   --     - -        -   -       -   - -   -- -       --    -
-   -       ---     - --          -    -    --  --        - -  -     ---     -   -  -   - -   -  - -
-    -           -  --  --   -        - -  --    -     -      --  ---  -  -  -   - -    --  -   - --
-  - -        -            -       - --           -  - -   -    -   --     --- --     -   --       -
-    --    -  --   --    -  - - -      ----    -- --     -       ---    - -        --   -      -  --
-                 -   - - --- -  - -  -          -  -  ---   ---- --    -  - -   -    -   --  - -- -
- -- -     --    - --      - --      -          -- - --       -- -    -               -   - - -   --
-  -   - --    - --   -    - - --- - --       --  - -- - -    -  - - -       -   -     - -  - -  - -
-   --  -      -         - -  ---    --  -- -  -  -   -       --     -    -- -- -    ----  --      -
-       ----   -  -    - -  --   ---    -  -   - -        -  --             --   -  -    -    -  - -
-        -       -        -    --   -  -   -    -   - - - ---  - ---  -   --    -    -     --      -
-   -        -- - -     -   ---         -        -----           -    --- - ---    -            -  -
-  - --   -- --     ---   -   ----  -  - - -   -   -      ---  --       -- -    --  -- --    - -  --
-  - -   - --     - --   - --      - - --        --    --     ---    - --   --  -   -   -   --  - --
- -  -        -- -  --  -  -  ---   -  -    -  -  - - -  -    -  -            -  -    --       -   -
- ---  -- -  -        -  -  -     --     -        -   -        - --   --- ---      - -  -         --
- -   --  -- --      ---  -    -  -        -  -    --   -  --   - - -- - -       -   - -  -- -  -  -
- - ---     -  - - -    - - ----    --  -   -- -  -  --  -     -   - - - - --      - - --  -     ---
--      -  - --       -         -  - --     -  -- -       - - --  -   ---  -    -   -       -- -   -
-  - --  -- -  -  - ---   -   -      -  - --      -  - -      -   -   -   - - -   - -  --  -   --  -
-  --      - -- --                   - -   -- - --- --  -    - -  - -- -    -  - -     -     ---  --
--    -  - -     -     -- - -  --  - -        -          -   -   -   --   -   -- -        - -   -  -
--- -     -     -  -- -       -- -     -   -   -     -- - ----    - -  - -     -  - --  --        --
-       --  -     -     --- -    - -     -   -  -     -   -  --    -      -     --- -  --         --
-  - ----  -  -  - - -          --  -   - -    -- --   --   -        -  -  -- -      --     -    - -
-     -- -- --   - -   -   --  - --         - - -  -- - - - -     -    -   -   -- ---    - - -     -
-        --          --   -    -     - - -- -    -  -   -- --- ---       -   --      -    -  - -   -
-   -      -- - --      -   - - - --    - - --  -      --     -   -  -     - -         - -   -   - -
-    -   -        - --        -         - - ---   --     -   -----      -               -  -       -
- - -  - ---       -- - -   - --- -    --  - -    - ---   -      - -     -   - -  -- --  -     - - -
- ----- --    -   -    -  ---  -    - -  -          --- - -  --- --    -  - - - --   -   -- -  -   -
-   -   - - -    -        - -      -- - ----  - -- -   -   - --- -  - --  - - - - - -           - --
- -- --   -    --   -- - -  -    -  -   - --   -     -- -  -  -   - - - -  -   -       -  -   --   -
---   - -- - -         -    -     -            -   -  -  --  -  - -   ---     -     -- - - --      -
- - -    -    -  -   -- --   --      -       --  --    -           - -  -- ---  -    --  -  - --   -
-     -   -  -  - --  -   -      - -  --- - - ---  -      - -        - -     -   -    - -   -    ---
-  --       - -  -    -     --  -- -     -       --  ----- -- -   -   --- -   - - -  - -  -   - ----
-    -  -     -   -   -     -  -   - - --  - - -   --  - - -   -    -  - -  -   -- - -   --       --
-  ---    - --  -    --   -   -          -     -          - -  -  -  - - -  - -       -  -   -     -
-     -          --  -   - --  -       - - ----    -- -    -         -- -    --  --     -  -    -  -
-    -   - - -  -   - -- -    -      -         - --  -      -  - - - -   ---    -  - - - -   -     -
-      -  -  -   --- -  - - -   -     --  - ----      -  - -           -  -     -   - -    - -     -
-   -  -   -- -       - -   ----   ---     -   -  -  -   -   - -  -    --    -    --  --   -   --  -
-     --   -- - --       -           -  -     -  --   -    -       -   -   -  -   -- -   -       - -
-   - - - - -  -   --     -   - -  -  -   -     --     -    - -  -       -  -- - - - -  -  -  --  --
- -  - -        -    -- -   - - - ----     ---      -                -  -- -  -   -  -     -       -
-    -  ----      ---  ---     -   -  - --  - -    -  -   - - -       - -      --       --      -- -
--  -           -           -     -  --   - -  ---   -  -   -  --- --    --   -- - ---  -    --    -
-   - -        -  --  --   -  --        -  ----      - - -- ---  -      -     - - -      - -  -   --
-   - --         -  -- - --  -      - - --       ---- ---   -      -  - -     - -- -  -- -  -    - -
-   -   --  -   -  -      - -  -- - -    -    - - --     -   --     - -       --   --          -   -
-  -- -   - -       - -          -  - - -   -   - ---   -   --   - -  -        --- --    - -- -   --
-      ----  -   -         -    -  -  -   --   --      - ---   -  -      -  - --    --    --       -
-  --- -      -  -        -   -   -  -          - --    ----- -- --  -   -- -    -     -     --    -
-  - -   -- -    --  -- -  -      -  --  ---  -    -     --- -  -     - - - -  - - ---   -    ------
- -       -       -    - -            - -  -           --    --    --    --     -----   -          -
-   --  -   -       -   -     - -   -- - - -  -  - --    - --   ---   -    -- -    -     -    --   -
- - --   --- - - - - - ---    --  -    - -  - -      - -      -     - -    - --  -    -       -- ---
--     --      - -       -- --   -     - -- -  - -   --     - - -          - -   --    -     - -   -
-        -     ----  - -  - -   -     - - ----- -  -    -  -    -   -     -     - - -  ----- -  -  -
---- - -     -- -- - -    - -- -  -     -   -  -      - -    - -      -   --- -   - --    -   -    -
- -  - -- -          ---  -  -      --     - --    -- - -    ---    - -     -              --  -  --
- --    -    - - -     - - -  -  - -     -  -   -  --       -      -  - --        - - -   -    -  --
--  -    -   -- -   - - -  -   - -   -          -  - - -       -    -  --     - --   -   - --      -
-       --     -  ---- -   --   ---     -   -  - -  - -  - - - --  - -   --       --   -    -      -
-  -   -          -   -    ---         -    - - - - -  - - -    --         -  -- --            -   -
-            -- - -----   - -     -             - - - -   -   - - -- ---  - -- -    --     --      -
-  --  - -   -  -  ---                       -  - - -  -   -  -- - -    --   - --       ----    -  -
-     -    -   -  -  -     -  - -  -     -       - -         -- --   -   -   -     -  -   -  -  -  -
-     - -   - -- -  -   -- - -  -   -        - -   - -   - -   -    -   -    --    - -     - - -   -
- -      -   --  - --   - -  -     - -  --    -   -     -     ---        -    -   -    -  --  ---  -
--   --            --  -  -   - -   - --    -  - -    --- ----  -       -  --    --- -      - --   -
-   -      --- -- -        -      -  - - --   -    --  -   -   -      ----          -- - --     -- -
----------------------------------------------------------------------------------------------------
