100
100
----------------------------------------------------------------------------------------------------
-            - --           ----    --    -     - - -     -    ------      --      -          ---  -
-  --- -- --      --                 -    -              -   -  -  ---   - -  - -  - ---    -  - ---
-      -    -   -     -   -  ---  -    - -    -- -   --  ---   -      - - -   -  -    - -- -  -    -
- -- --  - --  - --- - -  -      -     -  ----  - -  -      -    -  -  - -- -   -  --      -  ---  -
--   - - -             - --   -   - - - - -   -  --   -    - ---    --    - -   -    --- -  -      -
-   --         -  -  -- - -     -  -  -  - - - -    -       -    - --    -   - - - - -  -      - - -
-  -  --  - -          --- --        -  -  -  -  - -   --    -        - - -  -      -- - - -  -  - -
--- --        --- -    --  --     --   -  -   --- - -        -   -  -     -- -      -          --- -
--     -   -   -  - -     - -  ----      - --    -  -   --      -- - - - -  -      --   -   -  --  -
-      ---       ---   --    -    - -      -  ---           -  -    - -    - --  - - -   -    --  --
-    - - - -     - -- --   -     - --     -     ---- - -     -  -  -- -            --   -   -      -
--    - -   -  -   -   -      -  -          -       --- -----  -   -   -   -     -    - --   - - - -
-    --      - --  --   - -    -  -- ---   -    -- - -  -    -----           - -   - ---    --     -
--  -     --     -    - - - - -       -- -      - -     -         -  -  ---            - -  -   - --
-     - -  -   - -- -    - --  --  -- -     --    - - - -     -    -- - -    -- --      -   -      -
-   -  - -  -   -      -   - -  - --  - -      - -- -    - ---   -  -  -   -  -   -    - ---       -
- - -  -  - - -        --- -  - - ----      - -      -  ---    -  -  -  -  -   - --  -- -      - - -
-   -   -  -  -  -     -              ---    - --           --   -   -  - -    - - -   -  - -      -
-   - -  -  -   -- - -  --- -     -            - - --      -    - -      -- - -  -          - --   -
-      -- -  -         -  -- -      -  --- - -      - -  -         - -- -   - --  ---   -   -   -- -
-- - - -    -    - - - -       -  --      -  - - -     -    - --      - -- -   -- -  -- -- -     ---
-      -     -----        -     -  - -  -- -  -   -    - -       - --  -  -            -- - - --- --
--- --   -   -  -   - -    -- - -   -  - - - -- -    --- --     - -   -  --   --  - -     - -      -
- -  - -      -  -     -   ---   --     -     -  -  -                  -  - -    -      -   -   -- -
-         --        ---     -   - -  --   - -   -   - -- -    - --  -  - -- - -- - --   -  -- - -  -
-  --  -    --            ----  -  -    - - ----        -- -- -- --  - -  -- -   -      - -  -  ----
-     -    --  -        -      - -      -  - -    --- -   -  - -  - - - ---    -  -       ---      -
-  -- -  --   - - -      --  -    --- -       -   -    - - - -     - -   - - -     -     - -       -
- -    - - -- - -        -    -     --   -  -        -         - --  --     -    -        -- -  -- -
--  - -   - -   -    - -  -        -  ---- - -       -- -         -  -  - - - -     --    - -    - -
-     -         -  -- -   -    - -  -   ---- -  ----    - ---     - -  - -  -          ---  - -    -
-   --  - -  - -   -       -      --  -    -  -- - - ---     - -  -      --  -    -  --       -   --
---         -  --      -  -    ---   -   --   -        -   --      - -   - --      -   - -  -  --  -
--  - -  -       --  - - - - -- -  - -  -       -  -- -   - ---          -  -    - -- - -    - - - -
- --- -     -- - -  -     - -    -  -       --   --       - -  - -        ---       -   -       -  -
--    - -       --- - ----   --   -    -- --  --   --  - -     -   - - -    -     --  --  - ---   --
-  -   --  -  - -   -  --- -   -      ---    -          -  ----    -      --   -     -         - - -
-               - - -     -  ---     - - --  -         -     -  -       - -           --          --
-   -    -- -     -     --       -- - -   --  - ---   -      -    --     - - -- - -  -       -  -  -
-    --- -     -    - -           - -      -- -   -  -      -    -  -    -  - -   --   --      - - -
-   - -    -   -     -- -        -     --    -   -  -  -- -   --        --  -  ---      -    --   --
--   -  -- -  -  -   -   --    - - -  - -  -  -  --   - --  -   -    - ---  --   -- - -     ---   --
-   - --  -- -      - -  -   -         -  -   --   --      -  --  --       ---  - -      --   -  - -
- - --  --  -   --    --- - - -   -  ---- -     - -    -     -- -   -- -  -    -- - ---        -----
- - --  - -      -  - -   - -    --     -        --    -    --     --                - --  - -     -
-   --     - - -         -     -  -      -  -    -  -    -      -   -   -  -     -   -- --  -  -----
-        -   -  --    -   -- --  -   -  --    -  -      - - -- ---   --  -        -  - -  -  -     -
-  -  ------   -  - -          --    -      --           - ---         -    -  -  -   - -   -    - -
--- -   -    - - -  -- -         -- ---  - -    --         -  -  -     - -   -     - -          -  -
-     -        -    - --- -- - -----  -  -      -  -     --     ----- -       --    -  -  - - - -- -
-     -- - -   ---       --    -    -   -           -         --     --    -   - --    --   -  - - -
-- -  -  -            -  -    - -    --     -  --     -  -  - - -  --  -       -    -  -- -   -- ---
-     --     -    - -      -      - - - -  - --  -   - -   -      -    -   ---   --  ---     -     -
-   -        -   -             - -  -      --     -- -      -  - -  -- -         --   - -- -    -  -
-  --  --  -    -  -    - -    -    -   --   - --       -- -       -  - - - -  -        - -        -
- -       -   -   --- - -  -   - -  - -- -  -     -  -  -    -     -      ---     -  - -    - --   -
-    -   -  - -  -- -    - - - - -   -         ---    -   -    - -      -   -  ----      --      - -
-- -   -       -  -          - -   - - -- -    -  - -- ---  ---- - -- --  --  ---     -      - -   -
- -  ---  -   - -   ---  -    -   -  - -        -- --  -  -  --  ---  -  -   -   --- -  --    -- - -
- -  - --   - -- -      -    - -  -       -  -             - -       - - --   - --   -- - -     -  -
- - - --  - -  -    -       --- -  - -- - - - -    -       - -   -   -  -    -  - --    - -  -   - -
--      -   -     --   -      -  -         -    --  - -      -      -       -  -      --   - --    -
- -     --     -      - - -           --    -- -- --     - -- ---       - --  --    --  - -  - --  -
- - -     ---- - --     --  -   - -  - -  -   -  - ---   -   -   -       -  -   -   -   -   -     --
--- -        -  - -     - ---           - -- -                ---   --     --- -       -  - - -- - -
-  -  -  -      -  -    - --     --- -   -  - -         - -      - -       - - -       -    -      -
- --       -     - -  -    -  -    -       -- - -  - -  -   -   -- - --- -        ---- -   -  - - --
-  - -    -  --   - -  --   - -  -   - --  -  -  -    --  -             --- -  - --  --   -   -    -
-    -- -   -  - -     -    -- --  -- -   -  -   ---      -- -  ---  - - -  - -    - -    - -      -
--   -   -    -- -         - - -    -   -          - -         -   -           - -        -  - -  --
-   -   -  -- -    ---- --  ---  ----      ---  -      - -     -      -    - -   -- --- -        - -
- --- -  --   -        -   --- - -- -         - -              --  -  - -- -    -        -   -     -
- -          -   --   - -      - --        - - -   -         - -    --   -   -   -- --  -   ---    -
--  - - -  -  -       -  - -- -  -- - --   - - -   --   - -  -  -   -    --         -  -  - -  -  --
-        -       -     --      --     -   -  -- - - -    -   --   -- -       -       - - -   -  -- -
- - - --- -    -- -  --      - -    --      -   - -   -- - - -  - -  - -         --   - - -        -
--   ----    --     -- -  -  -    -   -- - -     --        --    --       -   --- -  - -  -   -  - -
-    -                - -       -    -  --   -       -    -   -- -  - - --   --       - -          -
- -   ---- -   - -    -  --  - -          -    - -            - --   -   -  -      -   ---  -  -   -
-- -    -   ---     -   -     - -    --   - -  --      -- --- ---   -      -- --   --       -- -  --
-- - - - --      -- -    -    --     -- -  --    -- -  - - - -   - --   --  - -    --   -- -       -
---        --  -        -  -       -- ---     ---   -  -   - -  -   - - -   -     -  -  -  --      -
- - -     - -   - -- -- - -     - -      -----   -       -  -  -     -     -         --            -
-  -  - - -   ---- - -  -  - -  -- --      -  -            - --  -    - -      -       -     - -   -
-  -      - -  -     -       -    - -      -    --     -  -   -   ---   -      -     -  -     - -  -
--  --    -   -   - -           - -- --        - -- -  -  - -    --    - -             -    - - - --
- -    -             -   - - - -        - --  -      - -  -------  -   - -  - -----     --   --    -
-   -  --    -   -  --   - -  - -    - -- - -- -  -  -  -      -   -    - --        --    -- -  -  -
-      - --   --     - -       -- -  -   - -     - - --       -        -     --  ---    -    -     -
-     -   - ---  - - -     -- -   -  - -    - -- -    -            -     -              -   -    - -
-  -  -  -- -   -    -   -  - -- ---    -   -    -  -- -     -       --   - --   --   -      -- - --
-- -          -  -     ---    - --     - - -   -    -   -    -       - ---   - -- - - -- -     -- --
-  -      ---   -   -- -        -  --    - - --   - -    - -             -    -- -   -         - - -
- -           --- -  --    --   --     -      ---       - --  -          -  ----   --    -- --- -  -
-   -- ---  -    -  -   --    -  -   -   -  --    -         --    - - --          - -   -      --- -
-   -  -  -   -- --   --      -    - -    - - ---   -      -  -  -     - -  - --    -  - --- ---   -
- - - -      -     -    -       -- -      - -   - -  -       -   - -  -   -- - -    - -    -  -  - -
-       -   -  - ---       - -     - -       --  -   - - ---  -     -  -- -   -  - -    -   -      -
----------------------------------------------------------------------------------------------------
