100
100
----------------------------------------------------------------------------------------------------
-    --  - -     -     - -       --  -      -             -   -     -   -          -   -     -     -
- - -  -   -    -  - -  -       -      --      -   -     -            - -   --  -  -   - ---- -    -
--           -  --- -     -   -       -  -  -   -     -     --    -       ---    -    -   -  -   - -
-  -  - --- -      -  --   -  -- -  -     - -  --   -- -- -  --                   - -  - - -  -    -
- -  -        -       - - -  ---  - - -   - -   - -  - -- - -  - --   -  --- -    - -    -    - -  -
-    -  -   -     -  -  -   -    -  -  -     - -  --  -     -   - - --    -    -      -- --     -- -
--- - -   -         - - -  -          -  - --        --  --  -   - -- -  -       -  -   -   - --  --
--    - -- -  -     -    -                 -  -         -     - -   -  -      --- --     -      -  -
- --    -     -  -      -        -   -   -  -  - --      -         -  -      -  -  -- -  - --   -  -
-   -  - -   -         --   ---  --    -       --  -- -   -    - -    -     -       -   ---  - -   -
-       ---- --  - -     - -  - -- - -- -  - --    - -   - --       --   --  -   --  -- --       - -
-    -  -     -  -    -    -  -       - - --   -   ---         - -     - -     -- --       - - - - -
--- -    --- - --   -   -   - --- -- -   -    --  -   - -  -  -       ---    - -- - --- -  - - - ---
-   -   -    - -          - -     -       -- -- ---   - - --      -- -  -    --      -    -        -
--- -   ----          -               --    -   -  -   - -  -    -    --  - -   -- -  -         ----
- -   --        ---   -- - --       -   -   - -- -- -- - - -        - -- -        - - -    -  - -  -
-     - - ----     -    -  --     -  -   --      -    -   -  -- -  -  -   -     --   -  --    - - --
-        -   -   - -  -- -- --   ---   -  -- --  -- -      --        -   ---   -    -  - - - -     -
- -       - -- -        -   - -     -    -      -  -    --   --  ------       - --   -- - -- ---   -
-  -       -     -  -                 -     -  -  -  --  - --     -    -   --  ---     --- -   - ---
- -  - - -- - - - - -  - - - -----     -   -  -      - --     -  -   - - ----     - - -     -  -   -
-    ---   -      -      -  --  -   -   -   --- ---    -   - -   - - - - -- - -   -     -  -  - -  -
- - -          --    -   -     -  -      - - - -      -  -  ---- --    -     --    -- ---   -   -- -
-       -    --     ----  -   -  -                - - -  -- -   - -           -  -   --  -         -
-      -  -  - - ---   ----- -            -  - -       -    -  -   -- -  -----   -    - - -   -- - -
---      --    --  --- - - -  --- -   -     --   -    -  - --     - --   -   --    --   --      - --
-  -  --    --   --    -    - -   ----- -  -   -- -     -  -  -   -   ---  -- - -  - -- -   -- - - -
-   -   --   -   - ---- -    - -    -        - -   -  -       - --  --   -    -         -     --   -
-  -   -     - -  -  -     --  -   - ---   -    --  -   - -   -- - -  - -   -          -  - - -   --
--  -          -  -   --  -    -     -     -- -      - --   --  -       -   -- -       -  -  -     -
-  -  -           --       -  --   - - - -  -    --  -                   - -  - - -      - -   -   -
- -     --   - -   -   -    ---    -    - --- -- -  -  -    -  -  -      - ---      -     ---  -- --
-- ----           - -    --  -    -    -     -    -   - -   -     - -  -  -      ---   -        -  -
-     - -   -- -  - - -       - -  --   -- -- - --- -- -      ----    --  ---     - -- ---    -    -
-- - - - -   -    -            -       -    -      -  - -         -   -- - -    -  -   -       --  -
- -     -   -     - -- --  -           - - -    --  - - -         -   -- - - -    -- -- -  -- -    -
-    -        -  -- - -  ---    -  -   - - -      --         - - -  -       -     -    ----        -
--          - --             -  -        -       -     -- -- -   -  -    - - -  -  ---          -  -
-       --- - -      --     -       -  - -      --  -      -   -  - -  - -      --      -- ---     -
- --   -      -   -  -   -    - -      - -- -    -     - -  -  - -  -    -      --- -      -  --   -
- -- -   - -  ----    -   -      - -    - -    - - - - -     -- -   -   -     -    --  -  -        -
-       ---   - -   -- --    - - -      ---    -     -  -- -  - - - - - - -     --- -   ----     - -
--   - - - -  - -  - -    - -     -  ---   -- -            - -   -- -          - -- --    -  - --- -
-        - -   - - -   -         --          -   -   -    -   - -    -  -  ----- - -       - --   --
- -   -             -- - --  -   -  - -   -      -   - -- - - -   - - --    -       - - --   --    -
-- -   -   -   -  -   - -----   - - -            - ---    ----    -  -   -       - -     -  --   - -
- -- --- - -     --   -    -    -    -   -- - -- -   -  - -       -   - -   -  - ----   -     --   -
---    -  -- -  - -  - - --         -  -   -  -    -    -     --     ---  -    -        -   -   -- -
-        -- ---  - -      -          -       -      - -    ---  -  -   -  -         ----     ----  -
-   -      -   --    -   -- - - ---- --- -   -    -  -        -    -     - -     -     -  - -   -  -
-    -- -  -  - --      - --    -  - - -  -          -  -  ---     - -    -- -       -          -  -
-        -          -   -        ---      -  - - -    - -         -- - -  - -- -    --   -    -  - -
- -     -    - - --  ---  - -  --- -           - -    -   --- - -             ---     --   -  -  - -
--- -       -            --- -       --  -  -  - - - ---   - -   --  -   --  -      - - -- - - -   -
-  -     -   -      - -       -        - -   -         - - - -       -- -  -  -  --  - -   -- -   --
-   -   --  --   -         --     -      -- -   - -  --         - - - - ---  -     - - --     -   --
- -   --       - ----   -  -    -- - - -  -    --   -    -- -    -    --      -    --   -       -  -
-       -  -   -  --        -  -- --   - -  --     --  -- -- -  - -- -  -       -    - -   --     --
-- ----  -   - -- -  -       --        -    -  -       -  -    -   - -    -  -  -  - -      -      -
-    --  --     -            - - -   -  - -   -         -   -- --- - -  - -    - -    --       -   -
- - -    -       -   - --          -  -     - ---     -      - --   -- - -  -- -   -    ---    -   -
-   -  - - -  ---- -  -- -   -   -  - - -  ---      -   -  -      - -- -   - -  ---  -    -- -   ---
-   ----      -----    - --     -  -           -  -         -   ----- -          -  -  --- -    -  -
-- - -  -      ---       -   -- -  ----         -       ----      - - --   ---   - -   - --  -     -
-- -- - -- -    -   -  - -       -  -      -        ---  -          -   ---    -  --- -    -  --  --
-- -    -      -        - -  --  -       --  -    -   - - -           - -  -            --  -    - -
-   - - - -   -    -   -- - -       - - -   -  -  -- -- - -  -- - -- -- -     - - ---     --  -    -
-        -   - -          - --  -  -   -   -        -   - --           - -     -  - -   -    - -   -
- -  --- --         --    -  -  -- - -      -  -   - -   -  -------  - - -- --- -  --  -  --  -- - -
-    -  - -       --     - -   -  -    -   - - -   -   -- -   -    ---    -    ---    -  -  --     -
-- -   -        -  --       -- - -- -         -    - --  -   -- -    --  -      -  -     --     -  -
-- -   -   - - - --  ---   -    --      --     -  -- -                  -- ---       - -      -    -
-       -    - -- -      - - - -  ----          -            - - -          -   -     -      - -  --
- -      - -   -     ---           -   -- - -  - - -    --     - -   --  --    - -   --    --   - --
- -          -    -         -   --   -   -   ---      -   -   - --- -    -      - -           - - --
- --  --     - - --   -  -   -      - -   -       - -              --   - ---    - -  -   -        -
-- -   --  - -  -  -   --  - --  -  -    -- -  --  ---  -- - ----     --     --- - - -  -  -   --  -
- - - ---              -     --  - - - - - -  --  - - -        -- - - - --  -    -- -    -         -
- -  - -      -  --        -  -  -      -  -   -  --       --  - --               -      -  -   -  -
--- -  ---    -     ---- - - -  --   --  - -  -  --  --    --   -       ---   - --   - -     - -  --
-- --  - -    -             -- - -  --    -     -     --   -   --  --   -  - --   -  -      --  -  -
-         - - ---  -   -  -   - -   -- -   --   ----   -            - - ----     - ---- -      - ---
- --    ---         --         -  -        - -    --     -      --  - -     --   -    -- ---       -
----       -    --  - ----- -   -    -      -   -- - -        - -- --   -        -   -- -    -   - -
- - -  -  - ---      -  - - --- - ---     -- -    -   --  -- -    --    -      -  -- -   - - -  - --
-  - --      -   - -       --   -  -- - -   -       -    -    --        -- - -  -   - -  -   -  -  -
- -  -    --    - --- - -  -      -  -    --   -  -   - -  -  - -   -- -    --    -- -         --  -
-- -  -   -       -      -   - --     --   -    - - ---  - --         - -  - -  -- -        - --  --
-  --  -   - -    - --             -  -       - - --   - - --  -  -    -  --- --   - -    -- -     -
-         - - -         - - --    --      - --       --  -  - --    ----       - -  -   -- -     - -
-   -      -    - ---                        -        -    -     - -   -     - -  -  --   -  -  -- -
-- - -   - -  -      - - - ---  - -- -     --  - -  - -   -  - ---    -   ---  -   --  -     --- - -
-- -   ---    -  - -  - --   - -     -  -    --    ---   - - ---    - --      - ---    - -        --
-- --   -     -       -     - -   --   -    --     -  -     - -        -- - -   -   - --     - --- -
-   -  -         -      --  -        -      -- -    --  - - -  --    --  -  -          -   -- -   --
- -    --   -  -- --- -    -  -   --  - ----- - - --  -     -      -      - -- -     - --    - - - -
-  -     - -  - -   --    -- -       -  -  -        -    -  -  - --  - -  ---    ---   -   -  -    -
-       -- -   -  --    -      - -  -        -        -  --     -        -     --    - - - -- - -  -
----------------------------------------------------------------------------------------------------
