100
100
----------------------------------------------------------------------------------------------------
-  -            -   -   -  -  -     ---- --    -      - -           - - -    -         --  -  -    -
--- -    -     -    - -   -   -  -- ----  -- --     -   -- ---      - - - -   -             --     -
--     -      -  - -    - - -       ----  -  - - - - - -  - - --      -  -  -     -  ----  -  -  - -
----  -  --  -  - --   - -    ---   -     -- -    -    -     - -   -  - -- --   -      - - - -  ----
-        -    -   --     -   -  - -      -   --     -      -     - - - - -    -- - -  -    -      --
-    ----        -   - - - -      -  - -  -  --- -   -- -     -- -         - -           - --    - -
-     - -  -    -   -       -       - - -  -   - ---      -    - -- - - - -    - -    --     - - - -
-   - -  -- -   - -       - -      - - -     -   -  -       --   - - -  ----  --   -     -  - -    -
--    -  -   -  --  -    --  -    - -   - -     -   - -   -       --   -     --  -   --       -    -
-         - -- -            -  - -       -    -  - -- -     - -   -  --- - -- - ---  -   -  -      -
--   -- -   -      -   -   -  -    - - -         --   - - -  -             -    -    -    --  - -- -
-- -    - -  -  -    ----   -  - -           -     -  -- --   -  -- -- --  -  --   - --   - -     --
-       -  ---  -       -  -- - -  -   -  --   -- - --   -  -      - - -     -  --  -          -   -
- - -  -      - -   - - -- --           --          -- -  -   - --    -   --   ---   - -  --  -  - -
- - -- - --     --   -   - - -  -  -      -     - -        - ----        -  --    -        ----    -
-     -      -    - -    --   --    -    -  --- -   -     -       --- -     - -    --      -       -
-    -- -       -- -   -     -   --  -- ---   -    --  -     -  -           --  --  ---           --
-       -    - -  -     - -- -- - -      -   - - - ---     -   -   -     ---      -       -  -  -  -
- -      -   --- - --    -  -  - - - -    -- -          ---   --      --  --   -      -          ---
-  -   ----          -- -  -  -- -   -       - - -  ---       -   --- -  - - -- -  -     - --  -   -
- - -         - -     -   - -  -  -   ----     -  - --         ---   - - - -           -- -  --  ---
-    -- -  -- --   -   - -   - --      - -   -  -  -  - -      - -        -       --     -     -   -
-     --   - -   - -      - -    ---- -   --  ----  - -     -    -  - - -    ---      -  -  -    ---
-    -   -  - -   - - -   ----  -     -   --   -  -   --        - - -         -   -- -    -  -  -  -
-    -        -    - --         -  - - -   -     -           - - --    -   - - --  -    -  -  -   --
-- - - -- - --         --- -  -- -  -- -     -   -  ---- ---    - -     -       - - - -  --        -
- -    -  -   - -     -       -  -    --    -   - -  -  -            - ---      -  - -  ---   - -  -
-   - -          --    -    --     ---                   - - - - -   -  -   -  -    -  -   - -  - --
-      - --  -- -     -     -  - - -    - -  -  --     -   - -  - -  -  - ----  -     -- ---- -- - -
--  - -- - --   ----  -- -  -        -  -     -       -      -  -      --    - - --     -    -  ----
-   -- -   -        -   --   - - --   -     -  -      - - - - -   - --     -    -     -    -       -
-     - --       -       -     -   -      -     ---            ---   -   -- -  - - - - -   -  -  - -
-   -          -  -      -   -    ---  - - -  -            - -  - - -          -  -- --      - -- --
- -    - - --    -  - -  -    --  -   --  -      --- - --      -  -         -- -        - -    -   -
--  -        -  -  -  -- -   - - - -     -   -        -  -  -  -     ---          ---    -       ---
- - -  -     - ----- -    -- -   -- - -      --        - -   -   -   -  -   -      -   ---    -    -
-   - -      --     -  - -        -   - -    - -    -   --- - -  - --   - -  -      -    -  --     -
---   ---- -    -  --     -  --- -  -- -- - -   -     -                -      -    -  --  - -   -- -
-    -    -   - --    - ---     -       -     - -       -     - - - --  -   -  ---       -   ---   -
- -   --   --       --        ---      -- -     -  - -        ---  --     -  -  -    -     -  - ----
-   --   - - -  -  -  -   --   -  - - --    ---     - -  -   -  ---  --  --   -        -   -  - -  -
---- - -  -       - -    - -   --    -  -    - -  - -  -     -      - -     - -     - -     -      -
-      -  -  - -  ---   -  - -    -  ----      -  - -    -      -  -   - -  - - - - -   --- -   -  -
-  -    -        -   - -        -          --   - -  -   - - --   -  -    ---  --      -  - --     -
-  --                       --  --   ---  -    -       --              -  -     --    - --    -    -
-     --   - --      - --- - - -  ---  -  -  -  -   - -   -   -     - - --  -  -    -  -  ---      -
-   - -     - -    - - --- -   - -    --     - -      - -            - -     -  -           -  -   -
-      -  -  -  - -  -  --   -  -  -- -      -     - -   -               --    -   -    -- - -     -
-  - --     - - - ---        ---       -       -  --   - - --  ---  ---  - - -   -- ---     -  - - -
-- -    -- -   - -    -  - -  - --   - - - -  -- -      -              - -     -    --   --   --- --
-   - -      -- -  -    -  -    -   - -  - --        - -     -  - - --  --  - - ---         -     --
-  -   ---- ---  -  -  -    -    --    -  - - --   -     -       -- -  --  -- -  -       ---- --   -
--        -  - -   -     --      -  --   -      -         - -     - --   -          --     -       -
- -  ---      ---    -     - -- -  -    - -  - - -  -      --  --- -    ----   -       -  - -      -
-         - -     ----    --    --    - -  --   -     - -            ---         --    -- --       -
---    -  -  -  --    -  -  ----  --         -   --      -- -  -      - ---   - -   --         --  -
-                - -  - -     -  ---       -- -  -   - --- -- - -   - - - -  -    -    - -   -     -
- - ---   -     - -       -  --    -               -    --   -   - -      --   --  -           -  --
- - ---             - -   -      ----        --   -     - ---        ---      -  -     -  -      - -
- --    - - - - -- -   -  - --   -   - - - - --      - - -     - - --   -- ---    -          -   - -
- -    -- -  - -  - -   -     --  - -  - - - -   - -  --      --   -  -     --  -- - -   -  - -  - -
-   -   - - -- - -  -      -     -  -   - -     -   -    -  - - - - -- -   - - ---  - - --     - - -
- -  -  - - -   -      -    -  -   - -   -  -   -      -    --- -    -           - -   -   -- -    -
-- --   - -   -   ---    ---   -    -  -     --   --  - - -       ------  -  --   -- ---      - - --
-   - - - -  --          -      - -     -    -- -    -  -    -      --        -   -    - -    -    -
- -  --  --         - --  -           -  --  - --    -     - --    -  -  ----     -     - -  -    --
- - - -      --         - --- -   - -  --  - -    -    - -     - ----- - - - -   - -- -  -     -- --
-  -  -  ----  -     -- -           -    -       -  --   - -   -  -  -  - --    - -    ---    -  - -
-- - --    -  -   -      - -- ----    - --           --   - -- -- ---  - --     -      -- -   ---- -
- -     -   -         - -   --    - --      -  - -  -  --         -  - -- -  -  -    - -          --
-   -- - -  - --- -   -- -      -      - -   -  -    -  -    - -   ----  -  -        --   - --    --
- -     -       - -  -  --------- ---   - - - -  -- --    -            -     - -  -  - -           -
- -- ---  - --        -    ---     -   -  --   -     -    --  - -     - - -  - -    --  ---------  -
-  - - - -  --  - -    - -    - -- - -      -       -   -   --  -   - -          -           -  - --
- - - - -  -      -       -  -   - -- ----  --    -  - -    -        -        - -   -        - - - -
--      - --    -  --     -- --       - -  - --  -   -           ---  -   - - -      -    -     - --
-     - - -     -  --    -     - ---  -  - - -     - -- -      --  --- ---  - -  - -       -- - -  -
-   - -- -  --  ---   --    --   -     --      --- - -    -       -    -         - -   --    -    --
-   -   --         -  -- --   -   -       -- -    -  -     - -         - -           -- -  --   - --
-     -    -        -     -  -    --   -   ---  - -        -  -- -  -     - -  - --   -  -   -   - -
---  - -        --  - -      - -      -               -   --  -      -       -   - --       -      -
-    --  --   -        - - -- -   ---  -- - -  -   - -      -   ---  - -  - -        --       -  - -
-   --     -- -  - ---   -    ---   - -         --- -  ----  --    -     --  - -- -    -- - -   -  -
-      -  -  -  - -          - -- -  -   - -  -    - -  - -       -   -     -  -    --     -  --  --
- -    - -   -      -  -    -     -    - - -- -         -   - -    -      -  -   - - - -  - -    - -
- -  -   -       -  - -    -  --          -  -     --     - -    --    -- - ---  -      -  --    - -
-   -   -  - - - -    - --  - -  --- -    -   --      -   - - --- --     -     -  - --     - - - - -
- -   --   -    -   -   -   -- -    -----     - -  - -  - --      - -  -  ---    -- -  - -  -  - - -
-  --- ---   -     - --  - - -  --     --    -   -   - -   - -  -      - -     -       -   --  -   -
- -  -   -       -  -  -   - - -     -    -  - - -     - -    - - -      -  --            -   -- - -
-     - -   ----  --   -      - ----  --   -     - ----  --     -     - -        - -- -  -- -   -  -
-   -  -    -    -      -  - -  -         -   -- - -    -   --      -  -     - -   -  ---  -  - -  -
- -    -- -    -  - --- -  - -     -   - -  -        --      -   -- --   - -- ---  - -     -   -   -
-  - - - -  --   ---   ---  - -     -  --    -       - - --    -- - -        -       --- - -     - -
- -      - -  - -   --- -    - --            - - ---    - ---   -  -  -   --  ----  -  -     -     -
-       --- --  ---  - --  -      -   ---   -  - -     --   - --- --           -   - -       -     -
-   -      --   ------ -   --   -  - -    - -       -  --     -   -- --     -     -  -  - -        -
-         -  -        --        -              -      -         -  - --     -   -         -  -     -
----------------------------------------------------------------------------------------------------
