100
100
----------------------------------------------------------------------------------------------------
-     -  -   -- -   -      -         -            -    -   -    ---   -   -  -   --  -  - --   - - -
-  -      -    -   -          -          -   -  --- -  - --  --    --      -- --   -   - -  -      -
-  - -   ---      -       --  -  - -    - -   -   - --  -   ---       --   -    --              - --
-  --  -       --  - -      -    -  -       -  --  -  -   - ---          - --  -  -       --- - - --
-   --  --   -   --   - --- ---    -   --  -  -       -     -- -  -    - - --   ---  -  -        - -
- -    --  - -     -                ----     - -- -    -   ---     --    - -   -- -    - -- -     --
- -  -     --   -   -  --   - -   -  -   -   - -  -      --    - -      -   - ---         -  --    -
-  -       -     -     - -     - -     - -  - -      ---    -- --          --      --  ---         -
-    -  - -     - ---   -  -  --    --- -      --  -  - -  - - -  --   -           -   -  -   - -  -
--  - --         -    --  -  -          ---  -            - -    -     - -  - -- - ---   -- -     --
-    --    -      - -- ----   -     - - -      --  --  --    --  -   -     -      -    --      -  --
-         -   -        -    -    -        --     -         --- -     -  - --- -  - ---      - ------
-   - -        - -- -   - -        --   -    - -- -      -     -  --         -    ---   --   -     -
- -  -   - - -- --- -   - -- -        -    -- -   - -  --   - -       -- -  -------           -    -
--- -- --- -   -   -- -       -  - -  -- -          -   - - --       --     -      ---- - --     - -
-      - --  -- -   -        -  -      -  -  -     - -      -  ---  -       -  - - -   ----  -     -
-- - -    -     -  - -    --   -  -    -  -    --  --     --      -  -  --  -  - -   -     - --    -
-    ---  --      - - -- -  -    -    -           -  ---   --       -     -   - -     - - ---- - ---
- ---  ---  - --  -      ---   -   - - ---- - - -- --  - --- --   - - -   -        --   - -      - -
-- -  -     -    -   -  -    -  - --          - --  - -  -- --       -- -        --   --    -     --
-       - - -   -   - - -     - - --  --   -    -     -  --    - -      - --  -          -  ---  - -
-   -  --       - -   -  -    -- -      ---    - ----       -  - - -   -    -  - -   -    -  -     -
-     -  - --      -      - --    -     -  -                  -      -----    -  -  ----   -       -
-  --      -  - - --       - -      -           -   -  - --    --  --    -  - -   -     --  -      -
-    --  -- -   -        -    -       -  -- -- - -  - - -     -  -   -  -   -  - -    -   -  ----  -
-   -      -   - -       - -- -   - -   -   - -   --  -  - -   -        -   -    -  -     -   -    -
----- -   -  -     -        - - - -     -         -- -  -        -   --- -    --             - - - -
--     --      --  -       -  -     - -  -   ----     - -   --   -     - -   -  -  -     --        -
-     - - -  --     -  -   --   --  -  ---   -   --  - ----  -     -   -    - -  -     --  ----   --
--    -    -- - ----   - ---  - ---        -- --   -   -     -   -  -     - - -  -  -   -    -   - -
-  - -    - -              - -         -  -     --   -        - -   -----   - ---   -      -     - -
-- - -     -   -   -  --   - --  -     - - -    ----        - - -- -       --      - -     -  -  ---
-    - --      - --   -  - -       - --    -        - --  -     --   ----   -- - -     -- -        -
- -            --  - - -  -  -  - -  - -     -       -   -   --- -             - -  -  ---    -   --
-     -    - --  - - -     -  -- - - - -- -      - ----      -    - -- --   -     --  ----   -     -
-   -- -  ----   -  -   -- -   - -   -   -       -  - -  --    -  - -   -  --       -   -     --   -
- -- -   -       - - -     -          -  --  - -       - -- -   -     -        -  -  --      - -- --
-     -    -     --- --  -- --   --- -- -     -      --  -           --            --  -   -     - -
-  - - - -   --       -- -       -- - -    -    ---  -  -    -              - -       -   - -  --  -
- -- - -  -      ---  -   - - --     ----    -- -     --  -        - -    -     -  -    -  -    -  -
- --   - - -  -            - - -   -        - -- ---   -    -    -      -- -- -    -   - - -- - ----
-  - -  -   -    --   -  -  -  -   - - -- - -  -      -   -- - - - --- --     --- - -   -   -  --  -
-  - - - -       -  --    -  - -  -   -- - --   --    -    --   - -  -  - -      - -  --     --    -
-- -  --   -            -  -  -       -    -  --          -   -       -- - -  --       --  -      --
-    - -  -     ---  - -  -- -  -   -- -    --    -  - -     -          -        -        --     - -
- -  - -- -   -- --     -   -     -  --    - - - -  -   -- -   - --  -     -----   -- - -    ---   -
-  -  --    - --    -     -    --  -      - -  - - - ----     -      -  -      -   -   - --        -
-    -- - -     -  -    - -       -  - -    -   -       -    - - --- --  -   -----   -- -      --  -
--    - - -- - -- -   --  -            -   --          - -  -  -- - - -     -       -  -   -      --
-   - -    -         -- - - -    -    -  ---       --  ---      - -  -   -     - - -  - -- -    -- -
-     -     --- -  -     -     -        -   ---     -      -    -- - --  -  - -                    -
- -     -  - -   --   --   - --    -          - -      -  - -      - -  -  - -   -- - -        -  --
-  - ---   -  -- -         - -   -        - - - - -     -     - -- -   -       -   -    -   - --   -
-     -     -- -    - -   -         --    -  -  -        - -  -    - -  - -- - -   --  -  ---    - -
-  ---   -      ---  - -   - -  -        -     --  -- --    -  ----- - - -   -- -    - -      -- - -
-      ---   -  -    -      -  -   -  - -      -    -         -        -- --    -    - - --  -     -
- ----- -  --    -    -   ----  --    -  --       --  --  --- - - -    ---    -- -         - --    -
-- -   -         - -- -            -  - -   -   -- -          -    -     --  -         - -   --   --
--   - -    --  -       -  - --- - -  - -  ------ -- -  - --  - -- -     -  --    --  - -  --  --  -
-   -   -         -   - - - - -  -   - ---  -       -- - -      - -     - - -        - --  - -  - --
- -  -     -            -   -  --  -      -  --- --- -    --     -  --   --  --   -    - -      -  -
-- -    - - -   --- ---   -  - ----     -   - --   - -    --- -  -- -  - -  -   - -  -   --    --  -
--        -  - --    -   ---- -     --  -       -  --      -                 -  --       - -   - - -
-   -  -  --   - -    ---          -      -  --- -     -    -   -  -    --     -   -   -  - - -  - -
-           - -     -        -- -     -   -   - -   - -  --     - -  - -        ---    ----        -
- -  -   -   -   -- -----   --- - -         - - - - - ---  --     -   - -     -  -    --     --  - -
-   -   ---    -          -        --       -          --      - - -  - -     -----    -   -       -
-  -      -       -- -- --  - -       -        --  - - - - - -    -  -      --       -      - -  - -
--      -  - --  - - --     - -- ---   -   ---  - - ----- -  -   - --  - -- -        --       -- - -
-  - -     -       -    --    -    -       -  -  -  --  -   --   -       -  --   -     -  -  --    -
--   -        -   -   -    -    --   -         - -  -   --       - -   -  -   - - -  -  - -  --    -
-  -        - -     - -     -  -   - -  - --  -  --      -- -     -- - --  - -           ---   - - -
-   - --   - --   -     - -  -      -       --   -  -   -       --     -        -   -  -    --  -- -
-  - ---   ----  -    -   - - --   -    -   -  -    - -    -  -  -     -   --   -- ---- -       -- -
--     -   -- - -      -      -  -        -       -- - -  -    --        -  -  - --    -  -  -     -
-  -- - -    - -- -  - - -  --     - - -           -    --    --          --   - - --- -  ----   ---
- - - -        -       -    - -- -  -    -  - - - --  -  -      -    - --- -    - -             -  -
-   --  --      - -      -   ---    -        --   - -  -     -- - -   -       - -  --    --  --- - -
-   ---    - --- - --   -    -    - - --- -     - -- - - --        --    -   --  - - - --        - -
- -      -      - -      - --   -  -  - -   ---     -       -        -  -     --         -    --   -
-  --   -   -   - --  -    -  -     -  --  -    -  -- -  -- -- -            - -        -  - -    - -
-   -  - -- -    -     - - -    -      - -  -    -         --- -     - -  - - ---  --   - --   --- -
-    --   -      - - -      --     - --      --  -        -   - -        ----    -  - --     -     -
- --   ----    - -  --  -  - - -  --        - -    -    -- ---  - - -- -     -         -  -        -
- -    -   -    -     -- - - -- -  -      ---  - -     -         --   -    -   -- ---    -- -  - - -
---   -    - - -  --- -   - -       --           --- -      --  -            --  --    --  - -   - -
-       -             - ---   -- ---        -  -    -         -   -  -  --- -  -    ---    -   -   -
-    ---  -     - -   -  -   - --       -    -  -  -  - -   -   -   -- -            --       -  -  -
-- -     - -- ----      -- -   - --   -   --  -- - -     -   - -        --  -      -  -   ---  - - -
-   --   -    --  -  - -- - --- -       - - -       -- -     -       --- ---  -   -  -  --   -  - --
---  -   - - -   --   -  -  -  ----     - - -   - -       -  - -    -   -   --  -         --     - -
-       -- -     -  --     - -       -   -       --  - --   -           - --  -  --  -  - -  - --- -
--- --     -  - - -    - - - --------     --   -  -        - -  -   -    -- -       -    -   -- - --
--     -  - - --    -   -     -  ---   -  -  -         --- --    - - - -  - - -- -    -----   --   -
-    -   -      -    -  -   --       - ---   ---          --   -   - --   - -- - -    -     -- - - -
- - --      - - -- -      -  -    -    - - --      - - - -    ---      -  ---   -         -  - -  --
--       -- - -  -   -         -   -  - ---    --      -- -  -      -  - --   -     -           -  -
-  - -          -  - -  -   - -  -- -   -    - -   -             -  --     -- --    -  -    - -- - -
----------------------------------------------------------------------------------------------------
