100
100
----------------------------------------------------------------------------------------------------
-   -          -           -    --        -              -  --    -  --      --     - -            -
-     -  -  --   --    - -     -   -  - -        - --   --      -  -  -     -     -   - -- -  -- - -
--   - - --   -- -    -   -- -  --- -  - - -   -  -   -  -  ---  --       - - - -  --      -  --   -
- - -  -      - -  -   -- -- - --- -  - -    -  --  -          -   -       -       - - ---   -     -
--  ---       - ---   - - -  - - -     -                -   -     - - -  -     -- - -     -    - - -
-- -   -  --     - - -  -  -  - - - -      -  -    --      -   -   -   -- --- - --  -   --   -   - -
-  - -    - -    -    --         -    - --- -  -   --- ---   - -      - -  -  -        -  -- --    -
-     -- - -   ---    -- --      -   -  -  ---  -          ---   --- - - -     ---   - - -      -  -
-             -     - -    -        -     -   -   - --  -     - -  -   - --- - --        - -- -    -
--- -    -  - -  -  -     ----     - ----- --    --   --   ----- -- - ----       --  -- --  - -  - -
- -    --   -          -- -     -  - -     -----   -- - -     - -       - - -- --  -    - -        -
-   - -      - --  -     -   -- -------      --  -     -   ----     -      -    -   -   -     ---- -
-   - -    --  -       --   ---    -       -     --  -  -     --- -  -    --- - --  -  -    -      -
-   - - -  -     - -  -    -  -  -- -    --   -  -          --    -     -    -  --       -  -   -- -
- - -  --   - -  -  --   -   - -  -       -      --  -   -    --      --   -   -   --      --  -   -
- --   ---  ---- -----   ---    -- - --  -  -- -      --- -     - -  -     -     -     -     - --- -
-      --     - -    -- -  -    -   -  -- -      -    -- -  -   -- -   -     -  -    -     -  -- - -
- -- - -- --      -   - - -       - ---- -   -  -   --        --   ---   -    - -  --    -         -
- - - - ---  -            -      -      -   - --      - --  -  -   -  -  -- - --- --- - -     -    -
-- - - -        --    -     -       - -    -  -  -  -----        --- -  -  -- -   --            - --
-    -        -    -- -     --   --        - --    --          --     - -- - -  --- --  -    -    --
- ---       -    -      -   -  -    - -   -  -   -     --    --  - -  -   - - --      --- -  -    --
-    -                         --  -  - -  -  - -- -     -   --    -    -    -     -      - - - -  -
--  -   -  -   -  --  --   -           -  -  - -               -        -  -  -- --   - - --       -
-  --    -  --        -   -    -     - -- - -- --      - --- -       -   -     - -- -   --- - ---  -
-   - -   -      -  -  - - - -  -  - - --          -  -    -       --  - -- - -    --    - -       -
-  ---  -  -  -       -      -    -- -       -    -   -   - -  --       -        - -   -   -  - -  -
--    - -    - -   --                 -     -   - --  -  -- - --  - -    -   -       -    --    -  -
-  --       - - -- -  - - - - - - --- -    -- - --   -    --      --       -  --   - -      -  --  -
-- -- -       -     -   -    ---        - -   -    --- - -  ---      -  -- - -    -       -  -   ---
-   --    -- -  -  -  - -   -       - --     -        - -       - -   - -     - - -  -  - - -   -  -
-         -      -   -- - - -   -  -      --       --    -  -             -          --  -  - - -  -
-   ---      -  - -      -     -  -       -  -  --   - --- -- --- - - ------    - --   ---- -      -
- -     -         - - -        -    -- -        --     -       -- - -       --- -   -- --    -     -
-   -    -  -    -     --   -- ----      --   -   - - - - -       -  -   --    -     -  ---  -  -  -
-   ---  -    -     -  -  -              - -      -             --     -      - --- --- -     -  - -
-           - --          -- -- --       -  -  -----   -- -       --   -  ---  - - -- -     - -    -
-  - - -  --       - - -  - --       -         ------  --      -     -      - - -      --     -  - -
--       --   - - -    -   -- -     -      -- -  -   - - -       -    -  --  -  --        -  -- ----
--   -      -    -    --      -  ---     -  --  - - -    --   -   -  - -- - -     -    - -         -
----   -- ---  - -   -  ---   -  -           -  --  - -- -- ---  --   -     - -  - - ----  -   --- -
-       --    --   -   -      -    --               --  -  - -    -   -   - ----   - -         -  --
-  -    - - --  -   -   - -   --       - - -  - -  - --  -  -  - - - - - - --  -- --    -- ---    --
--   -  - -  -        -         ---   -- -        -     -    --  -  -  -   - - - -       ---  -- ---
-  - -   -  - -  -  - -       -  --   -  - -  -   - -  -  -   -- --    --  -    ---  -      -  -   -
-  -   - -     -       -  -  -           - -      -      - -   -          -   --  -- - --      -   -
-    - ---  -     --  - -    -  --  --- -  - - - -    -   -  - -    - -     -     - -  - - -     ---
-  -  -      -   -- - -     - -    -- -  -       -- - --- - -  -- -   -    ----  - --- -- -      ---
-  - -- - --       - -     -   - - -  -         --  -   -   --    -     - - -    - -   - --    -   -
--     -  - - - -  -  - -     -          -    -    -- -    - - - -  - -  -     -   -     -  ---    -
- -      -   -  -         - - - ---    - -     -  -  -  --  -    --  - -   -     - -  - -- -  - - --
- --    - ---   -      - - -         - -   - - - ---             - - - -        -  --- - -- --     -
-- -   --    - -        -- - -    -  -   - -      --- -- - -  - - - - ---              -    -- - - -
-  --    -  -      -     -    -  --    -  -   -   --         ---  -  -     -      - --    -  - --  -
-  -  - --   -  - -     --   -   - -  --  --      -  -          -   -  -- - - -    -  ----  -  - - -
-   --  -  --      - - -       -   -      -  --  -    - --  -- -                 - - -         - ---
- -   - ----    -   - --   -  -   -    -    -  -    -        -    -   -  -     -     - --  - - --  -
-- -      -   -   --    --        -          - -    -  -  -  -   - --      -    - --    -   ---    -
- -  -            -- --     -          --     - - -   --    -   --    -  -  --  -   -- -    -  -   -
--   -  -- -- - -   - ----  - -     - -   -  -   -    --  --  -        -- --    -   --  -    -     -
- - -       -   --    -       -  - -  -     ------ -- -- -    -   -           --  - - --    -      -
-  -    - -     -      -     - - -  --- -  -      -              -  -  --  -     -- - - - - -   -  -
---   -  --   -- -- -   --    -    -     -- -  - --    -   -        -       -  --       -  -   - ---
-   -- -       -   - -  ---  - -  -  - - -   -    -  -      - - - --  -  -   --   -  - -      -    -
- - -   --  --  -- -         --  -    - - -- - -     -  -        -     - -   - --     -- -  - -  ---
---  -    -  -    - --         - -     -  -   -  -  --  - -  - -    --   -   -- --  --   -   -   - -
---   -- -      -  -    - - - --- -     -     -  -  -     -- --  -       -        -  -      -  -  --
-    - - -              - -        --    -           -  -- --  --  -- - ------ --  - - -   --    - -
-         -      -    -      ---  - -       - --  --- -   --  --- -   - -   -       --  - -    --  -
- ---- --      - -   -     -   -   - - - --  -    -    -   --   - - - - --   - --     -     --     -
-  -      --  -     ---     -  -     -- - --   -   -        -       - - --       -      -  - -  -  -
--   --       - - -           -  - -   --       - -      -             -  - --   -  --  -     --   -
-  -   - - -       -  -       -    - -            -   -  -  -  - -     -   -  ---     - -          -
--     - -     -- -- -  -      - -    -       -   -   -  - -  - -    --  -   - -     - -     - -   -
-       -  --    -     -    -          ---  --    -      -   -  ----        - - ---   - -     -  - -
--     -       --   -   ---      -- - -- -    -- -         -- -  -              - -   - - -   -    -
-   - - -  ---  -   - -  - - -  --   -      -    --    --   --        --   -- - - - -   -  - -- -  -
--    -    - - -   --   - -  -     - ----     -   -  -     - -   -      -   --  -  -   -  -    -   -
- -    - - -   - -   -  ---  - -  -   -      -   -    -- --  - -    - -- - --- - -      -         --
- -      --  -     -      - -   -  -    --     -   -       -     -      -     -   -  -  -- -- --   -
-- -  - --   -- -    - -   -- --    -   - -         -    - --   --    -----   ----     -       - ---
- - --   -- - -       -  - - --       -    -              --  -    - - - -  --   - -      -- - -   -
- -   -   - -      -  - -- -       -  -- -     ---    -     -   - ---    -   - -   -  - --        --
-  -   -     --- --   -      -    -         -     - -   -      -  -  - - -     --   - -   - -    - -
-   --  ---    - --  -    -     -- - -  - -      -  - - -     - -- -- -   - -- -      --           -
--      --   -- -             - --  - -    - - -   --    --- - -       - -   - -- -         -  --- -
-   ----    -   ---- -   -       -     -  -  -   ----  ----   - -- -  -      --   -  -    - -- -   -
--     -    -  -       - -- -      -- - -  -     -   -      - -  -  -  ----  -  -      -  --    -  -
- - - -    -      -  - -   --   ---    -  -  -      - -  -  - - -  -  - -  -     ---  --         - -
-  - -  -       -          -     -   -    -   - -   -   -    - -   -     -- --      --  --   -- - --
--     - - --        -   - -    -  -         --   --  --  --          -   - - --     -    - - -- ---
-- - -  -       - -      -     --   - --       --  --  ---   --  --   - ---  -    -   -    -- -    -
-  -- - -    -   -  --  -    -       -          -  -  - -   -          - - -  -  -      -- - -  -  -
-    --  -  -- -     - -  - -    --   -- -- - -  -   -- - -   --   -     -       -     - - -  -  - -
- - -       -  -    -        -     -    -      -- -       - - ---    -            -      - -   -  --
- -  --   - -   -           ---   - -- - -   -      --  ---  -    - - -  - --     - -     - -  --  -
-- -  -  -  -   - -    --  -       - -  -- - - -       -   -  -      - ----   -  -   -   -   --  - -
-  - -  -   -   - - - -       -   -       - -      - -         -  -        --      - -   - -     - -
----------------------------------------------------------------------------------------------------
