100
100
----------------------------------------------------------------------------------------------------
- ---          ---      --      -  - -  -   -    -       -              -- -       - -       - -   -
-     -       -            -- -  -- -         ---  -        - --   ---     - -     -      -  -    --
- - - -  ---  - - --   -   -   -            ---    -   -- -       -  - - --     - --  - - - -  -   -
-   -                  - --  - -  -  - -  -    - -    -- -  --    -      - --  -   --- -- -  -   ---
--  - - ----  - - -  -            ---   -    -            -     - -   - -      -      -      -     -
- --         --    -  -      -         -  -- --  -     -   - -  -- --        -      --   - - --    -
-  -       -   -- -        --  - - -      -    -     --  -       --        -   - -  -   -  -   --- -
--   -       -       -   -      -      -   -  -  -   --    - -      - --      - -  -  --    ---   --
- --        --  -       -   -- -          -   -    - - -         - -  -    - --  -  -  -    -  --- -
-        -   --  -  ---  -  - - -        -   -  -- -   - -  ---  --  -  --   - -- --  -- - - - --  -
-  - - - ----    -  -  - -   --- --      - - -     --      -   --  -- - -    - - --  -      --     -
-     --   -      --  -- -  -   - - --   --    -     -  -    -   -    - -  -   - - --  -    -      -
- --  -      --  --- - ---  -   --    -   --- -      - -  - -         -           -  -    ---     --
-  -  -   -   -        - --- -  - -- -   -- - - ---     -          - - -  -    -        --      -- -
-- --  -  -      -   -            - -- -    -   -  - - -  --  -        -   --     -- - --  - - -   -
-    -- - -     - -    -- --   -     -        --   - - -  - -   - -  -  -  -    -   --     ----    -
- - -       -                    - -    --   -      --      -  -   - - ---  --   -        -  -  -- -
-    ---  -  -     -- -- --   -    -  -   -   -   ----   ---- -  -   -    -  -   -  --- -   -    - -
-       - -   - -  -   -     -    -  -     -      - - -     -  --    -        -  - -    -- - -     -
-- -  -  -- -     - - --- - -   -   - --   - -     -    --         -  -    -      - - -    - --    -
-- - -  -        -   - -       -    -    -         --- -  - --    - - -  -  -        - --  -       -
- -    - - - --  -  -    -  -  ---      ---     - --       -  ---       -  - -   ---   --       -- -
- -  -- -  -   -     -  ---         --   -   - - --- -    -- -      - - -     -     - -  -   -    --
--  -     -           -   -  - --    -  -    - -   -  -           - -  -- --   -  -  -  --  -    - -
-  -   - -  --- --      -  -    -     -   -  -  - -  - -  --   - -- --   -  -    -    - - -   ---  -
-- -       --   ---         - --   -  - -- -    -  -- -  -  - -   -     ---- ---  ---- - -  --  -  -
-  --   -    -  -  -     -           -   - -  -  -   - -- -     -  -        - -   -  -     --    - -
----   -  - -- -   --  -    - -   - - -                 --  - -   -  - -  -- - -   -  --    -  -  --
-  -    -       -  -    --      -   --   - - --  -    --  -      - ---  -  -   -- - - --      - -- -
-    -       - -     -  -- - -  --   -  - -- -      ---  -   - - -   -   -   -  - - -   -- -  ---  -
- -    -- - -  -  -              -        -  - - --  -    -- -   - -      ----      --   -       ---
--       -- - -            - - -        ---  -            -- -     -              - - - - ----  -  -
--      --   --- - - -   -  -     - -- -   -   -   - -  --        --   --         -  -   -   -   - -
-       -----  ----    -  -  - --  -    - --            - -   -   -      -- ---- -     -     --    -
- -       -   -       -- - - --    --            -  -  ----    -  - --     -   - -- - -   -  -    --
- -  - ---   --   -   - -  -               -     - -   -  - - -     - -   --             -- --- -  -
- -  -        --  -  - - -- - -      - -     - -  --    - --     --  - -  - --  --- - --     -  -  -
-      -      ---    -  -  - -- -  ---     - -     -  - -  -  -- -  -- - -- - -         - --  --  --
- -- -   -       -- - -  -   -     -- -  -   - -      -           -  - -    -      -  ---       -  -
-    -  -  - -  -   -   -   -  - -  - - - -  -- --     --  - -   -   -  - -  -       -       -  -  -
--- -   ----  -       -    --   -  -    -  - -  - -  --  -    -     - -     -       -  -- -- -- -- -
-   - -       -       ---     - ---- -- - -     -- -  -     -       --   ---  - - -    -          --
-    - --   -   --- - -               -   -- -            -      - --        - - - -- -    -      --
--    -- - -   -      --        - --     -  - - -  - -  - ----       ---- --   --    -   -     -   -
-  ---  -- - --     - -   -   -  -    --   -  -       -   --   - ----   --     - --        - -   - -
- -    -     -   --    - -  - --    --  -    - ---      -     -     -       -- ---   -    -  -- -- -
-   - -  - -  -     --      -   - -     -   -    -- - -   -  -  -     - -- --     --   - - - -   - -
-- --     - -        - - -  -   - - - - ---    -        --  -     -  -  -      -   -  - ----- --   -
- ---   --- -  --  - - -  ---            -      ----  --   -    -     -- -   -  -          -  -   --
- -  - -    -           - - --    -  -  - -   -     -    ---  --  -       - -  - ---  ---      -   -
-- - --    --- - -    -   - -  -  -  --  -- -  - - - - -    -  -  --    --        -   -- -    -- - -
- --  - - -   - --   --    - - -       --  --  -    -  -- -  -   - -  - -       --  -      -  --   -
--   -- --   - -   - - -   --  -        -  - -      -      -   --   - ---   - -  ---  - -     -- - -
-  -- -          --  -   -     -   -  -  -- - -       --  -  --   -   --   -  --    ---- - - --  ---
---     --   -    -- -       -      -    -  --    -  -           -     - -        -              - -
-     -      -    -   -  -  -    - ---      -  - -  -    - --    -   -      - -    -  --     - -  --
- -     --    -   ---        -  -- -        - -    - - -    -- - -  -        - -- -  --  - -   -   -
-     -   -  --       -      -        -   - - -  -   -    -   -     -    - -      - - --          --
- --    -      -  --      -  - -  -   -  - -    -  - -    -          --   - ---            -       -
-  - - --      - -   -  -   - - -   -     -  - -  -     -   - -         - -  - -      -    --- -   -
-  -      --- -    -     ----   -   - --   -     --    -    - - -   -   -    - -      -   -      - -
-  -     - -    -  -    -  - - - -----  -  -- --   -  - - -       -      --   - -           --- -  -
-   - -         -     --        -    --     --     - -- --  - -- - - -  - --     --     - ---  - - -
-       --  -   -  -   -- --  -  --   -- -       -   -- - --           -    ---      - -     - - - -
- - - -    -  - --  - -   -    - -  -           - -       ---   -  --           -      - -  -    - -
- -     --    -  --     --    - -- - -  -   - -  -   - - -   --  -   -  --   - -    -- -  ---  -  --
-   ---         -                  - -  -  -- -       -  -- -  -- - - - -  -    --       -  -- - - -
- -      --   -  --    -- -    - -   -- -      - --  -     -      - - - - -        - -   -  -      -
--   - -    --  -  ---    -  --      - -       --  --  -- --   -     -- -    -         -  -   -  ---
-- - -   --      - -     -      -      -  -    -   -   -   -  -- --- - --       - -- - --          -
-   -    -     -          --  -       - - -            - -      -    -    - - -  -        -    - - -
-     -   - - -      -    - -    - -      -           -     -     -- -        - --- - -   --       -
-  - ---- --  -   -    -- -   - -  -    --- -    - ----  --    -- -  - - - -   -   -    --   -- -  -
- ---        --  -  -   - --   -  -       --  -- --                       -   -- --  --  -- -    ---
-- -   -  --      -- ----       -   --     -      -    -- -  -- --         ---  -   - ---  -   - - -
- - -- -     -        -    - --    -  -                  --   -  -    -  -- -    --         -   -- -
- ----   --       -   --   - ---- - -     - -   - -     - -  -   -         -  -    -      -    -   -
--   -  -    --- ---        -      -       -  ----- -   --  -        --  -        -- - - - -- -    -
--       - --     -   - --       -       -- ---            -  -   - -- -- -          --   -   -   --
-     -  - - - -   -- -    -- -      - -     -----     -            -     - -  ----- -  -  - --    -
-    -       -- - -  --   -  - --  --     --             -     -    - -   -      --   - --  -  -   -
-    - ---    - -   -   --  -   -   - -   -    -  --        -     -    -    -  --   -     -  --    -
-   --    -   -  --   -     - - --  - - - -  -  --       -    - -      -  -  - - -     -     -     -
- -       -    --  -  - - - -   -  - -           -     - -         - -- -  -       -      - - --   -
- --      --     - -      -  --           -       - --  -- --  - -  ----  -     -     - -  ---     -
-        -          - -  --       -    - -     - -- --   - -   - - -    -   -   ---   - -   -     --
- -        - -  -  -   -      - -   - -  -    - - - --- -   - -     -  -   -  ---   -             --
-      -      - - ----   - -    -  -   --    ---  --  -     - - -    -  --  - - --- -  -      --  --
- -  - -- -  --    -   --        -  - -- - -  - - -  -  - -  --  - -   - - -      --       -    -- -
-     -    --    -       - -- --  --         -  -      - - -    -    ---             -  -  -     - -
-       -- - --    -- --      - - -  - --  --      - - --    ---   -    -    -     - - -  - -     --
-        -  - - --  -  -      - -- -  - -   -        - ---  --    --  -  -   -   - -     -      -- -
--- - - - ----  -    - - --    - --  -   --   -   - -    - -  -       -  ---- -- -  ---  - -       -
-  - -           -- --- -   ---  - --  - -  - --    - --     -   --  ---      -  --                -
-     - -- - - -  -    -- -     - - -   -       --      ---       --    -      - --      -         -
-  -  -   - - -        -  -     -       - -- --    - -    -- -     -    -     ---   -    - - -- -  -
-   -    --   -- -       --  - - -  -- -   -   - - -    -     - - -    -   -      -         -- -   -
-          -     - -   - -  -  -  -    -  -  -      -    ---- -  -   -   -    -  -   -    -   -    -
----------------------------------------------------------------------------------------------------
