100
100
----------------------------------------------------------------------------------------------------
-   -  --   -     -   -- ---  - -  -   -   --   -          -------     -    -     - -   --  -  - - -
-     --    -   - -   - -      -  - ---   -   -  -- --- - -   -- --          -           - -     - -
-   -   -  - -  - - -      -- -    -    -   -  --  -   - --           - - -     -    --    -  -   --
-         -   --  --  --- -   -   - -- -  --        - - -    --- -- -       -  -   - -    - -  --  -
- - --  - - -       -   -      - -  --  -   - -  -  - - --     -    - --- --       -  - ---    - ---
--    -   -  ---  -   -  -    ---      -- -  -   --- - -  - ----            --     --   - -        -
-  - - --        - -      - --  -    -- -       -       -       - -    - -   - - --      -     -----
- - -     -     -- - -   -    - - ---          -   -- --     ---      -   -- ---  --- - - -    --  -
- -  -      - --   -    - -     --  -   -   --- -     -   -          -     - -   -- -  --    -    --
-  ---    -- - - - -      -   --  -- ---- --  - - -- -  -        - -          -     --    --       -
-   -     - -     -   - -  - -     -----       -   -     - -  -    - - -- -   -- -         - -------
-  -  - -   -  -  -   -    --  -    -     - -     - --      - -     - -   --     - --  -  --      --
-   - -    -        -          -- -   - -  -   - -- -  -- -    -         - --    -              -- -
-   - --     ----  -      --  -         - - -    -  -    --      ----         -     -  -- --     - -
-- -  --  --  -  -  -   -  - - --        ---    - -     -- --     - ---    - -   - - -  - -  ----  -
- - -      -    --       --  - -- --  -     --   --  -   -   -- -- - -  - -   --- - -- - -  - -    -
-    --  -- -- -   -  --- --     -     -- -          -     ---    - - -     - -   - -   -          -
- -           -  -   ---  -- -  -   -   -- ---  --- - -     -   - --  --   -          -  -----  -  -
-     --- -    -      --- -                          -   -  -        -- - -  - -      - -- -   -   -
-  - -  - - -  -- --  ---  -    - -    -  --       --   - -- -  - - - -    -- -  -- -   -  -    -  -
- -   - -  -  -- -    --- -   --   -      - - -       -     -     -   -   -    -        -    -  - --
- - --    ---- ---   ---   - -     - -- --           -  -- -    -   -     -  ---- --   -  ---   -  -
-- --         -  -    -           --  -   --  -  -- -      -  -- -  -   -      -              -   --
- --      - -    --- -      -    - -  - -              - -  --       -  - -- - - - -  -- -   -- -- -
-  --  -  - - - -  - -   -    - - -- --  --   -  - --  --  -   -- ---  -- ---  -      - -         --
-      -      -   - -        - -    -  - -              - --     - - -  -   - -   -  - -  -  -   - -
-    - - - -     --  - - - -  -    - -     -- -    - -  - -  -     - - --- --- -    -   -  - ----- -
- --   - -- --    - - - --- ----         - --- --     -     -  -       - -  -    --   - -  -       -
--  - -  -        - - -    - -    --  - --           ----  - -- - --        --      -    - - -     -
- - -    -     - --   - -  -- -              -- -   -   --  - -  -     - -       --  -          -  -
- -   --  --      -  - - - -  -  - -  --- -   -  -    -      ---   -      -    - - -  - ---      - -
-    - -   --   -    --   - -  - -   -  -    -   -  --     --     -   - -    --   -          -   - -
-    -  -  -           --     -   --   - --- - ---       -     --    -    --    - --  - - -   --- --
-          - - - -   -  - -    --  -     -  - --   - -- - - -   -  --         -      - -  -   --- --
- -  ---        - ---  -       -     - -   -         --    -- - --    --  -  -  -- - -   - -  - -- -
--    -    -  --    - -    -      -    --   --  --         - --   -      -        -   --- - -     --
- -- -  -- -  - - -  -  --  -    -      - - -  -     --  ---  -     - -    -  -    --  - --    -  --
-   -       -   -- ---  -     --- ---- --  -  --     --    -  - --- -         -         - -- -- - --
- -  -   -   -   --  -          -    -     -    - -       -  --  -     - - - -   -        - -    - -
-        -            - -  - -   - ---  -   -       --- -       - ---   --     -   --  -- - -   -  -
- - -   -       -  -  --    -- -  -   -     - -    -  -  -      - -    -- -     -   - --   -- - -  -
-     -  -                   -  -  -  - -   --      --  -   - ----      -  -  --        -      -- --
- -      - --    - -     ---   -      --  -    --- -       -    - - -     ---    -  - - -  -     - -
-  -   -     --    -   --         - -    -  - -     -- -  - -  - -- - -- -    -  - - -  -   -   -  -
---   -    -       - --   --  - -- -        -        --  - - -    -       -  - -     -   -- -   -- -
-- --- -    -    -     -      -  --   - -    -  - - -          --   --- --       --- -  -   -- - - -
--  -   - -    - - -       -   -   - --  ----       - -      - - - -      -   -      - --- -       -
-  -     - -  ---    -  - - -- -   ---- -      -----    -   - -  - -     -    ---  -   -           -
--     --- -     --     --      - -----       --   -  --  -   -    -         --  -   -  - --  --   -
-   - -      - -  -    -     - -         -   -     -  -  --       -  -  -   -      -  -   -     - --
- --   - --      -  - - --   - - -  - -     -  -   --    - -   -      -  -        - -    - - --  - -
-         - -       -  -      -             -- --     -    -      --  - --        -    -    - -  - -
-   - - -  -   ----- -    -- - - - - - - -     --  --   - -  - -  -       -     -  - - -  -  -   - -
--     -    - - -                -    - -   -- - -            - -       -   -      -     - -   -----
-       -     -   -    --- -- --- --       - -   - -  -    - - - --  --       - - -     -   -  - - -
-   -  -- -- -- --   -    --     ---  --     -   - -  -     -  --            -   -      - -- - -  --
-   - - -       -  -       -     - - - -   -   -      -    - -   --   --       -             -   - -
--     ----       ---   -    -      -     - -    - -  -  -      - ---  --  -   -      --           -
- -        -  -  -    - --  -         - -  -- --   - -        -  -  - -    - -  --    -    -       -
--    --  --   -   --    - - -      - ---     - -    -     -         - -----  - -   - - - -    -   -
-  -  -   -- ---    - - - -             -   --  -   - -  - - -  - -           -- -          - --   -
--- -     -            -    --  - ---         - -  -   -   - -    - -             --     -  --   ---
-  -- - -  -    --  -  -     -     -        --    -  -  -- -  -  -- -  ---   -   - -  -   - --     -
--           - -   -- -  - - - ----   -  - -  --   --    -  -   -     --       -   -   -      -  - -
-  -   -  -  -  -        -     -       - -    --  -    - - -    -- --       -   -  -  - -- --      -
-   - -  - -  -  --         - --  -   - ---      -                    -   --  -  -  - --   -   -   -
- -       ---  -     -    -    -      - -          ----- ---- -  -     --      -  - --  -   -      -
-- - -  -   - --   - -    --  --   --     -          -- -  -  -  -   -    --  -        -- - -   -  -
-    --   -    --    - --     --    -- --          --- -   --  --- -    - -   --       -- ---  -- --
---   - ---  - - -  -    --      --      - -    - -    --       - -         --           -   - -   -
-       -   -     --- - -    - -   -     -- --    --  -    ---    -      ---   -    -   -- -  -  ---
-   -   -  -- - --  -        - - - -   -- ---  -     -   -- -      - - -             - -   -   --  -
- - -        - -   --  - - --  -  --  -- -    - -     -    - -       -    -    - -   - - -  -   -- -
-  -   -- - -     --                   -    -  -  -  -        -    - -   --    -   -- -    -  - - --
---        -   ---    - -  -   -    - -          -   -    -    --  - -          - -  -  -   - - -  -
-  -  - -     -             -       -   --   -       - -      -- -   - -- -- -   --   -   -    --  -
--  ---  - --      -                - -     - -   - -        -    -    -             -  -   --   - -
-     -        -       - - -  -     -        - -      -  --   -----   - ---      --    -       --- -
- - --- - --   -  -    -               --    -   --- -   - - -    - --- --  -- - -     -  -  ---  --
-  -  --  -  -         --  -    --    - -    -    - -- -  -      - - - - -- -   -  -    - --     ---
- ---- - -  --         - -    -    -       - ---    -   -  --  -       -  - -       -  -   -  ---  -
-     -        --   - -        - - --   --- -      - -   - --- -    ---   - -- --   -    -   --    -
- - - -  - - -  - --   -   -     ---  -- -  -  --    --    --- - - -    -      ----    -- --    -  -
- ---     -  - -     -  -     - -     -              -   --       --  --   -- -   -- -   -     - - -
--   --    -   - -- -   -   -   -   - -   - - --     --      - --   -     -       - --  --  -      -
-   -    -   -- --      -  -- - -      --           -      -     - --- --         -  -          ----
--  ----  -- - - -- --        -    - -     - -     - -    -  --    -    -   -         - -   --     -
-- -             - --- -   - -  - -    - - -    --        -- --   - --  - -     - -      - --      -
-   --  -     -  -- -  -    -      -   -  --     - -     -     -  --- -      - -    --       --    -
- -     --  -- -      -         -      -     --        -    ----       --    -- - -  -       - - ---
- -  ---  -    -  --  -- -    --- -- --     --    -- -   -     -     --         -  -  -    -- -    -
-  --   --    - -             -   --          ---  -    - -- --      -  --    - - -  -  -       -- -
-- - - -   -  -        -   ---   -   -  -           -   - -  - -   - -- -   - - - -         --  -- -
-- - -    -  - --  -- -           -  --    - -- -      -   ---   -     -   - - -    --     -   --  -
-- -    -  --       -    -- --    -            -         -  -  -    -  - -  -- -  -    - -     --- -
-     -       ---  - -         --   -  - - - -  -  -     - --   - -- - -   -   -  -- -    -  -  -  -
- -       -- -      -- -  ---  - - -- -  -    - ---   -    ----- - -- -    -- -    -   --       - --
-    - - -     -   -     -      -  - -   --  - -       - - -     --  - -    -               -      -
----------------------------------------------------------------------------------------------------
