100
100
----------------------------------------------------------------------------------------------------
-     -                      - - -   --  -----     ---  - -  - -    -        - - -   -- -- -  - -  -
-  -   -- --     -  - -  - -   -          -- -    - -     -- -- - -  -    -       -   -  - --    - -
-    -      - -  --   -       -- --    -      -       --   - -  -- -  -     -   -   -  -   -- - - --
- -- -  -- -       -     --      --   -  - --    -      -      -   - -----   -    - -   -       -  -
- -   - --    --  -       - --       - -  -- -      -   - -     -   --     -- -- -   -- --  --  -- -
-    -  -      -   --  -    -    --   -    - - --         - -     -     ---- -      -- -  - -- -   -
-           --    - --  --  -- -   - - - -  -      - -    -  - -    -  -     -- -           -- --- -
-       -  -                        --     - - ---         ---    -   -  - --     -- - --  -  --   -
-  -     -  ---           -- -- -    - - - -   -         --   -       -        -            -- -   -
- --   -      -  -   -   --      -     - ---  -- -----    - - -  - - -- --  -      - -- - --       -
--  --         -  ---- -    -  - -   - --    -  --- -   - --   - - -  --    - -     -- -   --   -- -
--   -         -  --  - - - --     -  -      - -   -    -     - - -  --  - -   ---  - --  -   -    -
- -- -  --  - - -- ---- -  -   - --    -     --   -     -     -  -  -   ---     - -  -   - --   -- -
-   - --  - - - -    - -     -  -   --           --  - -   --   -    --     -   - -      -         -
-       -  -      - -- -  -  - -    --  -      -- -  --  - -   - -         -   -  --  -          - -
-  -    -            -- - -   ---     --   -       -      - - -   - -  -  -  --   -  -    -    -   -
-      -     --    -    --- -  -  -  -   - -   - -    - -      -   --- ---   -    -  --      -  ----
- -    - -         - - -    - - -    -      -    -     -  -      -    --  - - -  - - -  -- ---   - -
-- -    -- --             --     -     -    - --     - --           ---  -- -   -   - -       - - --
-  - ---  - -- --  - --  -  - -   - --        - -  -   - - - -    -- - -      -     --    ---      -
-        -    -  -      -     -     --   --    -        - --  -     -   -  -   -      - -   - -- ---
---    -   --  -- -- - -   -  -  -  ---- -        - -        - -           --- - -  --  -  -- --   -
-     - --    -- -  - -  -- - - -         - ---    -  -  - -  -          -    -   - - --  -- -     -
-   - -  -       ---   -- --     -  -            -      -   -- - -  -  --  --   -- -  -      --- - -
- -    - --      --    - -     -        -  --  -- -----  --  -  -     - --- -  -    -- -  ----    --
- --     - - -   -   - - -- ---- -     --   -    - -        -     --  -   - -  -       - -  -   -  -
-  -             --  -     - -    ---- -      ---   -   -   -- - - -    --- --     --  --     ---  -
-  - -  -       --     -   -     -        -  -      - -    ---    -  --    -     - -        -  -   -
-  - -     -      ---- -      -    - -  -     --- -   -- - -   -  -    --      --    ---  -     -  -
- -   -   - --  -- -- - -- - - -      - -     -   -  -   -      -  - --- ----    -   -          -  -
-       --  -   - -   -   -     -  -  -           --   - -   -  -    ---      --  -   --   --  -   -
- --- --  -  -- -     -  - -     -   -  - -   --- -   - -   -     ---   - --       - -    -  --- - -
- - - -  -   -  - -      -        -  -   -            -   ---    -   - -  -  -  -- -  - --- -      -
--       - -   - -   ---- -- -   - -   -       -    -     -  -   - --   -   -    --          -- -  -
-       --  -     --     -  -   - -  - - -  - - --         - - -- - -     -        -  -           --
-          -   --      -   -  - -  - - -- -- -    -- -       -    --   -    -     - - -        -   -
-  -  -           -   -  --    -     -   -    ---   -      -  --  - -- - -- -       - - ---        -
-  - - -   --        -  -  --  -- - -- -  -  --   -  --- --               - -   ---    -   -- ---  -
- - -- -  - --  -  - -          -   -          - - --  - - -  -  - -    -     -  -- -     - -      -
- - -- -     -  -  --- -    --    - -   - --  -    -     -  - -   -  -   - ---    - - - ---    --  -
- --  -  --   --          - -    -     --   -    -     - -  -   -    - - -    - -- -               -
- -     -   -   --   --- -  - - -  --    --           - -       -           ---  -   -  - -       --
- -- - --  -   -- - -----     -  --  -  -  - - - -  --  - -  -        - -- --       -   - - -      -
---    -   --        --     -    -   -           -        -        - -  -    --       --        -- -
-        -       ---    -    --   -   -- -  - -  -  -- -   -      -  -     --      -  -     -  -  --
-- -  -   -- -  -  -   -  - - - -   -        -   - ---    - ---    -   -     -  --  -              -
-   -    -  -  - --  -    -           -  -       -    - -  -   --  -  -    --  --  --  - --   --   -
-     -   -- -  -- -  --- -    -     - -    -   - ---     -  -    - -            --    -        - --
- - - -   -- -- -   - - -  - - -  - --          - -  - --    --     -   -     - --- ---    ----   --
--   -    -     -      -          -    - --   - -  -        -- - -    - -- -       --- --  -  -    -
- --  -       -  -   - - -  -   -   -   -   -   - ---  -       -    --  - - - - --- -- --     - -- -
--  -  -  - -        -  - -       -   -- - -   -  -  ----  --  -  ----  - --     --            - - -
- --    -    -  -- -  -- -  --    - - --      -           -  -     --- - - --  -   ---  -  -     - -
---  --  -- -     --   -      -      - --   - - -               - -    - - -  -   -   -   -    -   -
-  --     - -  - - -  - - ----- -  -   -- -  - - -- -   -         -- ---  --  -  - - -     -   --  -
----  -  -  --      -    -    -   -   -     -       -  -    - -  -   -    -   -    - ---- -   -   --
-      --  - -----   - --   -- --  -   - -  -    -  -     - ----  ---  -   ---      -- -   --  - ---
-  - - - -     -  ---    -   -- -       -- --           -  - -  -  -  -       --   -     - -  -    -
---   - - -  -   ---  -  -       -   -  -        -  -       - - -          --    -    -         - --
-   -   --            -- -   -   -  -   - -       -      - --    -     --                  ---     -
-    -    - -     ---  -   - -   --       -- -- --   - -- - - -      --         -       - -     ----
-  -   ---    -- -   -  --  -        -     - --          -  -    -    -   - -    - - - -   ---  ----
- - -  --        - -     --     ---  -  - -         --      ----     --  - -       -    -   -    ---
-        --  -       -      -   -    -     --    -     -   -- -     -  -     -----  - -  -         -
-- -  - -   --       ---- - -  -  ---    - -  --     -   -    --       -   -   - -    -      -   - -
-- --           -  - -         --- --    -  --       - - --     -         -  -       -   - - -     -
-     --  -  -   - --   - -     --  - -                --  -  --  -- -       ----  --    -    -  - -
- -      -    --      -     - -  ---      -   -  -   - -  -  -  --     ---     -  --   - - --      -
-  --      --       -    -      -      -- ---   -  - - ---- -  ---  - -     -  -- --   -   -       -
--       -    -- --  -  -    -   --    -- -- -  -    -           -- --  -   --    -  -    -      - -
-   -   -  - -    - -  -- -  - - -         -  - - -  - -       -   --  - -     - -   - -   -   --  -
--    - -     -- -    ---  -         - - -  -          -  --- - -  -    -   -    -    -- ---   -   -
- -   --   - -    -    -  --- - -  -      --    -    -             - -      - - -    -    ---      -
- -   - - - ----- ----   - --  - --      -  --    - -              --- --   - -     -        --  - -
-  --   - --  -  -    --     -- -      -   -  - -   -     -   -           - - -   -      -- -   -- -
-  -- - --  --    --- --    -      - --     -   -            -     - - -  -        -  -    -  -    -
-- ----  ---             -       -  -   -- -       --         -       -  - - -     -               -
-     -- - -   --      --   -     - -          ----  --- - -  -    -  -   -  --               ---  -
-   --   -      --  ---  - - -   -   -   - -    -       -  -  -    -  - --   -      -- -       - ---
-   -     --  --      ---    -  -- -  -- -            -  - - -- --- -  -  -    -        - - -   - --
-  -  - -  -  - -  --    -  --     -          -     --  --     - -   -    -- ---- - -  -      -  - -
-    - -- --      - --   ---  - ---      - - --- --    -     - --  --    - -       - ---  - - -  ---
---  - -         - -     -  -- -  -      - -    -  --  -  -  -  --    - - --   -     ---   --     --
-      -   -   -   - -  - - --      -  -          -   - -   -  -      - - -   -         -        - -
---  - --  -- --  ---    -  - -- -            -- - -       - -      - --           ----   --   --- -
-   -   - -   - -  -  - -   -    -      -    -  -   --     -  ----- - -  --   -  -    ---    --   --
-   -  -    -   -     - ---    - -   -- --                  -  --   -   - ---    --  --    -  -    -
-  -     - -   - --     -    -        -   -   ---                  -  - --   -         -- -   - - --
-     -   - -   -  -   - -- - - - -  - - --    -    -   -   - --   --   -     - -- -- --   -  - -  -
-  -   --- --  -       - -  -    -            -    -  -  - ---      ----           -   - -   - -  --
-  --   --    - -       -  --  - -- -  - -  - -  -- --    -       -  -      --  - - -  - --    -- --
--    --   -    -- -      -     - -     -  - -    - -  -- -       ---   --   ---  - -- --   --     -
-  -   --  -          -  --    - - -     -     - - -- --   -   - -      - - -   -- - - --   -    - -
-    -   -      - - --  - -         -- -- --    - -  - -       -        --  - - - - -    --  - - - -
-  --  ----     -    -    -      -     - - --       - - --       ---  --   --  -     --      --   --
-  -        -   -  -       -       -   - -   -- -     --           - -  -    - -   -  -- - -  - -- -
--      -- -   -  - -   -   - -- -   - -     -  -   - -  -  -   - -   -          - --- -- -  - -   -
-   -           -     -       -          -   -     -  -       -  -- - -  -      -                  -
----------------------------------------------------------------------------------------------------
