100
100
----------------------------------------------------------------------------------------------------
-           - --     - -    -  - - -  --     -  -   -        -         - -     --     -  -   -     -
--  ---- -     - ---- -    -       - -  -  - -- -   -   --            -     - -  -  -  -  -  --   --
-  - - -  -- - - -     -             -  - -           - -- -  - - -  -   -     --       - -  -  -  -
-  -- - -   -   - --    - --       -         - -  --  -- -      - -   -  -  --- -        -   --    -
- - -       - -- -   -     - --   -   - -        - -    -    -    -    - - ---    -  -  -  --  -  --
-    - --                      - -    --   -   - -  - -    -         ----  -    -  --  -     -     -
-   --   --    -    ----- - -   - --- -  -    -      -  - -    - -     -     -      ---    - -     -
-     --                     -- --  -   -  --     -    -- --      --- - --- ---  -   -  -  -   -   -
-   -    - - --  -  -   -    -    --  --        -        -       -             -- --- -          - -
- - - - -    -   ---    ---  - - --     -         --   - -           --    - -    -    -    -  -- --
-   ----  -   ---  - - - -  -    -   --     --     --          - --  - - - - - --    -- -   --  -  -
-          --        --    -         -         -   -   -   - - -- -   --    - -          - - - - ---
- --- -------     -- - -         -    - -       - -    - -     - --- -   -- -       ------- --  -  -
-  --        - -    -    -   --     ---    -            - -   -  - - -   -  -  -    -  -  - -   -  -
--  -      -    -   -  --- - -          --- -  -    -   -   -   -       - -- - -      - -     -   --
-  -       - - --   --    -  ---  -  --  - -   - -     - -       -      -   -- - --  - --  -   - - -
-   -   --      -          -- -  - -   - --  - - -      - - -    - --   -     - -   - - - - -   -- -
- -- -   -        ---           - - -     - -- --               --     - -      -     -    -     - -
-- - --       - -   -    - -----   --  -    --  --        -   - - - -- -   - -      --      --     -
- --   --- - ----  -  -- --   -      - -- -- -          -   - - --   -  - --   -    - -- -  - -    -
- -     -   -  -    -       -   -   -   -       -   ---       - - -         -  -   -  -- --   -  - -
--  -  -- -- - - -      --  -- -  -   --    -  -   -- --    -----  --  - --- --     --  -     --- --
- -   -    -   - - - --   --  - -    - - - -    ---  - -              -   -   - - ---   -----      -
- -     -  ----- - - -  - - --- -      - -  - -  --                    -    -          -   -    -- -
--    -    -      -- --   -    -   --    - - - --      - - -   -  -   -   - - -                    -
-         -  --- -    -  - --- - - -    - -  -    --   -   - -        - - --   -   - ---     -- -- -
- - - --    -   -         - - -    -- -   - -- - -      -- -      -    --     -      - -- --  --   -
-- -     - - -- - -      --       -   -- - -   - --- --  - -- - --   -   -   -    - -    - -       -
- - -    -  -- -  --   ---  -   -       - -   -   -    -- -      --    - -     --    -     --      -
-       - -- -    -  - - --- - - --   -  -   -    --   -     -  --- - - - - -     -  -   - -  - -  -
--             -- - ---    - - - ---    -- -            -         - -  -  - --  --            -    -
- --        -   -  -     -- -  - -                 -  -    -          -  -- - -- --- --    -       -
-  - -      - -  -              -    -       -          -  ---         -      -   -     -   ---    -
-         -   -  -  -  -  -   - - -    --   - -     -         -  --- -     -  -  - --- --- -  -  ---
- -         ---    -  - -       -    - --  -    ---   ---    ---- --   ---      ---   -    -  --   -
- -    -  --       - -  --  - - - ---  - -   -     --     -  -   -----     - - -  -       -  -   - -
-    --    -     --  ---      - -  -     -       -   -        - -    -  -   - -    -  --   --      -
--      -   -   - --  -       --  --- -- --   -         -    -              -  --   -  -    - - - --
- --  -- --  --     -  -  -  -       -  ---  -  - -  - - -        - -  --    --  -  - --  -- - --  -
-   -            ---- -  -         --  -   -- - -     -    --   -  -      -      ---  - - - --- -  -
-   -         -  -    -   --        - -   -  -   --   - -      -- -          -             -  -    -
- -  -  -   -   -  --- -     -      -  - - -       - --  -   - - -- -              -     - -- -   --
-     --  -          - - --  -    - -  - - -        --   -      -     --- -   -- -  -     - -   - --
-  -   -   -- -     -- - - -    --   - -   - -   - -          - - ---      -  --     -    -  -     -
-  - - --    -- -       --   -- --           -           --- -   - -    -  --  -  ----  - - -   -  -
- - -    --    --      ---     -   -     ---  - - - -      -  - -   --       - --    -     -       -
-  -  -    -- -  -    -    --    -- -  --    -  - - ---  -             -     - -   --  -     -- - --
---           --  -  - --     -  - -  -   - - --  - --       - ------      --   -    -  -   --- -  -
-       - --        --   -   -  ---    ----      -    -  -    -      -  - -- -    - - - -    -     -
--   - - -         - -   -   -   - -  -    - -     - -     - -  -  -     - - -   -   -   -  -  --- -
-- --  -   -    - ----     - --- -     ---     --   - - -  -     -- -   - - --   - -- --  ---     --
-      -   --    -              ---   -  - -- - - -  -        - -     -  -       -      - - -  -   -
-- -              -  - -  ---   --    --       -    -- - -  ---- -   - ----    -      -  - -     - -
- -   -   --- -  -    -  -   --  -- -   ---- --  -   ---      - -     -       ---  -    ---     -  -
-      - - - -- -- -    -  -       -  - - -  -      -    -   - - -    --  - -     - -- -    - - -- -
-  -  -        -     -- - -  - --  -- -    -       -- -  -   -   -    -- -  - -   - --     -   -  --
--         -  -   -- - -    -      -         -  --     --  - -  -  -- --   - -  -   - -- -  - -    -
- - ----     -  -     - -    ------ - ---      -   -  -  -       -- - -- - - - -      -   --- -    -
-  -     -- --    - -- --   -    -- -   -   --     -   --    - ----     -   -     -- -- --- - -- ---
- -  -     -  - --     -  -- -   - -- --- -    -   - - - -  -  -- -----      --  -  -   -   - -    -
-   - -    --   - -   -         -       -          -        --   --    -  - - -   -     -  ---   - -
-      - -    - - --    - ----         -     -       -   --    --     -    - -  ----   -- -     -  -
-    -           --             -       -         -----     - -  -- -   -- - -   -    - - - --  -  -
--- - - -  -- -- - -  - -     - -   -- - -     -            -        - - - -  --  --      -    - ---
-   - -- -- -    -  -  -  -      --   --   - -    ---   -  --   ---   - --   --   - -  ---  -  -   -
--    --     ---  - - -  - -    - - -     -   -  -      -    -  -  -- -  -       --         -    - -
- --- - --    -    -   - - -  -    - -  -  -   --    -   - -  - -   -     -  -- -     --     - -  --
-  -   --   -       -  -  -  - - --  -       -   - - -   - -  -  --   -     - --      -   - -   -  -
-   -    - ---   - --  -    -- -  -        -   - -  -- - - - - --  ---       -       -  -   -  -   -
- ---  - -    ---- -    -  --- -    -     - -  -  - -   -        -     -   -              -      - -
- - -   --    -  -  - -   --      - - -   -    --    -- - - - -  -  --  -- -   -   -  -  -  - --   -
- --   -  -  - - -            --    --  -     - -  -     - - - -        -  -    -         - -     --
- -   ----   - -   - -  -        - - ---- -       --     - -   - --      -    --   -     -         -
- -          -- - -  -  -       --      -  -    --   -  -      -   - -   - -  - -  -  ---        - -
----    - -     --       -      - -        -    -- -     --   -     -- - - -  -   -    - -   - - - -
-      - -- -   -  - ---  - - - --    - - -  --    -    - - - -    -    -- -     -  --   -     -   -
-  ---        -- -        - -   - -      -         --      - -  - - -      - - - --         -  -  --
-         -   -  -    ---       --    --      -       --     -               -----      -- -     - -
-   -- - -  -   - -  --    -- -   - - -   - --    - --    -    -        - --          -        - - -
--    - -  - - - - - -   --    -  - -  --   -- - -   --- - -   -      -       -     --  -     - -  -
-    -     -    ----           -----    -         - - -  -  - ---  --    -  -  -     -   -   -     -
-    - -  -  -    -   -       -   --  -   -         -     -  - -     ---    -    - --  --        - -
-  -   -    - - -  -  -          -   -   -     -- -  -    -     -       -        --   -    --- - - -
-     - -  -     -- - - -      -                   --   -   ---  -       -    --       - --  - - - -
-      -    --        - --      - - - -- - --   - -  - -- - - -   -          -  - - ---     -  - - -
--   --   -    -   -   -- --    -              -    -      -   - --     -   -     --   -  -  -   - -
- -  --    -   - - --  - - - -       - -   - - - -- -   - - -- --    --      -   -  -- --       -  -
--- - - -           -- -    -  -- -   -   -    - --  - -    - -    - - -- -   -- -          -     --
-   --  --    -- - --- - - -   - --     - -   -  -     -- -  - -    - -- -- ---- -    -  -  -      -
--   -     -      -  -       -        --   -   -- -        -      -        - -    - -   -   - -   --
-         -    - --  --  - -       - - -     -    -  --  -      - --     -  -   -  -   - - - -    --
---   -     - - --   - --      -    - -      - -   -    -            - -  -       --     -  - - - --
-     -    -   - - -   -   - --- -      ---  - -  - ----   --  - ---     -  -    -      -  --    - -
-         --   - ---    -       --  - - --- - -        - ---    - - - - -  - --     - -     ---    -
- --       - -   --   -     - --  - -              -  -      - -- --    -      -    --  --  -   -  -
-    -  --           --   -- -  -  - -  - - -       --  -     -   -- --  - -      -   -  - --      -
- -     - -  - -     --  - - -    -    -  -    -   -    - -     -     --   - -    -   -  -    -    -
- -    --  -  -    - -    - -    -       -- -              - -    -   -       -             - -    -
----------------------------------------------------------------------------------------------------
