100
100
----------------------------------------------------------------------------------------------------
-      --    - -   - - -      -   ---- -- - - - - -              -   -       -- - - -  -  -   --   -
-      -                -      - -    -   -  - --   -- ----- -      -  -  -  -- -- --    -  -    - -
-  -- -- -  --  --  -   -    -    -      --     - -     -   - -- -        --   --- -     --  - - - -
-    -          -   -   --  -   -     --       -   -       -    -        - --    - -     ----      -
-      --- -  --    -   - -       - -- -     -      - -    --- ---    -    -   --    - -- -   -  - -
- -     - - -    --       -     ---  -  -  -    ---   - --   -    --              -        - --  - -
-    - - -  -        -  -      -    ---  -   -- -    -- - -    --   --         -  - -    - -   -  --
-     - -      - - -   --    --- -       - -      - -   ---      - --      -- - - -   -  -   ---  --
---- -     --      -          - -  -  - -   -    - -        -  --    -- -  -    - -  - -   - -     -
-     -  -  -  - - -- -  --    -  --   -       -        --    -      - - -- - -       -   -    - ---
--- --  -  -   - --  --    -    - ---  - --      -   --   -  -   -   -- -         -      -   -   ---
-        -      --              --     -         - -      - -   -    ---   -  -  - -- ---    - -   -
-  -  -  -   -- - --- --   - -    --      -  --     -  ---- -    - - -          -  -  -  - -   -   -
---  -- -    - - -         -             -  -    --     - ---    -      - -  - -   -   ---       - -
- - -  --  - ---   -  --  - -    ---    ---- --  -- -    -   -    -  -   -  -- - -   - - -      -  -
--   -   - -     - -      - ---- ---     -        -   --    -     -  -  -  -    --      -       -  -
-  -    --     -    -            ---        - -    -  - -   ----   --   --        -   --      --   -
- --    -   - - -   -    --   -   -  -  -      - -  -   -  -           - ---- -    - - - -    -    -
-- -   - -- - - -- -  -  - - --    - --    - -- -       - -   -  -  ---- -    - -         - - -  - -
-       -   --   --- -          - -       -     --      --  --     -            -  - --  -  --     -
--   -- ---    ---     - --   -     -  - --    -     - -   --   -     -        -- -   -      - -- --
-          - - -   --  -       -     -    - -   -       -         -      -   -  -     - -  -- -  - -
-      -   - -   - -   - --   -          --    --  -   -   - -   -    -- -    -      -   -     -   -
- -         -    --      -- --     -    -  - -   --  -   -    --   --  --  --- -       -  -   -   --
-- ---      - - -  --   -        -- - -      - - -       -  - -  --    -  - ---    - - - - --    ---
- -   --  -   -      --  -   --  -   - - --   --               -   --   - --    -   -  - - -  -   --
-      -    -    - - -  - --  - -        -  -      -      --  --    ----  - - - - -   - -- -       -
-   ---- -   -     - -    -  - -     - --      - -    - -        -   -           - - --- --- - -----
-   ---   -- -   -     -  --  -     -- -  - -     -- - -      --  -  - -  -    -             --  - -
-  - -   - -- -  ------ -   - -     - - ---   -  -     -     --  --      -   - - -  -  -       - - -
---  - -- -- --     --  -     --   --        - -  -  - -    - --   -  --  - -       - -    -    - --
-  -      --  - -  -  --  -  -   -- -  -    -   - --    ----  -   -        - -  ---    -    -  -  --
- --   ---      - - -- --     -         --- --- -   -- - -  --   - -  - -  -   -    --  -     -  - -
--   -- -  - - -     --        ---   --  -     -  -    -  -             -   - - - -   -     -  --  -
-  -  - - -    --  -      -        -         - -     -              -  - - - -- -    --   -    -   -
-      -     ---             ----       -  - -    -  -  --   -- -     - -- --     -  -            --
- - - -      --  ---  -    --    - -  - ---           - -  --  -          - --    -   - - ---  -   -
-- - -    -  -    -    -  - -     -    -  - --   --      - -  -- - - --  ----  -  -  -    -        -
-      -  -  - -- -    -- - - - --  -   -  -      -  -   -       ---  --        --   - --  -       -
- -  -     ----      -    -  -      -    - - -   -  ---  - - -   -   -  -     -     -      -     ---
-- --     - -   - - - -   -- -- -  - -     -             ---    -     -    -  -- ---- -- - -   -  --
--  -   - -- -  -           --          -    - -   - -  -  -  -  -    -      - -  - -           -  -
- -  -  -- -     -  --   -        -  -  -   -   -       - -  -    -         -       --  --  -   -- -
-    -       --- - -  - -   -  - -  - - -  -  -     -  -  -  -   - ---   -- -  --- - -  - --  - -- -
- -      -      -   -     -    - -   --    -   -----  -  - --  - - - - - -   -  -  --- - -   ---  --
-    -   -   - -       - -     --      --- -   --      -     - -  -- ---      --  --  -- - -     - -
-  -   -  -    -    --         - -- ---  - ---      -  -- -     - -    -   ---  -     -- -      ----
--- -   -  - --    --  -- ---  --    --       - ---    --  - - - - --  -    - -               -    -
--  -    - -- -- -  --  --     -          -- - - -  -       -  - -       -  -        -  - - -      -
-          -       -  - - -  -   ---  ---   -  --     ---  - -  -  -  -- -   -   -       - - --   --
-  - -      - -- -- -  --    --          - - -  -  --- -     --       -   -- - -  - -    - -       -
--     - -   - -      - -   -    -   ----  -   -  - -  -    -  -- - -- -   - -     -  - -- -   -   -
- - -- -     - -- -       -  - -  --  --  -     -  - - -  -- --  -         - - -   - -     - -  -  -
- - -     - -       -- -- -  -  - -         --   --- --   -   -        - - -- -   ---       - -    -
- -    -   -- -    -        -- - -  -    -   - -    - --  -     -   -          --  - -   ----- -   -
--     -     -          -        -  --    - - -   - -   - -       - -    -  - -   -   - -     ---- -
- ---     -      -    -   -    --    -  --  -  -      -    --  --    -   --   -       - - ---      -
- -  - --- -   - --   --           -   -     -   -               - --              -         - -----
--       - -        -  - --- --    -    -     -    - - - -        -   - -   -  - -- -- -  -        -
- --    -      - - --  --  - -   -          ---  --    -  --      - -  -      -     - --- -        -
-- -  -      --          - -    - -     --   -    -        -  - -    -        - - -   - -          -
- --- - --      - --- - -   -   --  - -      -         - -  - -   -       -     -    - - -    -    -
-      - -   --    -     -- - -         -      --  -      --   - - -----      - --  -- - -- - -- - -
--          -   -   -     -   -     - - - -  - -  -   --     -       -    --  -       - -     - ----
- -   -      -           -     -  -  -    - -    --    - -  ----  -   - -         -    -  -        -
- --- -   -  -   ---  --  -  -   -     -- -  -      -     --      -  -  --  -   -- -  - - - -     --
-   -- --         - --     --   - -   -         -        --  --       -        -- -  -     - --    -
- -   -   -  ---- -    - - -       -- ---  -      ---     - --    -   -    --   -    - -  -     - --
-   --  -- - - -    - - -   -  --        - -- --      -  -    --  -  -- -  -   -    -- --       -  -
-      -  - -        -    --      -  -   -   -   -- - -  -   - -   -     -   -     -  -  --   -  ---
- -   -  -- --    -- ---     -     -  --    -  -  - - --   -   --    -  --     - --  - -       -   -
- -   -      -    -        --      - -   -        -     -    -   - -  -    --    -   ---- -        -
-  -      -   -- -           -   --   --   -    - - -   --   -  --- -- -- -       -        --      -
---  -----  --  -   - - -    -   -  -  --  - -    ---  - -  -  - -  --   - -- -- --- -       - - - -
--  -   -  --    -    - ----   -      -      --  --  -    - - -  -        - -  - -  -   - - -      -
-  - - --     --     - -- -      -- - -        - -     -   -  -  --         -   - --  -  -   - -- --
- -- -    - -   ---     - -      - -  -      --       - --   --    -  -  --      - - - -          --
-   -         --                -     --       -   -         - -   -- --     ---  -     --  --  -- -
- --     --     --  - -  -     - --  -  ----  -- -   --    ---   --    -  -      --  -   -    -    -
-     -  - - --- -  -    -     - -     -  - -- -  - -    -    -- - --  -     -    ---- -  --    ----
- -   -     - --  -       -  -- --- --   -       -  -      -      - - - --    - - -    -       -- --
-- -  -      -- --        --- -   -    -       -        -- --  - -- - -  - -     - -  -     -- - - -
-    --    - - -  ---  --- -- -           -  --        -  -  -  ---- -      - -   - -  -  -     -- -
- -  -  -      - -  -  --       -  -    --     -  -     ---    -  -  -   - -  -         -  -  -  ---
--    -  - - -----  -  -      -   -  --- -   - --   - --   --      - -      -   -  - -  - - - -    -
-  -       - -           - --- -       - -       -  --   - - -         -- --   - --  - -   -  -   --
- -  -- --    -   --  -- -      -   -    --- ---  - --   -   -- -  - -  -  ---  --          -- -   -
- -   - -    - -  -     -  -           -    -   - --  - -        -   - - - -   -      - -  -    -  -
-        -   -  -    - - -    ---            - -  -           -  - -   - -     - --  -       -     -
-       -  --     -   - -     -   - -   - -        -- - -  -                - - -  ---    --  -- ---
- -   -    - --   -     -           --    - --   -  -      -  --   -   -      -      -    -    -   -
-    - -- -  - ---  -     - -    - --- - -    ---- -  - -- -    - -- -- -  -- -      - -- -- -   ---
-- -  -   -      -    -       -     -    --- - -  - -  - -     -            - -- --  --- -   --- - -
- -    --         --- - -      -        - -- -         -    -     -  - - - - -  -   --- --     --- -
-- --- --     - -  -       --   - -   - --      -          -- --   ---  --       - --  --      -   -
-     -  -    -          --  -  -   - - -     -       -  -- --   -   -  - --   - -   -  -  -    -  -
- ---        -   -  -    - - - -   - - -   --    ---      -   -   --- -   -- -            - -  -   -
-    - - --  - -  -           - --         -  --         -  - - --   -  -    - - --   -- -         -
----------------------------------------------------------------------------------------------------
