100
100
----------------------------------------------------------------------------------------------------
-      -      - --   ---    --        -    -     -    -   ---               -   -       -- -     - -
---   -         -  -     --         -   -         - -    -  - - - --  --   -  -   - -- -    - --   -
-    - -    - -      --   --      -    - - -    --   -        -       -   - - -  -  - -- -- -      -
-      - ---            - - -   -  --  -    --       -   -   -   - - -    - --   --     -    --    -
-    --- - -      -     --  ---    -         -     - - -   ---   -   --   --     ---   - - -- --   -
-   --   -  - -  -   - -   -    --   -   -  - ---     -    --    - -     -  -            -  -  - - -
--   -  -  -   - -    ---         -      -   -- -   -      -  --   -- -       -     - -     -  - - -
-      -   - -- - -  --  ---     --  -  -   -      -  - -   -       -   --  -     - - -    --     --
--- - - -  -    -    -  -- -             --     -  --     -  ---     - -      -       - --   -  -  -
- --  --    -   - -  - -   -   -   -  - --------     -  -  --  --  - - - - - -      -   -     - - --
- - - -- - -   - -  -       -- -   -  ---- -   --  - -- - -   -    -  -  --   - --- - -  -         -
-- --  -     -- -    ------    - -              - --   - -   - -  - --- -   --        -   - -      -
- -   -      --   --       ---  -   -    --       - - -     -  - -        --   --     -   -   - -- -
-  -- --   -   --  -   ----  ---- --            - - -      -  -  - - -   -  - --   --  -   -       -
-     -  -  --    -- --          -  - -   - - -- - - -  -     - - -       -      - -    - - -      -
-   - - -    - -  - -- --- -      --       -  - --   -     - - -   -  -    - ---  - - -- --     - --
-  -       -  --     - - --      -   - -- -  -     --            -----   ---   - -   -  - -     -  -
- - - -  - --   --  -        --  --  -      -    - -         -        ---    ---    -    - - -   - -
- - - -  - -- -  ---       -- -- -   -  - -    --   -- - -   -    -     -  -    -      -       -   -
- - -   - -           --    -  -   --    -   ----  - -     -   - -       - --    -   -   ----  -  --
- --    - -- -   ----  -- -    - -- --     -   --  -   -  - ---- - - -  -  - - -- -    -  -   - ----
--  -    -    -      - --      -      --   --     - -  -   -            -   -      -- -- -  -- - - -
-  - --         -- --- --      -   -  -  -   - -   --   - -  -  -     - --   -  -    -   -   -- -  -
--     - -    - --  -     - --- --  -       - - --    - -     -   -- -  - -           -  - -   -   -
--     -  -   -- --  - -   -- --   --  -  -        -- -    -     -  -    ---   -- -   - -   - - -- -
-  - -    - -  --  - - -- -     - - -  -      - -       -  -   ---      -- - -   ----     -     - --
-   -   --  -         - -   -  -    -  -   - -      - -      --  -     -  -    -   -    --- -  -   -
-    --   - -        -  - - --  -   -   -     - - --    - - -- -  - - -- -     - - ----      -     -
-- - -   -     ----  ---  --     - -   -              - - -   - - -  -   -   -   -   -  -   -- -  --
-  - -----  --  - --      -     - ---   -     -- --    --     - - -          -   -    --       -   -
-     -   --- -      ---  --           -         -        -    -  -    --       -            -   - -
--      -  -       -  ---       -  -   -     - --  -  --           -  -   - - -    - - - -     -   -
- -    - - -     --                  -     -      -          -  ----    --     - -      -    --   --
- -     -  ---   - --  --     - -  -   - - -  - -      --  --  -    -      -   --  -- --   -  -   --
- -      -       -- -   - -    - -   - --      - -        - -         --     - -      -    --     --
--- -  - -     --       --           -    -- -  -         -    -  --  -   -     --   --  -         -
- -- - -    --  -  ---    -  --  -      -  - -- -- - --       --   -    - -   -  -   - - - --     --
-   -  -  - --  --  - - -   -  - -  --   --     -   -   - -  --  -   -      -- -  --   - --   -- - -
- - - -   -    -   -   - - -   -         -  --  --- ---    -   - -      -    - -  -     -    --    -
-    -      -     - -   - - -         -     - -    - -- ---  --       -       - -   - -         -  -
--      -- - - - -    -      - ---    - ---   -   -  -             -          --   --      - - -   -
-   - -  -   ---  - -   --             -      -     - --    -   - -  -         -    -  ---         -
-- -- -         -   -  -   -    --   -   -  - - --  - -         - -   - - -  -       -        -- - -
-- - ---  -----   --    ---  -   - -       --   - -   -- -  -  - -  -     - --     - -  - - -      -
-    --             ---         -    - -      -    -   -  ------  -- -     - -  -         -       --
-  - - -       - -     -      - ---      -  ---   -   -      - -   -- -    -    - - -  -    -   -  -
-   - -  -    - --  -  - - -       --      ---   -    - --       -  -        -- -  -   --   -    ---
-     -    --- -    -   - - - - -   -     -     -    -      --   ---   --- - -    - -            - -
-   - - - --      - -   -   --   -   -  -           --  -  -   - ---         - -  -       -  -     -
-       -     --    - -    --  --             -----  -   --  -  -  - -  - - -- -       -  -       --
-    - -   --   -   -  - - - - - -- --- -       -  - -  -- -- -  -       ---        -   --         -
-      -      -  --   --       -            - -   -       --         -        -   -  - -  -- ---- --
--     -     --  - -          -           --    -- ---       -        -     - -  - -  -            -
--  -  ---          --      -    - -         -   -   - -  ---     --  -    -----     - --   - - - --
- -  -    -- - --       - - -   -  -    -          -   -   -  -  -       - --   -    - -   -- -    -
-      -    -- - -- --        -- -- -   -  -      --    - -   -               -   -        -- ---  -
--    -   -  -    -   --      -    -      - - -- -         -    --  -  -   -  - -   --       -   - -
-   -   -  - -- - --    -   -    - -   - -    --     -   -- ---    -  - --     -   -- -   -  -- - --
- - - -   -   -- -      ----   -  -- - --    -  -      - -  - -  -  --  - -    --     --  -  ---   -
- -      -   -    ---  -               - -- - --   --  -     -    -    -- - -    - -         - -  --
- - -   -   -  -  - -  --          -    -  - - -   - -- -- -- -    - -   -   -    - ----        -  -
-  -   --   --  -- --     --  - - -  - -   -   -    -    -           -  - - -      - - ---    -    -
- - -  - -    - -   - -  - -   - ---    -     -       --     -- --   ----        --- - -  -- --  - -
-  --   -   -- - ---   - -    -  -        -       -   -       --- -      - --        -  ---     ----
-   - --       - --      -   - -   -  --- --       ---  -   -   -     -     -    -     -   -    -  -
-     - -  ---   -        -  --- -  -     - -   - --   -       --    -  -  --  --  -- -- --  -   - -
---  -    -  - - --- - ---    -    -  -   -   -     -      - -    -   --      -    - -  -    -     -
-   -- - ---    -     --      --  -  --  - -  -    -        -- -   --    --    - -       -   -    --
---   ---   -  -  -  -   - -    --          - - -      - - --     -      - --  -- -  -   - -   --- -
-  -    - -- -   - -- --      -  --       - -    --   - -   - -  - -  -              - ---    --   -
-      - -  - - - - - -              - ----    -   --    - -   -  -   -- - -  -      -     -  - -- -
-     -   -  -   -- -       - --  -      -    - -    - ---   -       --      -     -      -- -     -
-  -    -  - -         --      --   --  -  - -   - -  -        -    -    --      -- -          -- --
-   -   --        -----   --   -        - -   --     -   --      -   - -  --  - - -   -  -    -  - -
-   --    - ---        -   -      --   - -  - -    - --  -   - --      -  - -   -  -  -    - - --  -
-  -- - ----    -  - ---  --         - --- -    --   -  -  - -- - - -- -     -   --  -   -         -
-   - - -  -- -             -   --  - -   -        -- -  -     -  - -    - -   -- -    -  ---  --  -
--       -      --   -      - - - - -   -  -           -    -    - -  --  -      --- -           - -
--     - -        -   -  -    - - -- --   -  - -- --     -  - -  -  --  -    - --- --   --   -  -  -
-- - -  - -- - -  -      -       --     --           - --           -  - -  -     -- - -     -  - --
-   -      - -   -    - -  - ---  -      - -     -      -    --- --  -      - -- - - - -     -  -- -
-       - -      --- -- -     -  -  --    -    ---        -    - - ----  -   -       -   -  -     --
--  - -- -    --   --- -  -   -- -   --  --     - -      - - - -  -    - -   - -   -  - - -        -
-  -     --- -  - -        ---     --   -  -----    -- -  - -- - -    --   -  --       -    -   - --
--     --  -   -  - - - -    -   - -  -  -           -   --     -  --      - - -    -   - -  -     -
- - -  --  -- -  --- - -  - -   -  --  -  -     -- - - - -    --  -- -  - -  -  -     - - -     -- -
--  -   -              - - -  -    -   - -- --- - -    --- -   - - - -          -  -     - -   --- -
-  -     --  -   ---  - - -  -  -      - - -    -         - - -   -  -    -  --    - -             -
- -                ---  -            -  -   -      -    ---   -  - -  ---  --  - -     -    -  - ---
-      - -   - ----  - ----      - -    - ------ -       -   -      -  -   -        - -    --  - - -
---   --   -    -  --        -  - -  -        -- -- - -      - --  -    -- - -- - -- - -    -- --  -
- --- -  - -  -   -      -         -  -    -  -    -  - ------      -     -  --  -    - -- -    - --
-  - -  -- -    -   -    ----   - -  -   -    - -    -- -      ---      -- - -      - --  -     - --
-    - - -          - --  - -   - -  -  -- ---     --  -    - -  --      - -  --      -  --  --  - -
- -- --     -   -  -    -   - -- -   -       -      - - - - ----   --   - -     - -           - -  -
-  -   -  -  -   -   - - -  -    -   -   --    -       ---  -  -         ---  -  - --  --        - -
- - -  -  - -      --     --  -   -   - -   - --    - ---         -   -   -  --- -            - -  -
-          -   -         -   -                       - -     - -  -              - -    -  ---   - -
----------------------------------------------------------------------------------------------------
