100
100
----------------------------------------------------------------------------------------------------
-   -       - -   -  -  ---   --  -                       -   -  -   -  -      -      -     -    - -
- -  --  --  -  --  - -    -  -- -       - -   -   ---     -    -        -       - -  -  -   -   - -
-- -      -  - -     -  - -       -       - - -      -    -  -    --   --   --- -  -      -  -  -- -
-  - -- - --    -  ---    - -   -  --  -         -      -   -  -  -    - -       --  - --   -  -- --
--        -   -   - - --    -          -  - -     --- -  -     -   - -    -- -   -    -  --   -   --
-- - -    -   -- -    -    -  ---  -- --   - -  -      -    -  -  ---     -  --- - -   ---   - -   -
--    --   -      -   -  -     --- - -   -           -        - -      ---     - -      - -       --
-       ---   -     - -    -     -    - -  -- -       -    - ---   -- -  - -- -      - -   ---  -  -
-  -- - -   - --- -- -  -- --- -  --   - -  -    --  -   -   -  - -    -- -     -         - - --   -
-- -  -- - ---  --   -     --    -       - -  -   -- -    -        -       -  --- -  -     -   - - -
-- -           ---   -   -    -     -   - - ---    -  -  --   - -  -         -       -   -  --   - -
-    --      -  --    -     -   - - --- - -- - -- - -   -  -   -      --   - -   -     - -- -    ---
- -          - -  - - -  ---  - --    -  - -     -  - -     - -         --         -    -          -
- -- ---       ----   - ---    -    --  -- --        --    -    - -  - -- - --- --    -   --   -  --
- - -   -   -         --     - -            --  ---    -  -  -  - --- --   -     -  -  --   --   - -
--- -  - --- ---   --    --  -   -  ---   -   -      --      - -    - -   -  ---- -- -   -   - -   -
-     --  - -  - - - - -      -- - -    -   -        --  - -- -               - - -   -- - - -     -
- ---  --            - --   -    -  --   - -   -       - - -- ----          --   - -    -  --    - -
-     - - -           - -- -         -   -    -   --     -  - -  - -    -     - -- -   - -         -
--  -   ---  --- -- --    -        -  -   -          - ----   -  --    --                        - -
-  - -   -    --   - - - -  -      --   - - -        - --  -  --  -    -- -            -- ---  - - -
- -   --   -- --   -   -   -  -- --     - - -  - -  -    --  -              -         -  --   -  - -
-  -    - - -- --    - -  -- -  -    -    -  -         --  -  -          -      -  -        -  -   -
--       -       ----      -   - -     --    - -   -   -  --      -  - --   ----- - - -      --   --
-- - --   -     - -   -   - -     -      --  - --    -  --   -  - -   ----        -       ---      -
- - --- -    --    -- --    - --  -  -    - --         -  ---  -   -      -  -      - --     -    --
-- -  - - -  - - --    - -    -   -   --  -   --   -- -   -- - ---- --  -   -  -  --- -     -  -   -
-  - -     ---       -   -  - - -  -  - -        --  -    - -    -     -    -   --- -   -       -- -
-   -- - -  - -     - -  - - -   - -    -      -   -    --      -   - --   -  - -  - --   -   --  --
-       --- -    - -- -     -  -  -  -    -     - - --         -   ---- ---    - --     - - -    ---
- -  --     -  - -- -  ---       -   -  -  -   -     - --- --           - -  -       -    -    -   -
-- - -  --  -      --- -     -      - -  - -   -    - -     --- -  --   -  - -    -  -    - ---    -
--              - - -    --   --   - -- -  -- - -- ---  -            -   -- - -  - --- ---  - --  --
-     - --   -    - - -   --   -        -    -     -   - - -     -  -  -      ---        --- --    -
-       - - -   -  --        -      -      -      -  --   -   -   -     --   - - - -- --     -    --
- -- -  -   -  -   -    - -  -  ---   -  - --    --   - -     -  -  --    -  -      -    -     -   -
-  --   -    -- - -          -        --  -  --   - -   --   - -     - - -    - - -  -- ----    -- -
-    - -  ---- -- - -    -   -    - -      --- --  -  --  -  -    -       ---    - - - -       -- --
-              -  -       - -   -     --      -- --  -    -   -     - --- -     -      -- -     -- -
-          - -   --     -        ---      - --  -    --    --    --  - -    - -     --             -
- -  - --   - --  - ---- -   -  -  - - -   -  -  -  -  - - -   - - -        - -   -   ---   - -   --
-       --  -- -  --  - -     --  -     --   --   -     -   --  -  --      --    -- -----    -  -- -
-      - -      - --- -  -- - -  -- ---    ---  -  - -- -      -- --  -  - - -  - -       -  - -  --
--- -- - -   -  -  -  -   -- - -    -  --      -   -  --   - -   - -    --      -   -       -      -
-- - -      -  -        -    -   -- -- - - -- -  -  --  -   - - -    -  -  -    - - -  - --  - - ---
-  - -- - -     -  -   - - -   --      -  --  --   -   -- -   -    -     -     - - - --    -       -
-   ---       - -    -   -- -    -   - -  -    -   - -   - -   -       ----      -  -    -   -- - --
-         -- -  - -   - -    --      -   - -  -   -   - - ---       -    ----   -     -            -
-  -             -- -      -   -           -  - --   -  -  -    -   --  -   -   - -    -     - -   -
- -    - - --- -     - -- -         -  -  -   -      - -  -    -      -    -  -  - - - -  -       --
- --   -        -         --     -         -   - - -  -  --      - - -   -    -  -   -   - -- - -- -
-    ------- - -- -    -    --    -     --     -      -   - -- --        -     --         --   -  --
-  -            -       - --    -   - ---    ---   --  -      ---     - -   -  -      -        --- -
---- - -  --        - -    -       - -     -  -  - - -       -  -  --  -      -  ---    ---   -  - -
-  - -         -     -  --- -  -   - --    - --    -- -- - -  -   - - -  --   --       - -- -  -----
---   --   --  - -   - ----   -- -      -- -   -   -   -          - -  - -      -  -   -           -
--   - -  --     -  -  ----    -    - -     -        -  -      --  -  -  -   -   --         -  -  --
--     - -  - --- -- -  -        -      --  -- - -        - - -   ---  -    -  --  --- -  -        -
- -    - --    -   - -    -     -   --- - - -     -   --         -   -----      --    - - -- -   ---
-      -        -  -   -      - - - -          -- -   -  --      - -   -    -- -        -   - --   -
-         -     -  --  -- -      -   - - -  -  -   - -  -   - --    - -   --     -   -         --- -
-   -  -    - - - --      -  -      - -  -      - -         ---  - -      -     - - -  - -     -   -
-  -   -         -  -   -- -     -      ---       -     - -   ---      --  -    --   -   - - -   ---
--- --        --      --           - - --- -   -    - -   --        - -    -       ---   ----  - - -
-      - --- -      -    --   -               -   -          - -  -   - --   - --       -        - -
-  -  ----            -       --  --   ---- -    -- -       --     -   -    -   - -  -   -    - -  -
-  ---    --- -    - -   -  - - -     -     - -        - --            -  -      -      -   -- --- -
-  - --  -  - --     --- -    - -      ----    --  -- -  -  -- -- -         - - -          ---  - --
- -  - - -  -  - -   -          --  - -          -   -  -     -  -  -     ---    -  -         -    -
-      - -- --   -        --    -  --        -  - -         - --     --          -  -- --    -- -- -
-    --   --     --       -          --- -  ----      -   --     -       -            -      - --- -
-   - - - - -  -   -  -   -       -  -    -- -          --    -   -  --      -   - --  - - -    -- -
-  -- -  - -    -    - - -- --  -     -    --         -- -  -  -      - -       - -  -   --   - -  -
-          - -   - -    -           -  -    - --  --  - -   - - - - ---   - -   - --        -  --  -
--    -  --  - -    - -  -    -   -- - -    ----     - -  --   ----     -  - --   --  -  -         -
- -   - -  ---       --- - ----- -      ---     -  -   -  --       - ---    -   -  - ---  - -     --
-               -      -   --     - - -      --   -   - -- -            ---      -  -    -   - - - -
-      --   -   -  -     -        -   -- --    -       - --     - -  - -  -   ---  -         -     -
-      - -     -  -  --   - -   - -    -       -             - - -   -   -  - ---    -     -   -  --
- -- --   ---- -  -   - --  -   -   -- --       --  - -    -       -    -- -        -      -    -  -
- - -   ----   -   -  - -    --  -  -         --   --  -   -     -   -  --      - -         - -    -
-- -  -  -    -              - --  -  --    -- ---      -  ---- - --- - ---- --         - - -   -- -
-    ---     --   -   -   -- - -   -  -  -         - --       --   - - -  - -    -  -   -  - -     -
-   - -  -  -          -     -        -   -  - --   - - - ---  -   - -    --    -  ----   - -  -   -
-    - -- -  - - -  -    -        --- -  --         - - - --      -  -  - -   -       - - --     - -
-     --  -    - - - -  - - -- - -  -    --  -   -          - -   -  -         - ---- -      -     -
--   -       -   - -       -     - - --   - - --    -      --- -    ---         -       -   - ---- -
- -  - - --- -  --     -- - - ---          - -   - -   -  -   -    -        --            - -- - - -
-  -          -   -   -     -  -        - --  - - -  -- --    -- -- - - --     -     --  --   - -  -
-    -  -- -  - - -    -  -   --   -    --    -   - -          - -     -   - ----  -       ---- -  -
-  ----     -- -     -              -        -        -   --- -  ----  -     -          -  --  - ---
---   -   -- -     - - - -  -     -   -  -   -  - -  -    -          - -      -  -- -   - -  --    -
----    - -     --      - - - - - -  --          -  -    --  - -- --    -- -  -        - -      -  -
- -   - -        - -        --  -    - -      -- -- -  -    - -   -- -   -- --   - --  --  - - --- -
-      -   -   --   -  --      - -    - ----   --  --   ---            --- --- --  -   -        -- -
---     --    -      - - -    --   --       - -   -    -     -  - -   -     -    - -  -  -       - -
-  - ---  - -   --          -  - -  -   ---   -  -       ---    -     -     -  -           -- ---  -
- -       -   -        - - -  -      -       -   - -  - -         ---      -  -  --    - -    -    -
----------------------------------------------------------------------------------------------------
