100
100
----------------------------------------------------------------------------------------------------
- --     -        - - -  - ---- -       - -   -     -    - -     -   -       -       -   --        -
- -   -    --    - - -   - -   -           ---- -     - -    - --         -   - - -   -      ----  -
-    -     - -  -     ----  -  -- -  -   ---      -    -- -      -       - --     -  -  -   - -    -
-  -  - -    -- - -        -  -              ---  -- -    - --- -    -   ---    -    -- -   -  --  -
-   -  ---    - --- -  ---  -        - --  -   -         -   -  --  - - - -       -      --     -  -
-- -   -  - --     -  -      -- -        -  -  - - -  -    --         - -      -      -   - -      -
-- - -      -  - --   --        -   -  -  -  -  - -  --- - -  -    - - -  -      -   -     --- -   -
-    - -     --  - -  - -    -   - -   -   -  - - --   -    -      -     - - -    - - -    ---   - -
---    --- --      -    - -    -     ---     - -    -  -     - -         - -        -  - -    -  - -
-  - --- - -       ---  --   --  --        -  ---  -- -    -    -- -- -- -  -  --     -   -  -     -
-          -  -                 -  -  --- -  -   -       -   --   --  - ---  -           - -- -    -
-    ---     - - -     -    -- -      -  -       -  ---   -- -   -   - - - -      - - --     -     -
-  -  - ---  -  -    -  -        -       -       -      -  -  --        - --  - -   - -    ---  -  -
- -   --   -    -      - -    --      -- - --   -  -  -  -     -   - - - -  --  - -   -       -  ---
-  --    - -   -  --   -   -    -    - - --  - -     -       --  -        -    -- -    --   -     --
-   -  --      -  -           -  ---   -        -            -  ---       -   - -- --     -- - --  -
-         -   - --- -   ---    --    -   - - -  - -  - --- -    -      --- -            - - -    - -
--     -   --  --   - - -- -  -  -  -  -      - -   -    -   -  -   ---   - -  -  -  -   --  -    --
--    -           -    - - -     -                  -     --    -        - --------  -- -  - -    --
- --  -   --  -     -         ---   -   -   -  - --   --   -- -  ---   - -          -   - - --  -  -
- -  -     --   -- --- -- -     - --      -  -     - -- - -     - -   - - -   -  -   - -   -  -  - -
- -  -   -       -        --  --   --   -         - - -- - ---           --  - -     -     -      --
--  --   -  - - -     ---   - -                -  -  -    --- -        -   -  -   - - --           -
- --   -- - -   -  ---   -    -  - -    - -  - - -  --   --     - -  -   ---  -     - --- - -   - --
-- -   ---        -     --  -          -    -- -      -- - ----    -                 -  - - - -  - -
- -- -   - --   -     -     -     ----    -     -  - -       ----   - -- - -               -   --  -
- -     -    -     -  -  ---         - --      -   -   -     -    - ---     - -   --    -        - -
-  --   -     - -      -     -  -    -  -  -  - -- - - - ---    --     -       -     -       - - - -
--   ---       -  ---- -- -              -            -            -  -  - -  -   -  -   - -      --
-- - --  -   -    -  - -     - - - - -     -  - --  -    -   -      -    -  -    -  -    -  -   -  -
-   - -- - -  -  -    - -  - -   -   -   ---- - -  -   ---      -    -     - --    - -  - - -   -- -
-  - -   -   -      - -    -   -   -  --           -  -  -  -- -     -  -       --  -  --   - -- - -
-    -   --     -             --   - -    --     - -     - - -  -    -   - ---    ------   -       -
-    -   --  - -   - --  - --  -     --     -   -  --  --   ---- --  - - -  - - --           - -   -
- -      -     --      - -  ---   - -   -          - --- --   -- -  -      - --  --   --   - ----  -
-                - - -   - -           --     -     --           -    -  -     -    -  --          -
-    -     -  --  -  -     - -- -       -- -- - -  -    -  - ----    - -   -   - --- --       -   --
-   ---     -   --   -   --   - -  - --    - -   - - -   ---    -  --   -   -       -     - -  -   -
-       -  - ---  -    --  --     -   - - -            - - -   - - -- -       - --   -    -     -  -
- --- -        --  - -  --      -         -  -  --    -  -    -- - - -     ---    --- -      -   ---
-  --         -      - -    - -        - -  -   -- -- -    -     -   -  -    - -       -     -     -
--  -  -         -   --   --   --  - ----- -   -  - --- -      ------- --   --   -- -    -    -   --
- --   -- -  - -    -  - -   -- --- -    --                   -  -   - - ---    -   -    -     - - -
-  -  --  -   -           --    -   -   - -   -   -- --     -   - -- -    - - --   -  - - ---      -
--- -    ---  -      --          --        --  -  - - -    -- - - -  --   -   -   ----    -   -  - -
-     -   -         -    ---        - -- -    -   - - -- -- --   - -    -       -            - - - -
--  - - - -   --   -- - -    --        - -    --  -- -  -     - - -   - -- -   -  - -  --      - - -
-  --  - -- -    -     -  --   - --  -         - -  --  -      -   -        --   -   --      -   - -
-            ----- - -- -- --     -   -   -     -  -   -       -- - -  -  -- -   -     -  -  - --  -
--- - - -- -  -  -  -             - -     --  - -   - -  -  --   -       -      -    - -  - -      -
-         --   -  -      -   -   - -  -     -    -   -       ---  -    --        -  --    -  ----  -
-  -  -     --      -   -- -    --   -  - -- - -   -    -                     - - - -   ---        -
---- -    -  -  -   -    -   --    --    ---  --  ---  -        -    -   --  -      -         -- ---
-   -      -    -       ---   -- --    -          -    --    -       - -       -       -       - - -
- -- -- -      - -     -  -   -   ---   - --     -     - -     - --   - -   --  -      --    - - - -
- ---     --   -    -       --  -   -   --    -  ---  -        -      ---  -         -- -  -- -    -
--   -  -     - -  - ---      - - -    -              -  -  --   -  - --  - -    - - - ---         -
-     - ----  -   - -  - -  - -   -  -  -----      -   ---  -        -  - - - --  - - --  --- -  - -
- - -      -   -- -  -  --   --   --  - - -       --  --  -         -- - -  --  -    -       -    --
- -    -     -  --       -  --      --- -  - -  - -     ----   -    -- - --                --   ----
--   - -    - --    -  ------ -    - -   - - - -   --  --  -  -  ---   -   --   ---  ---   - -     -
-  -     -   -    --   -     -   -   -  --  -   -  --  --  --  - ----- -    -  --   - -   -- -     -
--- - - --  -    - -  - -       - -- -            -   -      -       -     -        -          -   -
-- -    -   -   - -   - --  -   --  ----  - --- --- -  -- --- -----      - ---  -        --- - - - -
-- --  -- - -      -- -  -   -        -       -  ---   --- -       -  - -  ---     ---  - -   --   -
- -   -  - -  -       -   --- --  -- - ---   -          - - -   - - -        -     - -     - -     -
-   -   -  - --    -- -- - - - - - ---   - - ---  - -     -    --   - - - - -   -- -  -  -- -- --  -
- -   --       --           --   -      -  -          -    -     -- -   -  -   - --  -  -  - - -   -
-      -  -       -    -  -  -     -  ---        -      ----  -       -      -     -   -     - -  --
- - -  - - - -         -          -   -  ---           -    -     -   - -     - -  -    -   -  -   -
- --      -   -- - -     -  -  - -    - -- - ----   -  -   -- -        -     --    -     -- - --- --
-    - - - -    --  --   - -----    -  - - -  -- --     --          -    ---  -            - -- - --
-   -  --   -   -  -    -  -  -  -  - -    --- -  - -    -- --  -     -         - -      - -- -    -
- - -    -    - -  -- --       -     -    - - -     - -       - -      - --- -    -   -      -  ----
-     - -   --    --      --  -  -         - - -  --   --- -  -     -  -  -  -  --   -     - -     -
-    --- - -   --    -  - -  -      - --  -    --   -     -  -      -      -  -      -     - -- -  -
-- --     - -    - - - - -  -  -    -         -         - --         - -   -   -    -- - --   -  - -
----   --       -     ----       -  -  - -  - ---     -- -   -   - - --  --  - --   -  - --   -   --
--  ---   - - -  -  -     - --    -              -  -  ---   - -  -  - - - -  --  -   -- --  -  -- -
-     - -    --      -- - --  -  -   - --  -   - -       --  -   - ---   -- -     ---    - -  --   -
--     - --       - -       -- -  -  -     -  -         --     --- -   -  --  - -   - -      -- -  -
--  - -      --- --  ---- -          - - -    --  -  -   -    -   -- -- -   -  -- - -   -----   -  -
-  -        -       --     -   -  -             --   --   -    - -    -   - -  -       -    -- -- --
---  --      -- -     -     -  -  -           -  -      -- -     -  -  - -   -  ---- -    -  -  -- -
-  --          -   -              - - - -  -  -   - -  - ---            - -   -        -- -   --   -
---  -   - -  -   --     -- - -  - --  --- --   - -     -  --   --   -   -    - -    - -   --    - -
- -   -  - - - -      -      -  --         -  -- -  - --        -   -- - -  --   -   -  -- - ---   -
-         -  -    -      -    -  -      --   -  - -     -    -    -   --           --  -   -  - -  -
- -          -  - - -        - -  -- -    -    -      -        -  - --  --    --   -    -  -    - --
-     -  - - -   -  -  --  -  - --   -     -     --   -     -   - -    -  --   -  --       -    -- -
-      - - -   -              -  - -   - ---  -         -     -  -  -- - -   -- -- - -  --   - --  -
-       - -   -        -     -       -      --      - -  - --  -    --  -       -     -  - - -  -- -
-  -- - - - -    - -    ---   -    -  - - -- -  -  ----       ----    --    ----    - - - - -  -  --
-   - --      -      -        -  --  -    --  - -     - - -   -    --    -  --  -     -      -- -  -
-  -     --      --- --  -      -- - - - -          -- -   --   -    --  - --       --   - -     ---
- - - - - -   -     -   --      - --  -  -   -- -  -- -       --  - -- --    -     --     - ---    -
-       -        -  -      -     --   --  -    - -   --       --  --  --    --  ---   - -  -   -   -
- -         -    - -   - --         -  -    --  -        --             -  -       -         -- -  -
----------------------------------------------------------------------------------------------------
