100
100
----------------------------------------------------------------------------------------------------
- -     --   -         -       - - -- - - - -  -- -   - -     -   - -    -- -   -     -            -
-  -      --         --     -  -     -    -   -     - -   -- -     -    -     -    -    --  - ---- -
--   -  ---      -        - - -     - - -    -- -  - -   - -      ---- - - --   -  -  -  - - -     -
-     -      ---   -   - - - - -   --     -   -     -- -----  - --     - --  -    -  -  -   -  -  --
-  - -  -  -- --   -- -         -    --          -                - -- -         -    - -  -      --
-  - - -  - --   - - -     -  -     -  -  -- -  - -   - -  - - - - ---      -  - ----  -  -   ---  -
-    -  -   - -        -  - --        -      -    -    - -     -     - -- -  -     -    -        - -
-  -   -    ----     -     -   -   -    -    - - -  - -    --    - --       -     -  ---- -      - -
-- - -  --        -    ---  --    --  -           -  -  --          -         -         --  -      -
- - - -  -     -   --  - --    ---  -   - --   -  -      -    -- --    - -   -       -   - -  - -- -
-     -     --  -- --     -    -  --    - - - ---    -   - -       - - -   ---           ---  --  --
- - -            -   -  --      - -  --   -  - ----      -   -- ---    -- -   - -  ------- - -  -- -
-  -       --- - ---- - -    ---          -  --      - -   --      - - -   - -  -           - -   --
-   -  - -    -  -  -      -     -  ---       -  - -  -  --   --   - -       -  - --  - -  --- -   -
---   - -    -   --    - -    - - --     -      -           - - - - -  -       -  --     -  - -- - -
-  -- -       ---   --   - -  - --     -     - -  --  - -       - -  --     -     -     -  - - --  -
--      - --     -   --    -  - -   -     -- --           -     -   -  - -- --  -  - - - -  -      -
-  -  -    -     -  -  -    -  - -- -   - - -     -- -     -----    - -   -  --    ---    -  - - - -
- -   - -- -- - -    - - -       -    -- --  - -- --      -     -   -     -     -  -  ---  - ----- -
-   -- --        -       -     -  --            -    - -          -                         -      -
--  -   -  ---     - ----- -- -- -   - --     -   - -- ---- - -    -- - -     -           -  -    --
--       -    --- - -       - -          -              -    -   --  -   -   --- -  -       --     -
- -- - -   - -         -      -       --   -- - -- ----         -- -    -      -  -  -  -      -- --
-  - -   - -    ----- - ----   --  - -- - -     --   -    --     ----       ---   - - -    --      -
- -  ---  -    -    - -   -  --    -  - - - - -   ---    - - -  -                     - -    --    -
- -          - -  -  -    -  - - -     -     -  -       -      - --   -            -- - - -        -
-- -  --      -            - -  - --    -    -   - -  -  -            - -  -  - -               - --
-- -  -     -- -  - - -   --     - - -  -   -  --  -       -       -     --   -  -  --     - -     -
-   -      --   -   -    -    -- - -   - -         --   -   -    -  - - -   -             -      - -
- - ----    - - --         --   -   -  -  -- -- -    -   - -  - -     -  - -   -  - ----           -
-      -- -   --- - -          -    -    -   -     - - -   - --      -  --- -  -         - - - -   -
-  ---  - -       -      -      -   --   --  - --   -    -- -        -       - -    --             -
- - -- -       --          -  --   -      --   - -    - - -  -  ----   -- --    -  - --      -     -
- -    --   - - - -       ----  -  -      -     -  -    -  -  -- -   - - -  -- -    -    -  - -- ---
--      - --  -   -     ---   - - - -   -        --   - - - -- -- -        --    -   --   -        -
--    -    -   -     -  -   - -      - -    -  --  -           - --- -    -   -  -    ---- - -  -  -
--   -    -  -      - --  - --     - - -         --   - -    --    - --         --    -     ---    -
-  --- - - -  - -      - --     -- ----  -    - -- - - -     -  - - -   -          -   -        -  -
- - - -   -- -     -      -  --  -   ---        --  ---          -- -  -- -   -- --    --   - - -  -
- -  - -     --   -    --      --   -  -  --  -   - -- -  -- -       --   -   -   -- -  -       -  -
-  - -- --     - - -       - -    -  -  - -  -     - - -  -         - ---   - -       -- - -   -  --
-        -  --  --    - --  - -   -    --   --  -      -         -  -   - -- - --  --       -  - - -
--   - -- - -  -        - --    --        -   --  -  --  -- -  -     -     -  -       - ---  -     -
- - -   --  -- --     -   - - --     --   -- -          - -       -   -   -  - -   -    -      -- --
-  -       -   -   -  -      - -    -                -     - -  -     -   - ---  --         - - -  -
- - - -   -  - - - -    -  - --- --- -     ----  - ---  --  -    - -     -       --  ----  -     - -
--  - --  - --   -   - - -        -  - - -  -- -      -   --    - -  --    - - -  - -  -   -  -  - -
-  -   -         -  -  -- -       --  -  - --     -  -  --  --  - -   - - --  --- -     --  --     -
--- -    -  -      -      - - -  -  -  ---            -  -     ---- - -      -     - -- --    - -  -
- --     -  --  -  -  - -    -    -  -      - - - ---- - - - -       -     --      - -             -
-    - -   -            -- - -  ---  - - -     -   -   -  -     -  -     ---- -  - -  - --  ---    -
- --    -  --     -- -    -       - -         - -   -  -- - -       -   --   -      -         -    -
-   -  -  - - -   -     -       ---       -       -          - -   -          -  - --    --     ----
- -  -  -  --- --  ---  --    -    - - -      - -  - - -  - --   - -    -  --  --     -   -  - --  -
- --  --- --  - -- --     --    -- -  - -    - - -                   -      --   - -      - --   ---
--     -    --      - ---   - -               -      - ---  --  -    --- - - -    -  -  -   -  -   -
--   -  -     -    -      --  -  ---  -       --- - -  -- ---   -    ---  -  -  - -  - - -  - - -  -
-   - -  -- --  --    -     -  - - - -  -    -    --   --     - -- - -  -      ---  -    -      -  -
- -    -      -   -   - -  - --     -   - -      -     --      -   --        -        -- -       ---
--   --- - -   -      --   -  -  -  -   -  - - -  - -  -- - - - - -    -  -  -       - -   - --    -
-      -     - - - -  -  - -         - - -     ---   --  --  -  -  -    -- ----     -   -  -  - -  -
-   -- -  - -  --  -   -   -      - --  -- - --  --- -  -  -       -      -       - ---  - -  -    -
- -      --- -          -  -     -   --         -    -- --   --   - -        -    - -  --    -   ---
- ---        --- -     - -   --      -   -  -   - -   - --   - -     -      - -  --    --  --   -- -
- -    -  --   --      - --     - -    -    -       -           -     - - -    - -- -- - -         -
-         -          -  -  - -        -   -      --   -- - -  -           - - -- -   - -   -  -    -
--        -      -   -        --         -  - --       -  - -        - -   -         ---       - - -
- --   -  -    --  -             - -  -- --- -- -    --     - -      -- - --   -   -      -  -- -  -
--   -          --  - -     - -- -- -- -- -  -        -- -    --    - -   - -     - --        --   -
--      -   -    -- -  -     -  - - --      -  -  - -    -   -      -   -    -   --   --  -  -  -- -
-  -       - -  - -   -   --  --  -     -- -     -  -  --- -      --     - ---  - --- --   -     - -
- -    - - -        ----     -  -    -   -    -- -         - ---   --   - -- ---  -  --  - -   -   -
-  -    - -      --    -- --- -  -  --    - - - --     --     -- -   ---     -  -   -  -   -   -   -
-  - - --- - ---   - -- -- - -     -        - -       -  - -      --    -            - - --- - --  -
-  -- -   -   -  --  -    - - -   - -- ---   -  --  -  --    -   - --- -    - - -      -      ---  -
----   --     --          -      -       -  --- --   --     - -          -  -     --  -   -        -
-       --   - --  --    --  ---  --    - -- -     -     -   -- - --  - - -   -    -  -   --- -  - -
-- -   -   -    - - --       -    --   - -  -  -     ---  --        -      ---   -   - -  -  -     -
-- -      -   -   --   -  -   -    -              --   - -  - -  --- --  -   -- -- ---   - --- -   -
-  - -     - -  -     -- --   -  --      -        -      -- - - - --                -   -        - -
--    - - - -           -  --          - - - - - -     -  - - - --   -          ---   --  -    --- -
-   - -      - - -     -     - -   -  -    - -  ---   --   -    --- --   - -     -   -    -  - -   -
-  ---   --    --- - -  - - - - -   ------ --   -      -   -- -- -          - -   --   -      -  - -
-    -  - - -    -  --   - -   -  --         --  --  - ---  --  -  -    -- - - -   - --  --      - -
- -    - - - -   -    - -    -   -       -    -  -     - - -              -    -    --    --   - - -
-- -- -  -  -  -    - -   -     --            -   -- --    ---   - -   ---  -     -      -  -      -
--         -    - -    -- - - - -   --    - -- -   --   -  -         - -           -   --  - --  ---
-  -    -    -  - --         --    -     - -        -- --   -     ---       --      -  -  --- -    -
-       - --         - -- -    --- -         --- -  -  - -    - -   -  -   --    - --      -   -- --
- -   -     - -   --   -        --- --   -      - -  -  -   -    -      -- - -  - -- -- --  -  -   -
-       - -  - -      - - -       -  - --  -   -  -  - -   --     -   - --     -  -- -  - -  -  - --
-    ---    -  -- -- -          -                - -         -- -   -- - - -  -    - -- -   -  -- --
-  -  -     -   - -     --- -- -    - --     - -   -   -  -     -  --    -     --  -    ---   -    -
-    - - -  -  -      --     - - -        -   -   -- -- -     -       -  -      -  - - ---   - --  -
-  - -    - - -   -     --- -  - -    --     -     - -     -    ---      -- -  - -  -     - -      -
--- ---- - -          -        -   -  -          -  -        -- -  - - --- - -  -  - -   -     --- -
--  -    -     - ----   --        - - --   -  --   -  ---         -      - --- -- -       - -      -
-     --- -            -  -     --  -   -  -             -     - - -   -- -            -      - -- -
----------------------------------------------------------------------------------------------------
