100
100
----------------------------------------------------------------------------------------------------
- - -   - - -          ---    - -  --    -       -  -   ---   -   - --   -     -   -       - -  -- -
- -    --  -    - -  - --- - -        -   -  --  -- -   -    - -     -  - -    -    - -- --   - -- -
- --  - -    - ---          - -    ---    -  -    -- - --   - -   - --     -  - - --       -   -   -
-   -     - -     - --    -       -  --- -- --  -  -        - - --        - ---    -  -            -
-        -  --   - -  --  - -  - -  -   -  -  - -       -- --    - - - --    - -    --  - -  -  -  -
-    -    ---        -  -   -      - --     --- - -                - - - - -  -- -   -       - --  -
-      --    -  -  --   - - - ---  - --   -   -- -   --  -    ---  -      - - - --   --   -        -
-  - ---- -- -        -  ---  -     -    -  --   -  -    -  -        -              -      --   -- -
-  -      ---  - -  -        - -  -   -  -   -      -- -   -  ------    -           -    -- -      -
-- -   --- - -    -   --    -  -  -       -   -  - -- -- -  -       -      -      - -  -       -- --
--     - - ---   --  - -  --  - -   -    -    ---     -     --     --       ----    -      --    ---
-   -- -        -       - -- - -  - -  ---         -   -- --  ---      -  -  -  - -- -  - -- -- -  -
- ---   ----  -      -- - - -      -     -  -  -  -     - ----  - --   - - - - -     -    - -  --  -
--    -     -     -    -- - -- - --                 -       -    -        --  -    -   -- -  -     -
-  -    -    - ---   -   - -    - -  - -  - --- - -       -- - -   -    --          - --    -   -- -
-             -  - ----  -  -  - --   -     -              - -       -   --  - -  -- - -           -
-   -   --              -  -    -     - -  -  -       - - --- -- -    --    -      - - -  --- - -  -
-     --    -   -      --- --- -              - -  - --       --      --  -  ----   - -  - -- --   -
-- -     ---  -  -- -  -       --    -   -               --         -   -      - ---    -    --  - -
-   -   --  --    --  - - - - - -   -        - -   --       -    -  - -          -   -          -  -
-     --      --  --   - -- -  -       - --  -  -- -   -    -   - -----    -   - -     --- -   --  -
- -   -      - -  -  -  -  -   --      -  -   -  -- -  -         -      --    -   - --   -  --  - --
- - --  -   -       -- -  --      - -             - -    -  -     -  - -  -   - - - -   -    -   - -
--  - - - - -   ---- -         -  - --   -  --- -     - -   - - - -     - --    -   --  -  -     - -
-  -     -           -   - -- -       ----       - -     - -    -      -   -       ---    -  --  - -
- -      --   -   -  - -  - -   -  --   -    -- --   -    --  - -     - --    --  -     --    -  - -
--    --   - -  - -- ---  -      -    -   --  -   -   --- -   - --  -- - --     -  -      -  -    --
-       --    -  ---  -                 -    -     -  -  -  -   -  -  -   -              -    - -  -
---  --   -  -- -   --    ---     -   -    -  -- - -- --          -   -   -  - -    -    --        -
- -     -  -   -      - -        -- -   -       - -  - --   --     - - -  --    -   --   - - -- -- -
-  --  -   - --    -   - -  - -      --      --   -       -    --   --   -   -  -  --  -  - -  -   -
----   ---              --- -   ---  - -       -     -     -       --     ---   -     - -- -       -
-     -     - -    -     -    --         -   -- -      --- -  -  --      -     -   --- -- - -- -   -
- - -     -- -- -  -  -    -  - - - ---   -     - --    -  -  - -- -   -  --    -      -- -       --
---  -     --  --   - -   --     -    ---- -        -    --- - -       -  - -    -      -   -   -  -
--      -   ---  - -   -      - --           - -   -  ---     -  -  --  ---  -      -      - ---   -
-    --      -       - -            --  --      - -       -  -- - - - --   --  -      - - -    -  --
----  -        - -   --  -   -- --  -    -    ---- -- ---  -    -  -    -    -   - - -  -     -    -
-  --   -   -      -   - -  -    --    -  -  -   -     -     -  - - --      -     -  - - --   -    -
--     - -    -    -- -       -   -     -   -  -- -  -      -  -  --  -   -  --       -  -     --  -
- - --     -  -  - -   -   -   - -   - - -   --      -    -      -      -  -        - -  -- - - -  -
- -            - -     -     -- -  - -  - --- -    - - -  -- --  -  - - -      -       - - -  -    -
-  --   -  -      -   -- - -     --   - - - - -  --      -  -  -     -  --  -      - -     - - --  -
-        - -  -- --   -  --   - -       -   -    - -- -- - - - - -    - - - - -    -- -   - --    --
-     -  -   - --               ---              -   ---  ----  -          -   -   - -         -  --
-    -  -    - -  - --- - - -   -     --      - - -  ---- -     - -  -  - -  -  -   -    -      -  -
--     ---       -- - --                    -  ---   -   -  - ---  ---  -    - -  -  - -   -  -  - -
- - -    -    -     -    ---  --      -   -- --          -- -            - -   -     -      --     -
-        -    -   --         -   - - -    -  - --   -  - -      - ---  -           -  ---    -   - -
-      -  --  -      ---  -  -       -   -      - --           -     - - -- -  -  -- -      - - -- -
- -   -- -  -- - --  --  - -     -   --   - -           --- -    -- -  ---  -   -     -     - -   --
-   -  -   - - - -     -- - --  - - -  -   -  --   --   -     --    - -             -----     ---  -
-     - - - -     -  -- -  -- -          -  -      --  -         -  -- -- -     -         - -    ---
--  - - - - - - -   -  -                 --   --- -  - - -    -    - -- -     -   -          -     -
-   -       - -   -- -  -    - -    --    -   -- --- - - -  -             -   - - --   ---    -  ---
-        - -  --   --  - -         -  -        -- - -    -               -- ----  -   -   -- - -   -
-      -    - -  -   --  - ---  - -  -   --          --     - -      --         - --  -- -  -      -
-   --   -  -  -  -   - -   --   - - ----- -  - -  -      -        -- -      ---        - - - -  ---
-     ------ --  -   -     -  - -     -    - --              - --    -----  -  -  - -        -  -  -
-    -      - -   --- -         - -  - --  - ---        --   -- --  -      -     -  - - -   -  -   -
-   --    - - -  -  -     - - -     --  -    -    - -- -  -  -   -      - --              - -  --  -
-             -  -         - -    -      -- -   --  -  --- - - -    -      ---   -                 -
- - - --- - --    ----     -- -- - - -  - - - -      -   -    --- -   -          - --  - -     -   -
- - -     -   -   -    -  - -  --- -  --   - --- --  --- - --- - -   - -   - -     - -    --  -    -
- - -   -     --   -  --   --       -    --  - -        --       ---- --         - -    ---    --  -
-        -  -     -    -     - --- -   - - --  - -   -  - - - -   -- -  - -  -  -     - -          -
-   - -- - -  -  -  - -    - -      --   -  --     - -- -   -  - -     - -  ----- - -  -  -   -  - -
-  ---    - -     --   -    --  ---   - - - -          - ---  - -  -- -        -  - --  - - -    ---
---- -     - --  - - -  ---- -   - - -   -      -  - ---       -      -- -    -       -    --      -
- --- -  - -          -      -----   - - - --    - --      - -   -  - -   - -   -  - ---       - ---
-  - -           - -  - -        - --- -  - -  - -   - - -   -- -    -      - -       -   --     ---
-  - --   -- -       -        -       - -     -    - -  -- --   --    --- - --     -- -   - -      -
-      -     - --     -  --   - -   -   - --     - -   - -  --   --  -   -  -  -  --    -  --    - -
-    --  --   -         - --     -      ---  -  --  - -  - -   --   - - -     -     -- - -  ----   -
-   - -  -         - -      ----  - --   -    -     --    --         -   - - - -   -  -   --    ----
-  ----  --  - - -     --  - - --  -  --   --    -     --    --     -     - --    -- -  -  - -- ----
- -    -             -        -  -                    -- - --  - - --  -- -- -          - -      ---
- - ---  ---  -  -      -  --     -   ----    -  ---   -----     -  -  -      --     - - - -- -- - -
--         --  -     -   ---  -  -     -- -    -          - -- -- -  -  -        --     --  - -    -
-    --  -       -- - -     - -     --  --   - --  - -  - -    -  -   -     - -      -    -    - - -
- --   -  -     --  - -  -  -  --  -       -          -       - -      -  --  - - -    -     --  - -
- -  - - --  -         - -       -  -  -  -      -  -     -   - - --  -       -  -- - -- -  - -    -
-   - -   -     -- -      -    -  - - -     --         - - - -     -      --  -    -    - -   -   --
-- -    -  -   -          -    ---   - - - -- -     - -- -      - -  - -    -- -    - - - ---     --
- - - -           -    -  - -  -    ----   -  -  -            --       -    -  -  -        - -     -
- - --             - -         - - -  -        --    -- -   --   -    ---      --   - --    --- - --
- -- -  -  --  -  -   --      -     -            --   -     ---  -  -     - -- -   -  - -  -       -
- --  --     -    - -  -     - -   - -   -   -    --   -----   -        --  - -     --   - -    ----
-    -         -  - -    -- -  - --     -   - -      - -    - -  ---      - --   ---  - -          -
-    - --  --     -    -  -- - -    -    -     -     -       -    -  - --        -      -- ---   - -
- - -           --     -     -   - - - -    - -   - -  - -    -          --   -   -  ----        - -
--  -- --  --  -       -    -  - ---           - -    - -- - -- -   - --   ---  -        - -    -  -
- -       -          -               - -         -    -  -    --- -   -  -   -         -  ----   ---
-     --  - -  -  -     -  - -    --- -   -   -       -    -  -  -  --    - -   ---  --  -  -  -   -
--         --- -    -   - -   - -   - - --- -  -- -    -  - -  - -     -     -- -     -    --   -- -
-- - ---   ---  -  - -- -  -      --  -    - --      - -              - ----  --  --   --- --      -
-- -   - -  -  - --   - - -      --   -    ---  -   -- - -  -- -       -    - -   -   -  -   --  - -
- - -  - -  -  -      - -  -- -   -   -  -   -     --- --             - -- - -       -        -  - -
----------------------------------------------------------------------------------------------------
