100
100
----------------------------------------------------------------------------------------------------
- -  -         -   - -  - -- - -    -    -  - -   --  - -  - -   --      -          -          -   -
- -  ---       --                    -    - -  -    - -    -- --  - --- - -     -  --  -    -  - - -
-              -     - -   ----  -      -      ---- - - - -     -      - ----    --- - - --     -  -
-   -- -- -  -- -   - -- - --  - ---       - - -  - - -     - -      --      -        -      - -  --
---           - -- --  -  -  - - - --  -     -           - -  - ----  - -   -  - -   -       - -   -
--     -      - --   -  -   -  -  -     -   - -  --  --   -  - -        - - -    -    - - -      - -
-    - -  -       -        -   - -  -   --    - -  -  -       -  - -  -     - -  - -   - - -       -
- --     -  --  --   - --     -     - -  -  -   -   --        -   --           -   -  - - -   - -  -
-      --     --  -- -      --  -   -- --  -     -   --  ---  --  - - - -    - - ---    - -   -   --
--  - -    ---- -      - -    -   - -     - - -- --         -  -     -- ---- -    - - -      -  - --
-- - -  -        --- -  - - - -- --  - -     -- --     -- -- --                    - -    - -     --
-  -   -        - - -  --  -       -       -   -  - -   - -      - -    --  -  - ---  - -      - - -
- -  -     - -              --   -  -    --   - -   -  - ----      -  - -  - -    -       ---     --
--   -  -- -- ---   --   ---     -    -   --     --     - --  -   ---  -       -    -    -    -    -
-  -   -              -        -         -   --     -    - -   -     --     ---  - - - -     - --  -
- -   -   -     -    ---   - -  --  -----       ---    - -        -           - - - -      -  -    -
-     --     -- -   - - --     -         - -     -  -     -  -- -    -  - - -   -      - -         -
-       - -   - -          -- ---    -- -     -     -- -  - - - ----   -    --   -- -   - - -  - - -
--  - -      --    --        --  -    -- -- -     -- -   -   -- -    -    - -  --  - -  - -- - - - -
- -    - -       -     -    -     - -   -     -  -    --- -  -  --  -    --     ----    -     -  - -
-  -  -    --    ---  -- --  -    -  -- --   - -  -     -  - -- -       -   -      -      -  -   - -
-    - -    - --      -- -    --       -    -    -  -  - -        -   -     -  -  --  --    - ---  -
-- ---  -   -    ----        -  --     -  --     ---  - - ---  -       - -  -    -  -    --  -- -  -
-   - -  --    -  -     - - - -   -  ----    - --    -- -- -   --   - -   -  - - -   -    -        -
--- -  -   --     ----  - -    - -               -- -   -   ---          -       - -   -  -  --    -
-  -     -  - --  -  --         - -              -    -  -  -     -----   -     - -  -   - --   -  -
- -         - -   -   -         --   - - - - -      - -- --           -- - - -    -  -- -  -  - -  -
-    -  - -       -  -  -    -   -  ----  -   ----- -  -     -- --     --  ---- -   --  -  ----- ---
-  - ---  -   -      - -        --    - --  -  -  -  -  - -       - --   -  - -         - -   - ----
- -    -    -     -       - -   - -   -     --              - --     -  - --   -   -- ---   - ---  -
----  - -  -   -- -    -   - --  ---  -  -  -- --   -     -  -     - - -  -  -         - -  - -  - -
---    -     -   - -    --    --     - -    --             -      -  - -   -      --   -    -   - --
-   - -- - -   - -- -  -  -   - -  --- - -  - -   --     -  --- -   -  - -    --- - - --      -    -
-  -         -   -   -  --- -   ---    -       --  - - -       - -  - -- -- -  - -      -  ---  - --
-  --   -  ---         --     --  -    -     -  -  -   -          - --              -  --  -     - -
- -    -  -    --  -  -- - -       --     --- -       -     -      -  - - -     -        -  -  -- --
-       ---- --    --    -  -         - -    -   -     -   -   - -       --   --   -      -     - --
- --      -      --    -   -    --   -   -- -    --  --   --  -    -    -   ----    -           -  -
--       -      -- -    --  -      --  -  --    -  - --     -   -     -  -- -  -  -    - --  -- -  -
--       --    - -- -   --- -  - - -     -  - -  - ---    -   -   ---   - -   - -        - -   - - -
-     -   - -- - -   - - -  - -  -     -    - --           --   - ----     --        -  - ------ - -
-  -       -- - -      -     -  -   --   -  -          -     --- --    - - -    - - -             --
--  -  -- -      -   ---  -     - - -   -  --        -    --  - -   --- ---- --  - - -   --  ---   -
-- -  -  - -  -     -  - - -           ----        -      -  -  -     -     -   - -    -   -     - -
-  -   --  -    -      - -- -    -  -       -- - - - -  -- -     -  -    -- -  -             -  -- -
-  -- -    -   --    ---       -        -      -  --    --     -    -  - - -- -- - -   -  -  -   - -
-    - - ---  --- --  -   -- -  ---    -  --    -   -       -       - -      - - -    - -- -  ---- -
-   -     -     - --            -  -    --   -    -   - - -  -      -    -  -- -- - - -   - -      -
-     - --     -  ---    --- - -  -   --     -   ---    -      ---- --   -- -  - ---  -   ---     --
- -    -    - ---  -  -  -          -        -    --  -    -- -       -     -  -       ----   --   -
-         - -   -                    - --    -       -- -    - - -- --  --  -- -  --      -- -- -- -
-  -     - -   - ---- -     --  --        ---            -- - -   - --           --  -  -    -    --
-  --   -  -   -  -   --  -   -  --  -- --  - --      -   -   --  --    -   -  -    -  -     - --- -
- -   ---   - -       -  -- -    -      -   -   - -      --  -         -      -  - --   --         -
-     -   -   -    ----    -- - - - - --  - -   -  - -     -  -  -       -    -         - -   -  - -
-  -   - -   -- -- --       --   -   -   -    -  -  -      -        - --        -    - - ---       -
- - -  -- --   -    -   -  - - --  -- -     - - -     --      --      --   --  -   -   -- - -- -   -
-    --  -  --   - -     -  -    -     -   --- -  -  -    -    -  --      -- -   - -     -       ---
- - -     -                           -  --     - -  -     -     -  ---     - -         -- -    -  -
--     --           - -  - -  -  -     -              - --  -    -  -     -      -   --  -     - ---
-        -  -   -  -  -  -   --  -        - -   -- --   - -  -     --- - -  -  -----  - -  -   -   -
- -     - -  ----  --  - - ---      -  -  - -   - -- -    -  -    -   - - -   -  -  -- -  -     ----
-   --       -     -  -  -      - - -   -     -    --     - - -  -- -     --   -     - -     -     -
- -   ---  -  --   -- -   -  -            --   ---   -  -    -        - -- -  -  - -- ----   -    --
-   - -    -   -  --  -- -        -         - -   -    -           -  - -- -   --     -  - -   -   -
-      --- - -        -  -  - - -  -          --- -   -   -             -       - -      -  - -  ---
-  -  -   -  -  - -  - -   -     -    - --  ---  -    -- - -- -       - - - --  - -- -      -      -
--    -  --  - -         -- - -  -- -- - - - -          -    -   -   -   -      -- - - - -  -   - --
-  -  -  -          - - -    - -- --   --     -  --   - --       - - -- --  ---- ---  - -     -  - -
--- --   - -          - -  -       -     -- -    -        -- --   -            --      --- --- - - -
-- -  ----   ---    - ---    -  --  - -   --   --     ---          -         -  - --     - -      --
-  - - --   ---  -             -  -     --       - -   -    -  -   ---  -      - -  -     - - - -  -
- -   --  -      -   -- --       - --    -  -- - -- - - -   -     -      -  - -   - - -  -  - - - --
-   -   -       -    -      -   -  - ---  -   --    -   -   -  --  ----     -         --- -- - --  -
- -   -      -  --- -     --    ---   -    -- -  -  - - -    -- --    - - -  -   - -             - -
-  - -  ---    - ---          -      -   -      -  -    -    - -   -                 --     - --   -
-   -    --      ----  ----    -- -  -      -   - - -  --   - -- -  - -    --     -- -    - - -  - -
-    - -         --       -        -      -  -  - -    -       -   - -   --  --   - -  -  -        -
-          -  ----   --   - -     -   ----    -      - - ---  - -   - -- - --   -     -  -  -      -
-      -     -    -    -   -  --         --      - -- -       -   -- -     - -  --  -- -     -   - -
- -  -   -   --- -        - -     --  --  -        -  -  --     -  --  -        - --  - -      - - -
-   -  --              -  - - -  -  -  ---    -- ---  --  -         ----   - ---  --  -  --  -- -  -
- -    -    - - -    -        --   -  ---- --       -     - -     --    -  -  --              -    -
-    -    --    --   -       --  -   -         -  ---       -- -- -  -    - -    --  -   - -       -
- -  -      -     --  - -- --   -  - -- ---      -    -             -    -   -     -  - -       -- -
-   -  -        -        -   --    -      - --   --      -- -   - -    - - --  - -     -    - --   -
- -- --    -  - - -    -  --         - - - -     -    -     --   ---  - -     -  -    -- --  -     -
- - -  -   -  --     -   -   -     -- - - - -     -       ---- -    --          ---         -      -
- - - -    --   - -       -     --   -- -  -   - ---           -  -          --   -   -         -- -
----   -- - -  -    - ---- --  -    - -     -    -    - -   - -      -  ----- --   -    - -- --- - -
-       --    -  -  --    -   - -  -  -  -    -   - -   -    - - -           --     - -  ---     - -
-   -   --            --   --  -   ---  --- - - -          -- -     -- --           - -  --   -    -
-    -   -- -   -- -     --     -     -  - - -  --      - -  - --  -   -- - - -    --  --   -  -   -
-    -- -      -  --- -    - --   -  ---    -      - - -    - - -   -- -   -- -- -  -  - -    ---- -
-           -            -   - -    -  - - -      - -  --     -       -    --     -- --         -  -
-  -         -   - -  -  -  - --  -  - ---  --    - - -   ----   -  -         - -  --  -         ---
- --  - - -   -  -         -- -  -    -- -             - -  --    - --     -  --        ---   - -- -
- -     -       -        -               -  --    --      -        - -           --       -        -
----------------------------------------------------------------------------------------------------
