100
100
----------------------------------------------------------------------------------------------------
-              -         -   -   -        -  -       ---  -   -      -    - ---    -   -           -
- -- - -  - -  -      ---   - - - --- -- --  - - - --              -  -  -   -                     -
--      - --   --  --- - -  -    -   - -                  --- -          -- --    -----      --    -
- -- -  - -  - - - -  - - -  -   - - -   -  -----  -- --  - -      - --  -     --- -       -  ------
--  -  --- -      -     - -- -  -   - --  - -   -  -  ----      --    --- --  -          -- --     -
-                       -  -- -- - --  -  - - -   --         -  -- -  - --    -   -     -    - --- -
-  -     --  --   -  -       -   --   - -  -   - -  -    --         -       -      -   ---        --
-           -      --   -- - -   -- --- -  --    - -     -  -    --  ---  -- -  -   -- -    --  - --
-     - -  - -  -    -         -     - - - -  -    --       -    --           -- --     --- -    - -
- -     -         -   -  - ---  - -  - - -  - -    -   - -         -   -               --  -- --   -
-  -  -   -       -  - ---    - -   -        - -  -- - -     -  - - -    -  - - -  -          -    -
- - - ---    -        - - ---     -   -    -    -      - --- ---   -  - - --   -    -   -    - -   -
-- - -   ---    -   -        --    -- --       - - -      --     -    - -      -         -     --- -
--   - - - -  -- -       --   -  - -   - --             --    --  - --  -         -    - - -       -
-   - -   -   - --   -        -       -     -   --    -     - -   -   -     - - - -  -  - ---  --  -
-  -    -  -  -  - -  -     --  - --  -   -       -  - -- -   -    -   - -             - -   -     -
-  -  --- -  -- -   ---   -  -        -     - --   - --  - -    -   -      -    --- --    - - - - --
--  - ---   -   -  -- - -   -   - ---  -        ---    -    ---  - -   -     -     - -  -- - -  -  -
-    -      -      -       - -  -           - -  - -  -- - -     - -          -- -     -          --
-    -   - ---   -    -    -  --    - -   --   -   -    -  -- -  -  - --- -   -   - -     ----    --
--  -       -      -  -      -   -    - -  - -- -  -- -    -  - -  -     - -     -   --  -    - -- -
-     - -  -  - -            - --    -        - -    -  - -  -       -   ---   - -   -       -  -- -
- - -  -     -    --   --  ----  -  -- -  -  -   -         -   - -  -     -    - -   - --    - -   -
--  -        -  --             -  -   ----  - - -   -  -- - -      -  -  - -   -  -          - -  --
-- - -   --   - -      -   --   -         --      -  -     -       ---    -     -- -  ---          -
-  -  ---   -    -   - --        -   --    -- - --  -   - ---- -   --   -- -     - -           -   -
- -   -     -  --- ---       -- -  -  -  --  -- -    - ----- --  - -       - -     -   -  -  - - - -
-     -     - --   -  -    --- - --   - -- -     ---- -     -  -  -  - - -             -  -  -  -  -
-        - -     - -     -    -- -   -   - -     - -       -    -  ----    -        -   -  ---  -  -
- -   - -   -  --  - -  -  -  - -- - -   - -   - -   -  -  - -- - --  -              -            --
--    -   -   -  -  -     --       -    -  - - - -- -      -    -   - ---   - -  -    ---  --      -
- ----  -  - - -     --   - -  - - -  -    --- --   -    - -  -         -- -     -  -   -    --    -
--    -  -  -   --     --- --    -      -     - -  -    ---          -  -    - - - -   -  --       -
- --- -                 -     -  -  -   -- ----- -   -    -     -  -  - - -   -- - -    -    -  ----
-      - -  -   -- -      -  -    - ---    -     - ---    - - - --  - -  --     - --   - --   -  ---
-   -         --            -- -  -- -    -       - -            ----           -- -          -  ---
-       --     --   - ---      -  -  - - -- - -    -     - - --- -  --  -    -       -- - --     ---
----- -  - --  - -  -      -----     --- -                   - - -    -   -     -    - -     -   ---
-       - -  --          -   -  -- -  -   - -    ---      - -  --   -        -   ---   - -  -      -
-  - --- - -   -       -- -  -         ----  -- - -  - --   - - ---  -  -     - - -          -    --
-  - - -     -  ---- -   -      -- - -     --- -    - -   --  -  - - -   -    -  -  - -     -   -  -
---  - -   -      -- -       ---  - -    --   -- --   ---    --        -    -- -- - -      - --  - -
-  -   - --              --  --  ---     - --  - -   -  -    -   -  ----- - -       - -        - - -
- --   -   - -  - -  - - --- --          --  - -  - -  --      -   --   -   - ----     -   -- -   --
-    - -     -- -  - - ---  - -- --       -  -  -                -       -   - -   ------ -- --    -
--      -  - - -  -   -  -    --   -       - - - - -     -   -   -  -  - ---  -        -       --- -
--- -    -  - -      -                -   --  -          - -- ---        -       -  -   - - - -    -
-  -  -   -- -- -  ---- -          - -- -     --- - -  -             - -     - -  - -  --          -
-    - - -         -    -   -   --  -  --     --  -      -  -  -    - -  ---     -                 -
-  --    -    - ---   --     -    - -   -    -      ---- -- - ---      --   - - - -     --  -----  -
-  -  ---     -   -        - --  --  -    -  --  -     -                  -      -  -           ----
-  -  --  --    --   ---   -      -    -   - -    --   ---     -      - -    - -  -- --      - -   -
--  --      -- -  -        --  - --      -       - - -          -- -   - - -     -   --     --  -  -
-  -      -        -  - -    - -  -- -     -    -      --  --  -  -   -       -  --   - -  --      -
- -  -   --  - -  -          -          - -  -- --    --    - -    --  -  -  -    -     -    -     -
- ---   - -   -  -   - -   -  -     -  - -  --     - -   --   -    -    --  -   -   -     ---      -
- -   -    -  -   -  -           -    - -   - -- -    ---  -  -- -- -  -   -   -   -     - -----  --
-      - -- --- -            - -   -- -  -      -- -- -     --  -  -       -   - -       -  -      -
-  -- -   -                   -- -- - -  --       -   ----    ----  -- - -    -       -            -
- -   -     - -- --    -       - -  - ----       -   -       ---  -    - -     -- -  - ---   -- -- -
-  - -       - - -- - -        -   --  -   ---   - --    -- -     -       -     - -     - - - -    -
-- -     - - -     -- - -- - -  -    -- - -   -   --  -   -      --  -    - -- -   - -----   - -   -
- - --     -  -- --     -   - -     -- -   -  - -   -  -  - --  - - - -           -     - -  -   - -
-  -  -- --      - -    - -    --   - -   - -   - -           -         - - - -  -     -   - -   - -
-   - -  -     - --- -  - -  - - -        - -   - -         -      -- -  -      -- --   - -   -  ---
-   - --      -   - -  -     --   -    -- -   --  - - - --- -- -  -- -   --  -   --  ---   - -     -
-   -     - -     - - -  --     -     -    -    -  -       -   -  --        -      -            - --
-   -    -  - --      -  - - -- -    - ---  - - --   - -   -   - - ---   -     --  -- -  --   -   --
- --   -  -- -   - - -    --   - -       -   -   -     -- - -- - -        - -- - -    - - -    --  -
--       -     -        -  - -       ---  ------    -      --   - - --        --- - --  -  - ---   -
-  -   - --  --  --- -  - --- --     ----     - -    -   -   -     -    -    --- -    - -- -   -   -
- - -   -   -       -  - - -           - -  --  - - -    - -        -  - -      --   -    -  ---   -
- - --                      -    -  -     -    -     -   - -  -      -    --     -   -  - - -   -- -
- - - -  -  -  - -   - --    --  -   -    - -       -     -  --      - -      -          --       --
- -     - -  -    - - -   -    -       -    -         -       -  --  -- - - -          --    ---   -
- - - -    -        -  -         - -  --    --  -        -- -         --- -     -- -    --- -      -
- -- ----    - -        - --- -  - -- -  -  ----  -- -         -     -      --  - - ---  -     - - -
-      --  ---      -   - -  - - -      -   - -   - -    -- -  - ---     -     - -      -    -  -  -
-- - -   -        - --     -          - - -    - -    -    -  -     -   - - -  - - ---- - - - --   -
-    - --    -----       --    -  - - -   -   --   -  -  -- --     -   - - -   - -  -      -       -
-- -  -  -   -    -               -   - -  -     -       -    -  - - - -  - -- --     - --   - - - -
--       --- -   -   -           --    --- - - -   -   -  -  -- -     --  --    - -  - -  -       --
-  - --     -   -- -       --  -          - -     --  - -   - -     --     -  -  -  -  -  -- ----  -
--  -- --    ---    -     - - - - -   -      -  -  -      -   -       -  - - -        - -   -    - -
-  ---   - - -  ---  -           --        - - - -   - ---   - - --  -      - -            -   -- --
-   - -    - - - -   -   -   - -  -  ----  - - -  --  - --   --    - -       - -  ---  -        - --
-     - - -  --- -  -   -  -- - -               - --  --  -    -      -  -   -        -- - - --   --
- -    - ---     - - - -        -   -   --  -    -          -      --  ---  ---      -    -     -  -
-  -       -  ---  --   -  --     - -- ------  -  --  - -    -   -- ----       -   -     -- - -  - -
- -   -- --  -   - -   -  -   -- -     ---         -     --        - -  -      -- - -     -  -     -
-          - - -- - ---         --  -- -      -         -        - - -  --  ---- ---        -  --  -
--- -    - -     - - -  - - -   -  -  --          - - -  - -   -           -    -          -       -
-  -   -    --- - -   - -- -  -   -  -  -         -- -  - -  -   --   ----      -  -- - ---   - -- -
-  -  --    - -   -     - --  -- - -    --  - -  -    --   -    --   -     -      -        -  -    -
-- -  - - -- -  -      - -  -       -      -   - -    -    -  -- -  -  -    -  --  - - -   -   --  -
-- -           -  -   - - - --  -   -  -    - -  --   -- - -   - -      -             - - -  --   --
- -   --        -          ---- - -    -  -               - -      -             -  -    - -  -    -
-   -     - - - - - - -       - -  -         ---  -- - -   -- - - -  -  -   - -       - --    - -  -
----------------------------------------------------------------------------------------------------
