100
100
----------------------------------------------------------------------------------------------------
-    - -    -  - -         -  -    - - -                -         - -   -    - - -  -    -- --     -
- --  -     -  - -    -  -  -         -     -         --   --      -      ---   -  -  --        -  -
--   -          - --    --   -  --   --    -  -     - -- -      - -- --    -  --   -     --  - - - -
-        - -  - -   - - -     - -   -  -- - - - ---     -  -  -     -    -- -     -         -      -
---  -- -   -      -       -  -    -  -   --        - ---   -   -   -  -     -   --    -        -  -
-    ----  --    -  -    - -   ---            ---   ----   -- -        - -     - -  --      -      -
- -   -     -- -  -    - -   -     - ---        -     -    -   -   -        -       --   -- - - -  -
-   --  ---    - -- ---  - -  -   - -    -   - -  --  -  -     -    -   -   -      - - - -  - --   -
- -- --- --  -    - -     -  --  - -       - -  - -     --  - - - -  --   --  - -- - - - --  -     -
-      -  -    --  -----      -  -      --        -- -      - --      - -  --    - - - -   - - --  -
-   ---     -     -     -    - -    - --  -   -        -   -    -- --    -- --  -  - -     -   --- -
- -  - -      -      - - -  ---   -   -  -- -  - ----    - - ---  -    -  -  --   -  -   -  ---    -
-       ---     -  ----- -   -      --   - -     -   --  -  -  - -   ----   -  -     - -- -      ---
- -   ---  -  -     -   -       - -   -  -   -  -  --  -   - - - -        --   -           -   - - -
--         - -   - -   -  - --     - -   - -          --  --    -  -  --  - -   -  - -        -  - -
- -   -  -    -     -        -  --     -- - -  -  ---   --   -    -   -    - - -   --        -  -  -
-- --   - - -          -    -   - -          -    -  --   --   --      - --  - --      -   - ----- -
-      - --- -   -  - -      -     -    --  - --   --  - -   -                 -  -- -   - -       -
-  - -  - -  -  - -   ---        -  -       -      -----          - - - - --- ---     --- ------   -
--          - - -   -  - - -  -  -   --   ---  -   -   -     -  -   -  -     -    -      ---      --
-  -       - -  - -  -   --    -  -      -      - - -  - -   -           -- ---    -    ---  -   - -
- -  - -           --  - -   -   -- -      - -   --- -    ---      -        ---- - - - -           -
-  --   -   - -  -   -- -  - - - -  -     ---    - -     -  -  -   -   - -            -  -- --- -  -
-- - - -    - - - -    -     -   - -  --    - --   -   -- - -     --   - - -- --  -  - ---    -- - -
-- -  -- -       - --    - -    -    -   -   -   -      -- --       -   --     - -          -  -   -
- - -- -  -      -     -- -   ---  -  ---   ---  -----   -     -- -  -   --- -----    -  -         -
-   -       - -   - ----  -   - --  -       -     -      -  -    -      -        -      -  -   - - -
- - -  -  - -   - - -       -- -   -  --  -- - - - -   - - -- - -  - - - -  - - --  -  -      -  - -
-  -    -      -  - - -   -   -        -  - -   - ---   ---- -       - ---  --    -  - -    -  -   -
--    -- --               ---  --- -         --    -        -   -  ---  -  -  -- --  -     - --    -
--   --   - -        -- --- - -     -   - ---- --  -   -- -   -           --- -  -         -  - -  -
-    - - -  -     - -        - --    -   --- -    -    -   - - --     -     -    -----    --  -- ---
- - -   - -   - -    - -   -  - --     --    -    -      -         --  -       --    - --     --   -
-    -       --  - - --   -   --  -  -  -- -  -  -  - --  -  -  -    -- -       --   -  -  ---  -- -
-        -  -        - -       -     -     - --   --  --    - -   -  -  - --        -  -  -   -  - -
- - -  -  -    - -    --         ---- -     -   - -   --         -          -     --   -- - -     --
-  - -   -        --      - -     - -  - -     --       - -  - -     - - --   -    - - --  -     - -
-- -      --- ---  -- -- -     - --  -- -    ---  - --     -- -  -  - - - -   -       -  --    -   -
- -- - --- - -      --   - - --        -     -         -    - -   --   -            - -            -
- -  -- -    -   --  - -   --         - --   -   --  --   --- -  - -   -     -  - -       -        -
- -      -     - - - -  ---   --    - --  -   -   -                     --  -    -  --- -  - -- -  -
-  - -      --   -   -     -   -         -- -   - - -  - -      --    - - -   - -              -   -
--      -  -  --- --  - -- -   -  - -  - - --- -  -   -  - --- ---  -        -  -    --      -- -  -
-   - -   -  -       -      - --- -- -     -  - ----     -  -    -             --  -       - -- -  -
-     --     - -   --  ---             -          - - --     --  -      -      ---  - -     -   - --
-  -        --     --- -  ------  - -   -  - ---  - -    -      -      - --  -- -   - -       --- --
-    --- ---  - -      - - --  - --   --    - --         -       -        --                -      -
--  -    -    - -  - --       - --        -    -     -     -  - - - --   -     --  - -     -   - ---
-  -           ----  -  -   -      -       - -    -        -   -  --   -  -- --  - - -      -   ----
-  -     -- --- -- -   -     -    --   - -    --  -  -  - -  - ---  --   -      -    -  -   -    ---
- --    -   -      -            -      -  -  -  -    - - -        --      -- - - - -  -  -   --  ---
-      -  -   --  ---  -     -- - -   --    - --      --   - -   - - -  --  -  -        -  --   -  -
- -- - --  -   - - - - - -    --   ---   - -   - --   -- - -      - --- - --   - -   --    ---     -
--   -                -  ---      - -          - -  -  ---   --- - -    --  ---   - -   --      -  -
-          -  -      --- -- - - --   -          -    -- -           --   -  -  -  -   ---  - -     -
-  --    -         - -   -      ----- -     - -   -  - -  --- -      --      -   - -      -   - -  -
-    - -            - --- -- - -- -  -    - --- -  -- -  -   -    - -- - -      -          - -  -- -
-     -   --   -- -      -   -  -  - -    -  -      -   -   - -  - -   -         - ---   - --    - -
-   -  -    -    -       - --- -- -- -         -  -- - ---   -- - -- - -  --    -   -  - - -      --
- -  -        --   - -      -   --   --     -             - -       - - - - - -      -      ---    -
-    - -  - --  ---        - -     --    - ---  --  - -  -     --  -         -     -  - - --       -
- - -  - - - - -  - ----   - -  -       -   -     -- -         - -    - --      -       -- --     --
-            -- -    - - -    -        - --  --- ----  - -            -     - -  -    - --       - -
-         - - -   -   - - - -   --  -  -        --  - -  --   - --       -   -  -     - --     -   -
- --   -     - -    - -     -  --   --        ---      - - -      -    -     -  ---  -   - -    -  -
--     - ----  -    -  -  -- - --    -   - -  - ---  -  -      -- -  -      -     -  -  -  -  --  --
-                 -   -     ---    --     --  -    -- --      ---   -   -    -- -               - --
- --- - ----- -- -  -    -          -        -  --- -       -  -  -   -  - -   - -- -           -  -
-     -         --  - -   -       - --   - --    -    -         -  -         -              -   -  -
--        -   --  -    ---  -          -          -   -       --  - -  -     -   -     -   --  -   -
- --    -   -     --    - -  -   -   -- -  --    - - ----       -  - -- -  --       -- - - -  -   --
-  -   -    --- - - -    --   --  - -- -  -        - -     - --   -     --   - - -    -  - -  - - --
-  --            -   ---        -   -      -  -  --   - ---   -       -  --     - ---  -- -     -  -
-     --  - -- - - -        --  -    - -   -   -  --   --       - -  - -  ------ - - --    - -    --
- -  -     - -       - -  -  -   -   - - -  -   - --  -  - -  -         --    -    --     --  --   -
-      ---    --  - -      -     - --- -  -- -- --     - --        -  --  -      -        - --  - --
- - -   -- -            -  -   -         -  - -  -- -   -         --    -- --  -    - -      -  -  -
- -  ---    -   - --  -    -   - -  - -      -  --  -  - - -   - -  -     - - - -- -     - -    -  -
--   -  -      --       - -      -- -       -- --        - --- -   --    - -    -       -   - -    -
-  - -----   -  --           -- -  -     -     -   -  --- -  -- --   -- -   - -  -       --   -    -
-     - - - -       -- -- --    -      - - -   ---- -   -   -- -                   -   -      -  - -
- - ----    - --    -   --  - - -- - - - - -- -    - -  - - --   -   --    - --- -  --  --  - -    -
-- -         -  - --- - - ---  -    -     -     -  -   -    --  - - -    - -   - ---      - --     -
--   ---  --       -    -   - -  -    -    -        -     -  --    --    -    --   - -    -- - --  -
- -   -- - -           -       -- -   -- - -     -  - -   -  - - -     -  -     -   -      --   -  -
--  - - ---   -  ---- - --   -    -- --    --   -            --     -   --- - -   -   - -          -
-   -  - ---         - - -    - -  --    -  -   -        -  - - -      - - -  - - -  -      -      -
-  -        -        - -   - - -       -      --   -     - -     - -       --  -     -             -
-    -  -      --             -     -    -  - --  -  --  --  -    -  -       -  -     ---  ---     -
-     - -   -        -    - ---     -  -       -  -- --       - - - -- --           - - -  -    -- -
-- - -   -   - - -     - --      - ---  -    --   -  --  -   - -  -     - - - --   - -  -    -  - --
-           -  --- --        ---   -       -     --- -- -  - -   -   -  --         -  --  -   --  --
--    --  -       -   -         --   --         - -    - -         - -- -- -    -        - --     --
-    ---  - -   -- -   - - -  -- - - -      --  - - -- - -  - ----     -   - --     - -     - -   --
-    ----   -   - -  --  -     - -      --- -      -       - - -  - --    -    - -      -- --    - -
-  -  - - - -   -  --       -  -   ---- -  -  - -- - -  - -  -------    -   -   -  --   -   -    - -
-   - -    -   -  -      - -         - -  --      - - -    -      - -         ---    -    - -    - -
- - - -         - - --  -  -                -         -  --  --   -  --  -   -   -  -----    -  -  -
----------------------------------------------------------------------------------------------------
