100
100
----------------------------------------------------------------------------------------------------
-  - -    -    -    -    -       ---       -           - -    -   -        -   -       -       -   -
-     -  - - --- -   --  - --      -- -  -       - - -        -       -  -        - --     -       -
-  - --  -   -  - -- - -  -   -- --  --- - --  -       -   -     -     -  ----   -        - - -  - -
-  -     - - -         - -  ---     - -  -  -   - -     ---------     -    -  - --  - -     -  - - -
-  -     --      - -- -- -       -   - -         -    -- --      -   - -  - - -   -  -       - - - -
- - -  - - -     --- -    -         -    -- -  ---   -  -    -- -       - - -     - ------ -- --   -
--   ---      ---  -  -     --    - -- -- -    - -    -  --      --          -      --         -   -
-  -- -   -       - - --   -  -   - -      - --         --    - - -  ----   - --  -       -  - - - -
- -  --   - -   -  -         - --   -- ----      - -----    -    -       - --   -    - - -       - -
- -          -      --   -- -       - -      -  -  -    ---  ---    ---    -  -     -    -  -- --- -
--         -  -- -  --   ---  -  --     --    - -     -   -  --  -   - -  - --     -  - -    - -   -
-   --- --        --  -  ---  - -  -     -   -   - ---- -            -       - - -   -   ---     - -
- -          - --                  --  --   - -        -  -  -----  -    ---           -   -       -
-   -- -  - --    -  -    -  - - -   -- --  -    -      - ---   -     - --   -- -  -   -    -   -  -
- - -      - - --        -   -         - -    -- --          -   - --   -  --       - - -        - -
- - --- -  -    -- --   --  - -    -  ---   ---   - --       --- -   -   --   - ----     -    ---  -
-        --   -    -     - ----- - -- --   -       -  -  - -       --- -    -      -   -        - --
--  -    - -            -       - -  - -   -----  --     --             ---     -   -   - -    - - -
--            -         -      - ---   - -   --     -   - -   -   - --    -     --  -   - -    - - -
- - -  - -  -   -  -    -     -- - --     - -  --  --   -     --    -  - - -- - -- - --  -         -
----     -    -  -  -     --    -    -     -- - -     --   ---      - -         -   -    -         -
-     --        - --      -  -- - - -- - -       -         -  - --      - -      - -  - -      - - -
--     -   -  --     --  --   --    - -   -   - --  - --    -   -- -   -- -   -    -  - - -     -  -
-  -    -  -- -  ---   -    -   --     - -            -  -  -           - - - -  --  -- - -  - -   -
- -  - - -   -      --     --    --      - -        --- -     --  -  -  -                  --  - - -
- ---  -   --- -  --     --          --- - - --  -    - -    - -   -  - - - -   - -  --     --    --
-- - ---      --  ---  -   -   -   -- - -          -   -- -- - -  -    -  - -   -        -  -     --
-        -- -      -     -  - -  -     -  --       -- --   --      -   -  - -       - - --   ---   -
-         -    -   -    -  -         -        -   -     --   - - - ----   -    --- -        -  --  -
-  --   -  -      - -        - -  -  ---  -- -   --  -    -  -    -  - -      -  -       - -      --
--        -    -  -   -        -   -    ---  -     ---    ---   -- --- -- --     -   -  - - -  --  -
-         ---   --- --   -   -        -         -              -- -  -      -  --   --   -    -  - -
-   -  - --- -      -- --  -      - -     -  -   --   - -  - -- --- -   -           -       -   -  -
--   -  --  -    - --    -      --   - -     --  -  --   -- --   -   -   ---   --     --      -  - -
- -  -     -- - ---    - -- -       - - - - ---  -  -  - - -  -       --    ---- --     -    - - - -
- -         -   -  -                - - --    -  -- --      - -- -- -   -       - - - -   -- -    --
- -   -  -- --     - -  ----  - - --  - -   -     -    -     -      -   -  - -- ---- - -     --    -
- --  --           -  --    ---  -- - -     -   -  ---   --        - -- -  - -        --       - - -
-   - -  -      -- -     - -         -    --     -    --   -  - -         - -       --     -- -  - -
-  -   - -        -  ---  -  - --   -- --- - --   -- -  -- --          -      --- -          -  -  -
- - --    -  - --  --  -  -           -    -  --     - - -    --   - --    ---        -  -      -  -
-  -  -  -  -            - - - -      - -        -     - -      - -  -       -- -- -   -  - -   -  -
- --   - - --  -  -- -   --    -        - -   - -              -   -   ---  -  -   -      -      ---
-  - - -   -   -       --- -- - -  -     -  --    ---  -    - - -  ----          - -  --  -        -
--              -  -      -     --    -    -                -          --   - - -   --  -  -  --   -
-    - -- -        - -   --      - - --      -  -   - - ---  - -     -     - --   -            - - -
- -    -- -        -            -   - -   -- - --    -  -  --     --       --    -   --            -
---- - --     -  -  - -      -     -    -           -  - -    -- -   - -         - --  ---    -  - -
-  -   -- -      - - -    -   --   -     -   - -      -   -   --  -    -  --   - - -             ---
-     --- --  - - --   - - --     -  -       -    ---   -       -     --  -     -      -       - ---
-  ---  - - -    -          -- -    -     -- -  ---     -   -  -    -  -  -  - -      - -    -   - -
-- - - - ---      -    - -    -  -     -- - --      -    -- - - - -          -- -- ---         -   -
-            -  ---- -- -    -- --  -         -     -   -          -      --- - ---   -- - -   -- --
- -     - -  -        -   -     - -        --- --     -    -   - --     ---   -    -   - -  - -  ---
- -        -  -   -  -    - -   --- ----  ---           -   -   -  - --  --  - - -   -  -       -  -
-  ---   -  --        -        -   - -    -      -   -    ----- ---         -- -    -       -   - --
--     - -   -     -   - - -  - -  ---          -  -    --   - -   - -    -  -  --    -   -     - --
- -      -        -       -    -    -   - - - -            -   -    -  --             -   -  -  -  -
-  - ----    -  -  -    - --      - --   -   -   --    --  --  -  -   - -  --- --     --    -  -  --
-- --    --  - -    -  --    -   -   -  -  - -    -- -   -       -  -    --       -- - -  -     ----
-   -  -     - ----- -      -  -   --  - -- -  -    --    -- -        -- -  -- -  -         ---    -
-         - - -      -   -   - -- -   -- --      -- - -  --  -  - -      --   -- - -- - --     --- -
-  -   --  -- -   -  -   - --- - -  -- --           -   -  --- -  -  --      --- -   -     - - -   -
--- --    -     - -       -  -- -    -    -  - -- -  --  -          -- ---  - - -   - ---      -   -
-   -  - -  -       - -  - - -    -     --  -- -      - -  -  -    - -- -  --   -     -  -  -   -  -
-   -  -- -    - -  -  --    --      -  -  -- -  -- --    -  -     -     --  --       - -   -      -
-  -  -  - --      --    -- -     -  -  - -     -      -   -   -  -    - -  -  ----    -      - -  -
--        - -- --  -       --     --  -    --  - - -   -- ----        -  -  ----   - --  - -    -  -
-  -              -  -  --  - -    -    -      -- -   -  -    -  - -   -   -    --    -  -      ----
-   -- -  -   -    -     -- --   -     -   -- -        -  -- -  - - -    -        --    -  - - -   -
-       - - -         - -  --   -- -    --  -  -  - --    -- -        - - - -        --    - --  - -
- -      -- --  --      - -  - - -  -  -   - -     ---  -   - --      - ---   -  ---  -  -     -   -
- ---- -       -        -  - -   -       -     - - -  -      - - ------ --  -   -  -   -  -    -- --
-   -          - - -     --   -    -   -  -     - - -   -   - - -  -   -- -      ----    -   -  -  -
-  -  -  -- -- - -- -     -         - -   ---  -- - -    -   -  - -   -   -      -     --      -   -
- -    -   -     - - - -   -  -    -   ---   - --       -    - - -      ---  -   -        -        -
-   ---- ---   --- -   - - - -  -      - - - - -  - ---  ----      -   -    ---  - - -  - - ----   -
-- - -  -    -    - -  - --      - -- --      --   -    -      -   - -- -        -  - ---  - -- ----
- --- --    -   --  - -   --- -  - --    -  -    -   ---     -   -  -  - -  ----  --  --  - -      -
--  -  -    --  - --  -    -        - - - -   - -   --  -    --   -   - ---      - - -   --  -     -
------- -  -   --    -    -     -   - -   -     -   -    - - --    -   - -         -    -   -      -
-  - -   - -  -   -      -   -  - -     -     - ---  -      -             --   -  -    -- --  - -  -
--  -- -    -- --  - -         -  -   -        -  ---     -  --  -         -   -- - -   --  -  - - -
-      - -   -- ---- ----  - -- -    - - -- -       - -     -  -  -    -   -      -   -    - -     -
--- - -- -  -  -    -     -   - -    -  -  --   - -     --     -   - --  -- -     -   -    -   -   -
-        --     -  - -   -  - - -  -- -  -  ---     - -            -    -     --           -- -  - -
-- - - --      -        -    -    --     - - - -        --    -     --     - -  -- -  -  - -    - --
- -    - -     -  - -      -       - - -    -  - - - -         --        -- - - - - - -   -   - - --
- -   - --   -      -  -  -  -      -     -  - -   -- - ---   -      ---    -    --    -    - -    -
-    --- --     --- -  --     -- - -            - -  -      - - -  ----  --   -   --    --    --   -
-   -       -  -       -      -- -  -------      -  -- -  - -  - -   ---  -    -     - -  ----     -
-  - --    -  -    - -- ---      -    --     - -  - -   - --- -    -   -          --   -- --  -- - -
-    --  -  -    - -    -       --  -    -        -- -   - - - --    -     -   -    -    -   -   - -
-   --  -       -   -      - - -  - ----               -     - --  -   -         -     -   -   --  -
-           -  -  - - - --        -  - -    --   -    -   -   - -        -   ----    -        -  - -
- - -  -         --   -    -  -      -  --  -     -  --  -      --   -  -    -   - -  -     -    - -
--   -       -     -   -    --  --    -   -   - - -       -  --     -   --    - - --- -  -   -  - --
-      -- -      - - - -   -        -   -- -     -       -     - -         -   -  --    --- -      -
----------------------------------------------------------------------------------------------------
