100
100
----------------------------------------------------------------------------------------------------
-    ----  -   -        -   -  --      -   --   -  -  - - - - --           -              -  -   - -
- - -      --    -        ---     - -  -      -  --  - -       -  -           - - --        -   -  -
-  --  -- --  - -        --       -          -          - -                 -  -   - -  --  --   - -
-     -        -      -           -  -    - -  -      - -   -      -- --     - - - -         ---   -
- -  -  - ---  ----    --- --      -    -  -      -  -    - --  -         - ---    --  - ---     - -
- -  -  -  -- -    -- - ----- -  -  -     -  - - -   --  - -      -    -          -      --        -
- -   --   -  -  -- --- -  -      -    - ---- --- - -   -    - -   -- --  -  - ----- -- -  -- - -- -
- -      -       - - -    -  - - -   -    -  -    -         -  -    --        -    - -   -         -
-- -   -- --  --   -           -        - - - ---  --- -- -  -  -     ------ --     -    --    --  -
- -    - -  -   -  -       - --      -   --      ---    -    -    -     -     -- -    -    -       -
-     - -     - -    -  -     - - -    -  -  --    - - -      -           --        -  - ---- - -- -
-   - --    -   -  - --  -  -       -    -  -     -  -  - - - - -  ---   -- - -   - -     -       --
- -- - -- - -  --   -                  -   -   --    -   -      -    -  -       -    - -      - -- -
-   -  -       - - -        --- -   -  -    - --  --       -  - ----  -         -    -     -  -- - -
- -      -   -   -   -- - -     --  -  -  --    - ----  -  -- --     --        - -    -  - ---   - -
- -    - -  -              -        -  - -   --  - --  -  - - -   --   --- -    -  -   --     -    -
-      - - - -   -   --    -   -- -   - -  -   - -- -   -  - -   --  -     -    - -     - --       -
-     --       -  -  --- --- -  -    --   -  -     -      -   -  -  - - - -       -- - --- - --    -
-  -     -  --  - -     -    -      -  -       -  -- - -- --- ---   - -  -- ----       -  -        -
- -    - -    -    -  -          - - - --        -   -- - -  - -  - - - - - --      -- -- -  -    --
--  -  -    - - -  -   ---  ---  -- -     - - --   -    -  -  - ---- -       - --  -          -  ---
- --  -   ----  - - - -- -  -  - -  -              -   -- - - -   -  -       -    - -   - -        -
-        -----  -  -         -  --  -       -       - -  - -         -  -    - ---  -----      -  --
-  -  -     - - -     - -  - - -     - - --       -   --  - -   -- -   --- -  - ----       -  -    -
--  -   -   -      - --         -   - -  - - --   -  ---   -   -          -  -  -   -      -      --
-    ---   - --  - -  -   -  ---    -     -     -  --   -- - -- --   --- -     -       -     -- -  -
-  -- -     -     --       - -  -   --      -   - --  --       -    -  -    --  --   - ---- - - - --
-  - -    -  -            - - -   -      -      -- - - --  -- -   - - -  -    -- - --       -   -- -
-  - -  --  -    -  -   -   -   - --            - - --   -  - -  -   - -    -----   - -  - -- -    -
- ---          -  -  - -   - -  -   - - - ----   -    - -  ---     -     - --           -     --   -
-     - --  -         -   -  -    -  - -  - -       -  - --  - -              ---    -    - -    ---
-- --   --- --         -    -     -     ---   - -- -- -   -  --   -  --  --      -  - -      -- -  -
--  -  - -       -  - -   - - -          -        --  -    - -   --   --   -     -   -- - -      - -
-     - ---  ---         --  -      -     -  - - -     --     ----         - - -  - -- - -  - - - --
- -        -     - -  -  -          - ---   -- - -   --   - --      - -        --      ---     - - -
-  - - -- -   -        --      -- -   -  -     -  - - -  -  -       --    ---- -    -- -  --  - - --
-   -  - ---        - - -       -  - -   --   -  -  - -       -- -          --  --  - - -  -   -   -
-     - - --   --       - -    -- -  --  --   -  --   - -  -     --- -  --    -  --  -  -    -     -
-    --  -   --    -- - - -    -- - -       ---    --         -       -- ---  - -  ----  - - - -   -
- -      --     -     -- - --     -   -             -- --  -  -- -     -      -  --   -    - - -- --
-  -  - -   -     -    - -   -  - -      -  -      --- -    --   -----  -  --- - --  -  --     - - -
-         -  - ---      --    - -- -     - -- -       - -    - -   -         -      --       - - - -
-  -   -     -      - -- -      -  -  -  --  - -- -        -   - -   - ---  --- --  -           -  -
-  -  -- - -  ----  -- --      ---        -      - -   -  - -   - -- - -      --    - -  - -  - -  -
-     -      -   -  - -   -      -   -     - - - -  - -                        --   --     -       -
--      -          - - - --   -     -      -  -   - - -  - -   - -   - -  -   -    -- --  -    -   -
- - -  -  - ----            -    ----- - --  -     --  -        --     --  -   -   -     - --  -   -
- -    -         -     -  - --     -   -  -     -   -  - --   - -- -     --   --    -- --          -
--     -     -   --     -   - - -           -- -----   -     -      -   -  - -- ---   --- --      --
- --  --  -   --  - -- -  - --          --   --    -  ----   -- - - -  ----        - - -  -  --- - -
-- ---- --   - ---      - - - --  -- - ---     -- -         -                        -   -      -  -
- - -      -      - -  -   - - -      -  -   -    -  -- -  - -----       -- -         -      --  - -
--    - -    -  -       ---  -  - - --          --   - -     -    -  --    -- - - --    - - -   -  -
-    ---    - - - ---   -       -      -  - -    - -    -       -   --     - -     -  - -          -
-  -     -  -        -     --   -   -      -          - - --- -      -      -  - -- -     - --     -
-    -  - -          -  -        -- ----    -  --  -       --   - - - - -- -     - - --        -   -
--  -   -    -   --   --   -- -   --  --    -  ----      --  ---        - ---  --           -   - --
--    -- -        -  -- - -   -- -   - --      -  - -    -- - -- ----- -- -     -  --   -       -  -
--  -  - ---       -   - -  -     - -  --            -   - -   -  -      - -    --   -    -   -    -
-   -  -     -               -    --        -   -  -   -       -    -        -  -     - - --   -  --
-      -   --  --  -     - --  -   - -   ---  -        ---      --- - --   --- - -  --   ---    - --
-   --           - --    -  --    -           -- -  --  - -  ---        -     ---   - - -- - --- - -
--       ----- ---        - -    --     - - - - -     -   --            -           --- --   - - - -
--      -      -  - - -   - --           -- --      --    - -      - - -- -    -- -       -       --
- ---  -     - - -- -    -   - --    -- - --        -     -      -    -    - -      -  --  - - - - -
-   -            -             --  ---  -   -        - -   -  -- ---     -     ----          - -- --
-  -  -- -- --           -  --   - -  -       - -     --   -- -         -- -         -  -  - -     -
-   -- -  -        -    - -  --   -   -    -  -        -  -   - --   - -  -  - --           -      -
- --- -          -      - -- - -   - --   --       ---  --     ---  - --  ----      --  --  -      -
-      -  - --- -    -  -     -        --- -- - -- -- --  -- -         -          -        -       -
- - - -   -   -  -- - -  --   --   -     -  -        -  -      -- --  -   -  -- -  -   -  -  - - - -
- -       --  -  -- ---        -     - -  -    ---      - -         -  --    --    - --   - - -    -
- ---  - -  -      -     -- -   --   --     --  -   -   - -   - -     -    --    - -- -      -- -  -
--      --   -   -  -      -  --    - -    -  -   -    -    - - -     - --   -  -   -   -       -  -
-    ---       --  -             - -   -   --     -    -     -- -  -    -        -- --    -     -  -
---   - ---       - ----     ---        -  -  --  - -    -   -    -   -- - -    - -      -    --- --
-   -  -        --    -  ---     -     - -     -     -        -    --   -    -  --   ---- -  -     -
--  - -  -   ---  - --  -   - --   ---   -  -    -     - --        -   - -    --         --     -  -
-   -  -  -- - -       -  - -  - -  - -- -      -    -        -    -        ---  - - - -- -  - - - -
- - -  -    ---   -   - --     --     - --       - --     -    -  - -   -- -   -            - -    -
-  -           -  -    -  --         -    -  --     --  - -     - --   --        -- -       -   -  -
-  -  ---     -- - - -  -- - -   -  -      -  ---  -   --   - - --       -   --- -   --  -    - -- -
--       -   --   -   -  --              ----   -- - -- -- -    -  - -    -     -  -       - -  -- -
- -  - -         -  -      -      -     -   -  - -  - --   - - ---  - ---   -  -     --- -   --   --
- -     -- ---  -  -- -  -  ---    - - - -     -- - -    -   - -          - - - -  -   - -   -  -  -
--        - -  -     -  -    -     --    ---    -     ----  - - --    --         - - -   -     - - -
-- -  -   -- --  - - -  -    -    --    -  -  - -    -    -   -    --        --   -   ----     - - -
-- --  -              --    -  -  - - - ---- -    -         --  -   -  --      -  ---     - -   -  -
- -   -   --  -  - --   -- --   --  - - -    ---       -- - - -     -     -   -             --   - -
- - -         -- -   -- - --   - -   -  -   -     --    -  -  -  -  - - -   - --  -     -    -   - -
-   - --- ----   - - -  - -   ---     -    -  -- - - -   -  --     - -- -   -      -  --      -   --
--  - -           - - -      ---   - ---   ---   - -  -  --    -   - -- -                 --     - -
-  -- -  -     -    - -       -   -    - -        - - -       -      ---       -  -    --  --      -
---  -     -   - -- - -  - -- -      -         - -    --       --   -   -  -    -   - -   - -      -
-  -     -- - -- -  -  -   -    --  - -  -       -   -- -  - --  -    - -       -     --    ---   --
---  -   -  -   -  -  -- -  -    --- -  - -      - -  - -    -         - -- - -    - - -    --   - -
-    ---      -             - -    -   -     -     -  - -   -  -- -- - -  -            -  - -  -  --
-     -  - -   - - - -    -   -  ---          -     -    -   --   -  --        -  - --   --  -   - -
----------------------------------------------------------------------------------------------------
