100
100
----------------------------------------------------------------------------------------------------
-   -    -       - - --- --   --  - -  -         - -- - -- - -    -    --     -    - -----  -      -
-- -                        - -     - - -      - -    -- - -- -            -    --   ----- -  -    -
-     - -        -   --- -- -  - -        ----     -  - -  -      -  ----      --       - - -- --  -
-  -    --   --    --      -  -  -- -    --     -   -    - -    -  - - -  -   -  --  --   ----     -
- --      - -  -    ---  --  -  -- -   -    -  -  --- --    -  -- -    --     ---  -   - - ---   - -
--  - -   -     --              - - --       -     - ----  -  -- - -  -      -  - ---    --        -
- -      -     -  -   --   ---    - -    -       -                 -    - -  - -      -- -  -      -
--  - - --  -    -       - -  -- -   -   -- ----  -- - -  -- -        - -  - -    --    -  - -  -- -
-       - -     -      - -  -  -   --      -       ---   -       ----  -- -    --      - - -     ---
-   -  -  -- --  -     - -       - -  - -  --   --        -     - -    -  --- -    - -   -  -  -   -
-   -  -  -     -  - - -    -    --- - - -     -     -  -     - --    - --     - -    ---  --  --  -
-  -- - -   -           -- - --     -      -     -- -  --     -     -  --         - -  -  -- -   - -
-  -   -      -     --        - - -     -   - -  -   - -   - -  - - ---      - -     -        --   -
- -- -    - -   -     --  -    -     - -- -    -    -  - -     --  --     -  - --   -  - ---   - - -
-     - -       -      -      - --    -      -   - - -     -  -  -    -- - -  -      -     - --  - -
-   -  - - -    -  -  -       -   -  - - ---   -  --    -   -   -    -   - -     - - -  - -   ---  -
--             --    -        -- -       -   -    -      - -         -        -           ---    - -
--     --   - - - -  - ---- -    -    ---  -      -    -       -            --   -  --    -    -   -
-  - --- -       ---  -     - ---      -   -   -- -  -      - --  -  --   --- -       -   -       --
- -      - -       - --   -   - ---- -         -   - -   -  - - -- -     -    - --            -  - -
--  -   -- -  -   --   -  -- --  --   -  --     --- -  -  -       --  -         -  -          -   --
--     - -         - -- -   -    - -   - -  ---   -  --           - -        -    --   - -   -   - -
-    --      -- -  --      - - -   - - --   - ---- --  --- -    - - -- --  -  -   - --      -  -   -
-   -    -  -- - - --  -       ---    -  -  -     -         - --   --   --  - -  - -    -     - -  -
- - --   -          -    --    - -   --  - - -   - -- - - -  -     -  --     -  -   --   -       ---
--   -     -- - -   --   --    --     --   - ---        -      -   ---  -     -- - -  -  - -  --  --
-  - -       -    -  -- -      -    -    -     - --    -   -- --   -   -   -       -       -- --- --
-     -  --  -  -   - -- --    ---        -     -   -   -     -  -     - -   -        -         ----
-          -     -    -  ---- -   - -       -      -     - -   -   - - -      - -     -    --  -   -
-    -     -- -   -   -     --  -- -  --  - --- ---- - ---   -       -   -- --    -  -        -   --
-   -    -  -   - --            -         -  - - -  -    -  -  -  -    ---      -   -  - - - -   - -
- -       ---  -     - --- -  - --  -  --   -  -   -  - -    -  -        -      -          - --    -
- - -    -       -   - -            - -     - --     - -  --       -       -    - ---   -  --      -
-      - -  -   -   - - -  ---  -  -   ---    - ---     - - -        - -  ---  -   - -   --      - -
-- -  -- -    -   ---        -     - - -  -     -   -     --  -  -  -   -- -  -     -       -  -   -
-    -- --- -  -     ---  -      - -   -             --     -      -      -        -      -   -  - -
-      ---    --  -     -    - -  -  -    - -   -  - --   --  --           --- -   -- -     -    ---
-   ---   -- - - - - --- --  -   -       -- ---   -  -- - -          - --        ----  -- - -      -
- -  -         --  -     - -   - ----    -               - -    - -      --  -        -    -   -   -
--        - --       --    - --       -- -       --  -   --     -   --    - -  -  - -       -  --- -
-       - -    - -- - -- - -   ---       -     -       -     -- ---   - -    -    - --  -          -
- -   -  -  -----    - -    -   -- -- -    ---    -  -               - -   -  - -- -   -   -   - - -
--    -          -- ---   -- - -       ---- - -  - -     -      -     -     --- - -   -   -      ---
--   -  - -   - -     - --         -     -            -  -      -         - -    --   -   - -  --  -
-      -  - --   -  --  -- -  -       -    - -  -   - - -- --     - -   - --    -      -  -   --  --
-     -       -     - -  -     -   - -- --  -   -    -     -     -  - -    --   -   -  -  --- --   -
--  - -  -    --   -   --- - - -   - --        - ---     -   -  - - -  ---   - --   -         --   -
-   - --  - -     -- -       - --  - --  -  -        -  -         - -    --  - -- --    -         --
- - -  - -  -- -  --   -- - - - - -    -   -    -        -    - - -    --- -- -  -  -  -  -- - -  --
-   - - -     -  - -  - -    -  --      --     ---  -- - -    --   -       --- -        -    -   - -
-   --    --  -     - -   -   -   - -   -   ---  --      -  -- --    - -  -   -  - -     - -   -   -
- -   --       -   --   -   -       - --     -  -    -  -     -  --     --       - - -- -  -   -- --
- -         - --     -      - - -  -    -  - -  -       --          -  -- --  - ---        -   - - -
-   -- -    -   - - - -      -            -    -  -    - - -  -    -- -- --    -         -  -   -  -
-    -  -- -  -     -   - -   --   - -     - -      -- - -         -    -  -  - --- - -  - -   -   -
-  -- --          ---    --   -  -- --    --  ---  - -  -   - -- -    ----   -- -- -          -    -
-       - - -  -   -   -   - -  - - -  --       --   -  --   -   - -   -  -    -   -- - -  - -  -  -
- -  ---  -   - --  -   - - - -      -  --     -      -- - -  ----    --    - -      -  -      -   -
----   -     - --  -           -   -    -    -     -                    -   -  - --  - -   -       -
-   ----      -  -- -     -- - -    -     -   -     - -  ---     -- - -       --            -  - - -
- -       -  - -     --  -   --  -  - -- - -- -  - -   --- ---        -    -  -   -   - --  -   - --
-   -  - -  --   -  -    --  ---    -   -   - --   -   -  --     ----  -- -    -- -  - -- -  -  -- -
---   -- -        - -- - --      ---  - -  -- --  -   - -  --      - -- -  --    -  - -    -- -  ---
--  -   ---   -  -   - -    - --       - -  --  --  -  -      -  - -   - -- -       -     --- --   -
---   -        - -                -       - - -- - --    - ---    -  ----   - - -       -      --  -
--                 -     -  ---  -- ---     -     -  - -- -- -- --     -    -      --  -  -- -  - --
-- --   --  ---   -- - --     -     -   - -  -         - -      -   - -  -   --    -               -
--           -       -  -   -   - -   ----      - -  -   - -- - - - -     -  -   -- -- -          --
-  --    -    -- -  - - --  --   ---  -  - - --- ----       -     -  -- -  - -- --   -          -  -
--- - -   --   -     -      -   -    -  -   - -- -   - -  -- - -  -     -   -   - --   --    -    --
- -     -   -   -  -    -- ----  ---   -   - - - - ---  - -     -- -      --    -  - -- - -        -
-  -  -   -      - --          - -   -  -   -- -   -    --  - -      - -   -   --- -- - - -  -------
- -    -  --   -  - - ---     -   -   -  -    - --    -      - -  -    -- -      - -   ---  -  -   -
-   -   -       -  --- - - --  --     - -  -          - -    --       --  -  -     -  -     -     --
-   - -    - - --              - --    --      --- - -   --   -- - -  --- -  -  --      -  -   --  -
-    ---           --         -   -  -   - - -  - -  -            ----   - -   --  -  -         - --
-    -        --      -- -   -       -     -   - -   -  - -     -   - -  --   --    - - -- -     - -
-    -  -   - --  -   - -  -          -    ---  -  ----    - -     -  - - ---    -  - --    -  - ---
-   - -    -  -      - - -- -     --  ----   -    --  -    - - - -   -   -  -     - - ---  -    -  -
-      -     -   - -   --  - ---   -           -    -- -  -         --   - -     - -        ---- - -
-  --  -   -         --   - -  - -    - --  -    - -      --    -   -  -- -- --    - ---   - - --  -
--    - -       - - -       -    -  --  -  - --   - ----  ---     - -      --- -                -- -
--     -   - -- ----        - -- --  -   -  -     - -- --    - -  -- -    - -    --     -        - -
- --    --- -  - -     -    -  - -  -  -     --   --   -   --       -    --      --  -  -   - -  - -
--   ---     - --  --   -       -  -        --   -    ---- --   -     -    ---   --   - - - -    - -
-     - -  - -- --    -    -   - --   -  --  --  -   - -       -          --   - -    -        -   -
-  -  -     -  --  ----- -          -     -                 -   -   - - -       -    -       --    -
-   - -- --           --  -- -    - - ----          -  -       -        --- -   -             - - --
-  -  - -   - -  --   -         --  -- -     -     -  - -- -- - - - --          - -  --- -     -   -
-        -      -   -   - -     -  - -       --  -- --  -   - - - --       --- - -     -  - -   - --
-   - -    -   -  -- - -    -   -       -    -  -    ---     --- -- ----  -    -   -  - --  --     -
- ---        - --       --  -      - -  - -- - -     -  - -  --    -    -- - - -   -  --  - -  --- -
-    -  --   -- - -          -- -      -- - - -  -   -- -  -  --   -  -   - - -   -     -          -
-- ---   -    ---        -   -   -  -   -- -  -       -  -  -     - -           ---   -  -     -----
--    -    --     -   - -   -  - -   - -  ---            - -   - -     -   -   -      -- -   --  - -
- -      --- -  -            - ----  - -      -   -    -     -        -    --- -    --       - -  --
--             -    -     -   - -   --  - -    -               -----  -  -  --       -  --  -   -- -
-       -       - -   -      - -     -         - --    -             -      -      -     - -       -
----------------------------------------------------------------------------------------------------
