100
100
----------------------------------------------------------------------------------------------------
- -     -     - - - - -     --          - -     -  - - -               -       -  -           -- - -
-  - - -  --   - - -   -   --    -  -----   --            -  --  -    -  -   -      -      --    - -
- -  -   -         - - --- - -- -       -   -    -       -    -  -   -  -   - --   -      -      - -
-    -         -- - -  -   - - -    -      --  -    -- - -        --   - -   -        - --  - - - --
--  -   - -      -   -          -  -    - -- -  -   -      -  - --- ---               --   - -   - -
-  -  - -   ---    --    --     --  -  -           -- -  --        -   ---  ---   --- - -  --   - --
---      -  -   --         -     --   -   -- -       ----    -      - --  --  -  -- -- -    -     --
-  ---    -   -     -- -    -- --            --       -    -  -   - --  --     --  - -       ----  -
---  --- --  - -  -    --  - --  -   -           -   - ----   -    -       - --     -     - -  - ---
-  --      -  -          --    -   - -          - -            - --  -  -   -    -- ---     -- -  --
-- -  - - - -- - -     -         ---   ---   -  - -  -   -     -    --  - -       - - - ---  -  -  -
---   -    -   - - - -  --      -        -   ---  -  - -  -           -     -    -       -   -     -
--  -  -  -- - -  -    - - -     -  -    --      -         ---   - --    -  -  -   ---      --   ---
-  -  - -  -              -  --         -   --  - --        -  -  -   --    -  -    -  -  --    -  -
-   -    --    --      -  --- --  -  - - - -  -      -  - --        -           -      -    -      -
-----  -   -     -- -           -    -  - - -   -   -    -      -   --     - -----   -      - -- - -
-    -   ---   - - -----  --   -      -  -  --          ----    - -  --  -     -    -  - --        -
- -- -  -- -   - - -     -     - ------  -    - -   - -      - --  --  - -  -   ---   - -  - -  -  -
- -   -     --  - --         ---        -   - - --  -   --   -   -  - ------  -    --            - -
--    --  -  -         -       --- - ---  --   -- -- - -  -       -               - -        - --  -
- - -     -  -        -   - -    --                   - -   - - -  - -     - -   - -   - --  -   - -
-     --  ----      -- -- -     - - - -     -  -   -  -    -    --         ---          -  -  -    -
-   -   - -  --      - -      -  -  - ------     -   -      -- -      - ---     - ---  -- -  -   - -
- -  --  -     -  -  -  -  --     -    - - - --- - -    - --    -   ---           -            -   -
- -  -  -    -  - -         --  -   - - -     - - -   -        --               -  --    - -    -  -
-    -  -  -      -  -   -        -  -    --   - ---  -  --   --   - - -   -   -- -- - - - -     - -
--  -    - - -     --  -  - - - -- -  - - -   -         --  -           - --   -  -    -      - -  -
- -     -  - - -  -  -           -  -      - - -  ---  -   -  --  - - -- -  --      --    - - --  --
- - -     -    - --     ---  --  - - -    -     - -   - - -          --    -       -    -  -      --
-  -   -    - -     --  -     -- -  -  - -  -    -   --        --- -     -  -- - ---  -  --  ---   -
- -----  - - -   -     -    -  --    --   -     - -       --  - -             - -   -    -        --
- -  - -   -  -- --    -  -  -    -   -     -    --  --     - -  -     -- -   --    --   - - --    -
- -  -- -   -   -    -        -  -  -   --       -  -- -- -   - -   -    -    - --        --      --
-     - - - - --     -- -      --   -   - - -  -   -  - -  - -  - - -   - -       ----- --    -  ---
- -        -   --     -  -    --  -      -                --  --- - -  - -  -  - --    -     --  - -
--     ---   --         -        -         - -- -   -   -  -       - - -    -    - ----    --  -   -
-   --  -     -- - -  -   - --------- - -     -   - - --      ---   - ---     --       --  -- - -  -
- - --     - --         - --  -  -        -   - -   ---    --- - ---   -  - - --  - ---   --       -
- -             -- --- -              - ---- -       -       - -    - - -          -         -  -  -
-   - - -   -   -  -   - - - -   -         --   -           -        - -    -    - -  -   -  -  -  -
-     -     -  - -   -     - -     - -   -         -   - -  ---- -  -               -    -    -   --
-    ---                    -  -- -  - - -  --  -     ---    -       -         -      -      -- -  -
-   - --  -  -    -  - --    - -  -    -   -    - --   -    -  --  - -  -        -  - - -          -
-       - -- -       - -   - --  -      -   -  -         --  -  -    -    - - -     -  -- -- --    -
--  -   -    ---     - ---  -  -  - -  - -  --         - - -  -       - - ----       - -    - --   -
-       -   -      -  -   - -  -   -   - ---               --  - -- - --         - --   -     -  - -
-  -- - ---   -      --     ---   --   --    -- -    ---     - -      - -   - -     -             --
- -- --     -- - - -  -      - -  -     -  --     -    - --     -           -     - -  --    --  - -
-         - -    -- --     -    -      - - -   -  -  -         -  -- -   -    --  -  -   --   -    -
-    -       - --  - -     - -   --  - - --  -  - -       ---  - --  -    -     --   -    -  -     -
-    -- ---  - - --    -  -- ---         - --    - -   -  -  -----             - ----       -   -- -
-   -  - -      -  - - - -   ---    ----  --   ---    -  -  -    -      - --           - -   - - - -
-  -  -   -        -     --  -  --   --   - --   -          - ---    - --   -        -   ---   - ---
- -  -  -  - ---  -   --  --  -  -  -   --    -     -     -   --   -  -  ---  -    - --   -  -  -- -
--- - -  ---  -   --    - - -  -- -  -- -  --  - --   -      -         --    -     - - --  --  -  --
-   ---        -  - -   -- -- -   -- -    -  -    -  -     --   -   -  -    - - -   - --  -   -    -
-  -    - - -  -   -  -     - - - -  - -- ---  - -   - - -   -    -       -    -   --- - - ---   - -
-  - --  -      ----  -  -     - ---    -  --  - - - --     -  -       -    --             --   -  -
- -   --  -- -  -  -     -  -   -     --   -  - --  - ----     - -- - -- --- - --   -- - -    -   --
- -     - -    - - -   -   - -    --       -  --        --     -   -   -   - - --  - --  -   - -   -
-         -   -- --  -    - -- -    - -  ---    --  -  -  -  -   - -    -        -  -  -   -    -  -
- - -- - - -  -   -  -   --    --  --  --         - -- --    -   - -   - - -   --    -  - - -- -   -
-    -   - ---  -          -  - ---  --- --  -  --- - -     --- -   - -  - -     - -     --        -
- -       -   --   -   - -          -  -   - -        -- - -     -  -   - -     --   --    - -     -
--         - --    -   - -      -   - - -   -   -- -    - -   - -         - -     -        - -   - -
--        -   - -  -  -    - -    -    -    -- -  -   -     ---      -      - --   -  -- -  -  -   -
-  - - -  ---   --   -   --                   -    -  -  -       - - - -      -      --      - --  -
-- -   -      -   - -  --   -    --   --      -- --     - -  -   -      --       -  -    ---     ---
-             - --  -  -       -   ---          --    - --     -- ---          -         -    -    -
----      -      --           -   -         - --- -  -  - - -- - -   -    -  - -  --    -  -- --   -
-   --- -            -  - --      -- --- ---   --          -   -  --  -    -    -   ---- -      -  -
- - -   --- -  --       -   -       -  -    -      -  ---  - - -       - --- - -   -  -  - --     --
-  - --    --   -   - --- ----- ---  --  -    - ---  --   -   -- - -- - -       - -  -      -- - - -
--   -- --  -     -  - -    -      --   - - -  -  -   ---  -   -   -       -  -- ---   - -     --  -
-  -   - -- --      -- - - - -  - - -     -  -     -  --  --  - -- -     - -- ---   -- --  --    - -
---- -      - -   --  -  - --  -   -   -  -   --  - - - - - - -  --      --   -    -     -  -      -
-     --      -- -  --     - -  -  -  -  --        --       -  -    -           ---     -    -  - --
-  - -   -- - -  --      - -       -- ---   - -  - -- -      --    ----       -     -- -  - -   -- -
---   -        -     - ---     --    - ---     - -     -   - -  -     -   -  -  --- -- --     -  ---
-  -    - - -          - - -    ---- - -  ---    ---   ----  - --     -           -   -      --    -
-- -- - -        -  -       -   - -           - -  -          -   - -  -  - -   - - - -  -   - -- --
---    --      ---  ---   ---   - --   -    -- -   -    -- ---   -  -   ---      -   -  -  -       -
-  -        - -     --- ----   -   -    - --- - --    -            -     -  -     -- --   --   - - -
-    - -     -   --- -      ----    - -            -  - - --  -        -   - -         --    - -   -
- -  - - - --  -  - -  -- --- -- ----  - -- -    ---        -  - - - -   --- - --       -    -     -
- --          -             - --       -      --    --     -- -       --    -  -   -  -      -    --
--  ----   --      -   -     -            - - - -       -   -  --        --      -  --  - --  --   -
- -          - - - -   -      -  --  -     -    -   - -  -     -    -   -    -  -       --     -   -
--  --  - - -      -     -  -       -         -  -           --  -    -     ---  -  --  -  --   ----
-   -      -     - -  -  -       -  - -  -   -    -   --     -        -  -- -  -    -  -     -     -
-    --     -  -   -     ---         -   --        - -  --         -  --  - -     -- -   - -    -  -
- - -  - --   -   -   --   - -   -    -     -        - -       --   -   - --    - --        - - -- -
--      --   -       - - -  - - -    -    --     --    --     -    --    -   - -- -  -  --    -  - -
- --      --   - - -     ---- -  ---  -  -   -  -               -    - --  -      -       - -    - -
--    - -    -   -  --- -         -   --   - - - - -      --- -  ---  - - - -      -  -     -     --
- - ---   -    -       - -     --- - - -  -           --    -         -   -  --   -   -  -    -    -
- ---  - -          - -        -     - -  ----  --- -   -  -      - -         --  -    --- - - -   -
- -  -   -----     ---   --  - --    -          -  -      --       -  -      -   -    -  -   - - - -
----------------------------------------------------------------------------------------------------
