100
100
----------------------------------------------------------------------------------------------------
-          - - -    --  - -  --      -   - --    -    - -  -  -  -  --    -   - --  -          -   -
---   -   -   - ----   ---          -     -   --  --   - - -     -   -     -      -   - -  --   -  -
---       -   -  -  --     -  -       - --  --          - - -       - --   --  -----  -     - - -  -
---  - --- -   -      -      -  --   -    -- - -    --   - --      - -      -      -  - - - - -  ---
-     - -      --       -- - --      - -- --- -- -        -  --  - - - -   --    -              -  -
--  -     -    - - - -  -   -  -         - -   --   - -      - -     - -       --  -  -- -   -   ---
-    - -   --     -   -    - - -   -     -  --    -- - --       -  -            - -- -             -
-----        -   -      -  -     -  -   -       - - -  --     -     --    -     --    -  - --      -
------ - - - -    - -         --         - --  -        --   - - - - -  -   -     --    -    -     -
-----  --     - -- - -   -  -    -    - -   ---   - --   -  -  -  - -     -- -    ---     - -   -- -
-    -    -  ---    - -   --  - --             ---       - - - -     --             -    - - -     -
- --   -  -    - -  - - -          ----      -    -  -              - -     ------   -      -   ----
-  --  -   -- - -      -    - -  -     -       ----  -    -     -    -            - -     - ---    -
--- -    -  -   - -   - --  -      - -     -        -  -   - - -- --     --    -      --      -    -
-  -       -- -- --      -  -   -   --   --    - -                  -     -   -  -  - - ---- -     -
--                    --- --  - -     - -  -       -----   -  -- -      -   --   -  -        -  -  -
--   -  - -   -- - -  -      -    -       -  - -   -  -    ---   -  -   -   -- -      - -  --   - --
-        -  -             - -  -   - --- -       -       -       - -       - - -    - --     - - - -
- --   - - --    --   -  - -  -    -- -    -            -     -- - - - -    -- - -     - -  -  -  --
- - -   -       -   -   - -     -   - --    -            -        -    - - -- - -           --   - -
-    -      -   - -  - -          - -     --     - -  -    -  -   - - - -     -  -    - - - -- - - -
-   -   - --          - -  -  ---       --  - --  - -  - -- - ---   -  -  -  --- - -   -           -
-    -- --   -  --          --    -   -  -      -      --       -  -    -         --  - ---  -  -- -
-     --      -      --  --   - - -     -     ---- -   ---    - -    -  --     - -   -  -     - -  -
-  --  -         -         --- -     - -  -   - -  -   -   -  -   ----  - -   - -      - ----    - -
--       -     - - - --  --   -     -   -       --   --    -     -  - --  -   -  - -     -   -   - -
- -           - -   -  -     -       ---  - -     ---   - - --  -      --   -- -   -    - -  -     -
-  - - -        -   ---   -   -   -          -   - -  -   --  -       - - -  - -     -- --         -
--  -- -   --    -        -   - -    --    -- ---         -  --  -   -  --   ----  -- -        -   -
-            -  -      - -     - -     -     - -   -       -  ----   -- - -- -         -- --    - --
-        -- ---  - --    - -    -    - -  - -   --      - -   -- -    -   -     - -- -      -      -
---- - --   -  ---    --     - - -  --- -   - -    --     ---     -    -     -         -  -   --- --
---      - ----     -      --  -   -     -  -   -  -    - -  --- -  - ----    -     - -  -  - -  - -
-     -        -   --  - -    -- -- -----  -  -   -    -   -   -  - - -     --    --- ----   -   - -
-  -    -       -         - -- -    - -    - - -  -  -  --- -        -- -  -      - - -      --    -
--- -  --      - -   --     - -   -  -  --- - - --  -   - -- -                       -  -  - -     -
- - --- -   - -- -- - -                - --  -  - ----     -         ---  -    -- ----  -- - - -- --
-- -   -  --      -    --- -   -     -   -  - -- -      -    - -    -   -  - -- -  -     - - -- -  -
-- - - - -   -  -   - -   --    --   -   - -   -----  -    -    -   - -    --   --       -- -- -  --
-  -  -    -  - - -  - -    - -    -         --    --  -- - --  --      -          --- -  -- --    -
-  --        --         ---  -   -- - --  - -   -  -  -          --  - - - -  ----   -      -  -   -
--        -    -      --    -  -      - -    --- -  -    -    --   - - -    -   -  --  -  ----    --
-  -- -   -   -      -  -- -  - - -  -        -     -- -- -   ----- -- -    - -  -   - -       -   -
-      --   -- --    - -  - -    - -  - --  - - --   --            -    - -    ----- -       -    --
-  ---   -- - - -  -   ---    -   --      --    -      - - -   -           -  -        -   - -     -
-     ---       -  - -   - -  - -  -          - -  -- -     -- --          ---  -   -  --  -   -   -
- - --   -    --   -- -     -   --   -     -   - -     -- -  -- - - - - --   -   - -- --     -    --
-    --    -   - - -    -  -- -     -- -   - - -    -  -   --   --  -   - - -  -        - --      --
- - --  - --      -    -     - - - -     -   -- -     - - - - - -  -    -    -   --  -    -   ---  -
-     ------  - - -        -         - -  -         --  -   -   -          - --  -    -     - -  - -
-    -  - -       -     -    --  -   -- -     -        -     -     -   - -       -    - -- -    -  -
- -  ----       -   --     - -  - ---    -        -  - -   -  - -   -   -- -     - -        -   - --
--  -     -  -  --     --   - --    ---- -   - -   -   -       -     -    -   ---    --  - -    -  -
-     -  -   - -  ---   - -      --               - --      -   -  --             -  - -     --    -
---  -  --  - - -    - - -    --    -  -- - - -  -  -          --          -     - - --     -      -
--  - -   --  -   --      -  -     -      --    -     - -      -- -        - - -- -    -- -  -  -- -
- - --       - ---  -      -- -- - - -   - -      ----   -  - -           -  -       -    -- --    -
-   -      -  -- --  -  -    -    -              -  - --         --- -    -       --      - -  --  -
-   -- -  - -        -  - -       - -  ---    --   -   ---- -       -  - -  - -  -    -  - --      -
- -- - -- -   -- -  -  -  - - - - - --  -        - --- -   -   - -   -    -- -    -     --  -    ---
-    - - ---    --   -- -            --   - - -   - -  -- -          - --  - - -  -   - -   -  -  --
- - -     -       --     - - - - - -  -      -  -        -  -   -    -   -      ---   -    -   - - -
-   - --- -  - - -  - - --  -- -     - -            -  -    -      -   -    - - -    - --    -   ---
- -    - -- - -      -   - -    -- - -  -  -- -- -  --   ---     - - -   -      -- --- -      -    -
-   --  - - --   - -        -- -    -- - -      - --  -      -  -        -        - - -   - -- -- --
- - -  -     -     -    --  -   - -  -  -  ---  -  ---   -- -       -    -   --  -   -  -- --  -   -
- --        -    -  - -   -     - --     --  --- -  - - - -  - - -- -- -     -    -   -            -
--- --      - -  ----  -      - -  -  -   --  --    -   -  -     -   -   - -   -   -   -    -   -  -
--   -   - -- ---            --       -  --   -  -- - -  - -  -  -     -   -       -         - -   -
-  -   - - -      --     - -   -  --   - -- - - -     - - -       - - - -  -         -     -- ---  -
--- --   -- -   -   -            -         -- -- -      -        -  --  --         -     - --  - - -
-   ---  --- -   - -  -           -      -  --       -- -- -        - -  - - --    - - --   -     --
---              - --- -    --  - - --- -     -   -   - - -    -- -  - - -  --     --  -        - --
- -       - ---  -  -  -    - -  --      -  -   - -- --   -- -   -- -     - -  -  - - - -    -     -
-    - -- -- -       -  -  --  --    -  --    ---- -  -   -- -     - -- - -              - - - --  -
- -      - -  - - -  -    -   -  -- - -  - -            -         ---      -   ----  --     -   -  -
- - - -- - -     -  -    -  - -    - --   --  -  ---    -- -- -      -   - - -  - -      ---   --- -
-  -     -- -    --      - - -    - -      -        - --    -     -        - -  --   --      -    --
- -  -- -    -  - -        -   -    -   - - -   -- - -- --   -   ---    -   -- -    -    ---- -- - -
-- --    --    ---    -- --    -  -  -      -  -   -  -     --     - --           - - -   - -  -   -
-- -----   --      --   -  --  -- -       - - ----  -   - - -     -    ---   -  - -   -         ----
- - - -        --     -- -    -     -  -      - -   --  --- -   -    --  -          -        ---   -
-  - -- - -  - - -  - -   -- --  -  -    -      - -  -       -- -      - ----  -    -    --  -   ---
-   - -  - --       -               -- -  -  --  - --        --     - -    -  --     - -   --- - - -
- -     --  - - -     -   --  - ---    -    -         -       - - -     - -         --        -    -
---  -  -         - ---               -      -       -  -   -  -       -  - -- -     -  -  --- --  -
-  -  - ---        -  --      -             - -    --   - - -  -  - --  -      -      --      - - --
---        -  -      --  --  -  -      -         -     -       --  -- -  - --    -- -  -         - -
-      --  - -    -      -- ----    ----        ----  -    -    - --     - -    --  -     ---  --  -
-       -    --- -  -  -                --    -  -       - -  -- -   -- -    --- --  -  -- --   -  -
-  - -    -----   -  -  -    ---   -- --  - -- -- -    -       -   --    -            -      -     -
--       --   - ----   -  -     --  - --    - -  - -   - -     --     -  - -  -   --  - -  --   -  -
- --   -    - --         - -  -     - -   - -         --      -    - - -  --- --   -      -  -     -
-   -  - --      -  - ---      - -      --  ---       - -   --   - -  -  -     -    -  - -    -  - -
---       - -          -- -   -  --         - - -  -   --     - -     -    -- -  - --   -   -  -   -
-  -    -   -   -- -    --   - -   -        --    -    --  -   - -  -     -      -            -- - -
-    - --   ----  -- -    - - -   -         -   -     -      -   -  -   --      -  -   - -     --  -
-      -        - -      --   -  - -  -  -     -  -   - --  -   -   -  --    --   -- -    -   -    -
----------------------------------------------------------------------------------------------------
