100
100
----------------------------------------------------------------------------------------------------
-   -    -      -    - --         - -   -   -     - -     -  -       - -     -    - -    - -- -    -
----  -   -- -     - - - - -- -       --     --    -  --        - - -   --     -  -   - - -   -    -
- --- -   -     - - -  --  --- - - --  --       - --    -   -- --      -  -   -  --     -  -     - -
-          -  -    -   - -    --   -       -   -- - --       -  - -  ----   -  -    -        - -  --
--     -  -     ---  --    -    -    -           -      -   - -    --   ---   --             -     -
- -  - -     - --   - --    -    ---  - -               -   -  - -- -       -            -       - -
- -  -     --   -   --  - - --   --   -             -    - -         -        -  -       - --  --- -
- - -- -     - -   -        -  -  -    --    -   - --  --- -       -          -    --       ---  - -
--     -   - - --          -     -  --      - -     --- -      ---  -   --   - -     -      - --- --
- -   -- --     -  --    --  -        - -   - - -  -   -   -   --- --- -          - - - --   - - - -
-   -  ---     - - - -           -   --  --  -  --   - --        --       --    -       -   - --   -
- --      --     - -     -- --  --  - --             - -    --- --  - -     --  - -   -   -    - ---
-  - -        -- -   -  -  -          ---- -  - --  -             -    -  -- -- -     -      - --  -
--   -  - -   - - - -- --  -    - - -      --         - -      - -  - -- --    --     - -   -    ---
-  -  --            -- -  -    --    - -  -- -  --   -  - - -      --     -  -     -               -
- - - - ---        --   -    -       ---   - - - -  - - - -  -    --    -   - -     - - -   ---   --
-    -   -   -  -     - --   -  -- -   -     - -    --     - - --   -     -- - --  -    ---  --  - -
--  -  --      ----  -    -  --    --  -  -    - ----   - -   --  --- --- -   --                -  -
-    --  -   -- -     - - ---  -        - - -  - -   -   -  -   --- - -   -   -    -----  -  -   - -
- --      - --  -- - -       - - -- -       - -  -     -   - -          --  -  - -   -- -        - -
-    - - - -        -   - --   -  -   -   - - -     -  ---     --- - -  -    ----      -   -  - - --
-  -   -   -   -  - -     - -   -  - -   --   -- -      - -- -- ---     ----    -- -   --   - - -- -
- -  --    --  - --   -     -      -  -          -    - -- -  ---   -  -      -     --   --     -  -
-  --- - -    -   -    - -      --   -  - ---   -    - ----      -      --- - -- -          --     -
-- - - -   ---   - ---      - --  --  -  -  -   --    -    --- -    -              - -   -   -- -  -
-     - -         -     --  --- - -- --   --   - - -   ---  ---  -  - - --       --  -  --   - --  -
- - --     --   - - -- -             -      -  -- -    -  -  -    --  -    --   --        -- -  -  -
- - - -  -    -    --- -     -     -   - -  --      - --       - -   -    -     - -    ---  - -  - -
-- -     -  -- -      --  -            ---    - --  -    -  --     -    -   -        -  -  -- -  - -
-      --              - - -- - -     --     - -          --    -  -    -   - --  --   -- -   -    -
-       - --            - --     - -    -     -   --  - - --  - -- --          -  - --    -   -   --
-   -              -        - - -  -      -     -   - - -  - -- --  -  --            -- -   - -    -
- -  - -   -      -      -    -      -       -     -  ---- --     --     -- -- -   -     -    -  ---
--- -  -     ---      -    -   --- -  --                -      --    -       - - -    -     -   -  -
-     -- - -    -   -- --- -   -     -     -       - --    -- -  -    -  - - - -  ---- --  - - -  --
- --        -      -  -  -               -          -  -      -          -  - -     - ---- -  -  - -
- -    -   -  ----  --- - -- - -     -- -   -  --    -- -  ---    -  --    -- - - -        -  -    -
- -- - -    - -    -   ---- -   --  - --- --  -  ---           - -   -- - -  -    -   -        --  -
- - - - - -      ---- -  -  -       -- -      -      -- ---  -     -   -    -  - -    -    --  -   -
--     -      - --     --     -   - -      -     - - - --        ---     - --     - -     -     -  -
- ---   --- -       -  -          -     -        -  -              -  --  -   -- -             -   -
- - --       --  - -   - --  -     -- -   - -- -  - -       -   - -  ---   -   -- --     --   --   -
-   -     --    - -   -    --- - -     -- -- -  --        - -      -  -      - -- - - - -  --   - --
-    -    -    -- - -- -  -  - - --  -           -   - --- - -  --     -  -     -    -  -          -
-  -   -- - --    - -- --    -- -          -         - - - -  -    -  -      -     - --     -     --
-  -   -   -- -   -  -       - -      - -    - --     --   -- -   -   -  - - --- -      --- - -  - -
-- -  - - - - -    --  -   - -  --  ---    -      --       - - -  --     ----  --    -  -      -   -
-  --      - --  -          - -   --        -      -    --   -   -   - -           -   -  -   -    -
-    - -  --    -- - -   --- -  -    -    -       -- - - -    -  -     -  -  -   -- -          - - -
- ---   -  - - - -          - -    -   -- -     -      - -  - -   --  - -      -   ----  -   -     -
-   -                  -     - ----    -     --         -      -  -    --   - -  -  - - -          -
- -    -- --- - -  -  -   -- -    -  --  -  -   -   -- --- -- -   - - -  -              -- -    -- -
-  - --    ---          --     - - --   --  -- -     -    -     -- -  ----         -    -          -
-  --   --  --   -     --     - - --- -    -  -   - -  -    -    - --  -             --       -- - -
-     -   -  --    - -- -       -   -  -  -- -- - -- -  --           - - -  -  -          -  --  - -
- -  - ----     -      -      - -         ---      - -- -         - -  -    -    -       -      -  -
- - -          - -    -   - -   -    - --   -     - -    --   -           -    -   - -  -  -  --   -
-   -- - --   -     -   -      - --  -   ---  - -  - ---      -      - -          - -- -   -   - - -
--    - -- - -  -      -    - -  -         - -     -   - - - -  - -      -   --  -  -- --    - -- --
--- -    -     -  - - -  - -  - -        --  - -- -     --  -    - --     --     - - - -     -  - --
-       --  --    -    -     - -     --    ---  - -          --   -- - --   --  -- - -- --        --
-   -  -  - -   - -  -  --- -  ---  -   --  --     --   -          - -  -  -       --   - -   -- ---
--  --  -   - -   -- --  -   -  -   - -   - -     --     -  -  ---- -  -     -     -    -  --    - -
-   -    -  - -     -  -  - -- -  - -  - -- -     -- -- - - - - -    -   - --     -        -   -   -
-  --   ---   -     - - -  -   --    -- --  -      -   --  --    -  -      -- -  --       ----     -
-  - - - -    -- -  -   -    -  - --            -- ---    - ---  -    -   -    -  -  -    -     -  -
---  -     --   -  --    -- - -      -    -  ----  - -       - -  - -   --       --   -  ---  --   -
-     - -    -  -  -  -   -   - - -    -    -        -  -     -- -  -    - -- -  --- -       -   - -
-   -     --   --   -   - --   -   -   -   -  ---       -- --   -         - - --    -   - -  -    --
- --   - -    - - --         --  -   -  -- -    -     - -    -- - ---    -- --- -     -- -  - -- - -
-    -  - -  --     ---   -- --- -        -        -       -          --      - - -    -- - - --   -
- - - - -                - - -    - -    - -         -         --       --   -  -         -   -  - -
-  -      -      -   -   - - -  - - -  -   -  ----- -      -   -  -  -- --           -- - --   - - -
--    - -    -  -   -   -- -    -- -      --    - -    - -   -      -   --     --        --  --  - -
- -  - -   -   -  - -     -    -   - ----    - - - -   -  - -- -  -  -  -    -   - ---   - ----    -
-  -    -     -    -  - -    --    --    -          -    -   - - --         --   - -    -   ---  - -
--   -    - -      --     - -      - -      --           - -       -  -         -    -      -   -  -
-  -  -    - -        -        -  -   -  - -- -    - -       ---     - - -  - -  -      -- -     - -
-       -   --  - -  -   - -      -  - -   -  -     -    - -  - --     - -              -- -  -    -
-   -  - --    -- - --     -  --       -   -- -  - --    -           --    -        -  -  -        -
- -  - - - --  - -        -    -- -     -   - --       --   - -   --    --   -   - - -   - -  - - --
--        -           - --     --  -   -  - -- -  -     - -     -  -- -   -   -   -- -    -      - -
-  -  -     -   --  - -   --     -      -     -  -    ---- -- -  -  -        -  --    -   - ---    -
---  -  -- -     -  -    --       --     -- - -  -- -       -       - - - - -  -     -   -    - ----
- -       -   - - - -    -  - -     -   -    - - -  -    --- -              -  -  -    --- -   -   -
-  - -  -   - - --- - -- - -       -           -- - - -- - --            -- -   -- --        ----  -
-    -   --  --   -    - -        -   -      -  - - -- -   - - --- -    -  - - -   --   -- - -- -  -
- -    -- --         -     - -  -  -     - ----   -- - -     -   -   -- -   -  --     -            -
-     - --- - -  -  - -         -      -  -    --    -- --- -  --       - -         - - -   -  -   -
- -     - - --  --  -  -  - --   -      - -  -     -  -  -          - --  - -  - -  -  -       -- --
--  --   - --  -  -      -   - -        -- -  -    - - -     -   -           -       - - --  ----  -
--    --          - -      -   -      --      -     -- -   -   -  --  ----  -      - -- -      - - -
-   --   - - -  -     --- - -   -   - -   -- -- -    - --              --   -   -     -  ----  -  --
--  -  -------     - -     -- - - - -   - - ---      -     - --  ----  -  -     -   -- - -   - - - -
-    - -       -  - -       -   --   -- - -      -   -   -    -  --       -    -  -  - -     - - - -
- --  --   - - - -    --- - -  -  -   --     - --- -   -   - -  - - -        - -  -  -- -   - - - --
- --        - -  - -   -   -- -    -       -        -   -  -  - --       -            - --   ---   -
- --  - - --  -     -     -   - -    - -     ---  -       -      - -  -   -- --- -           -     -
----------------------------------------------------------------------------------------------------
