100
100
----------------------------------------------------------------------------------------------------
-  -  -         -  -         ---  --        -- --      - -  ---      -   --     ---  --   - -  - - -
---       -  -   --  -  - -       -   - - -  --   --  -    -       -   -   -    -    -    -       --
-  -   - -  - -- - -   ---   --  -   -               -   -   - - -- --  --  -- - - -- --   -    - --
-   ---   -  -      - -    --     ---  --       -  --   - -  -    --  --   -  -   -- --  - -    -- -
-  -    --- -  -- - -   -- - - -    -     -    - -  -  --     -- -      -- -  -        -- -     - --
-   -- -  -- -  -   - -  -       - -  ------ --       ---    -   --  -        -    - -   -     -- --
- -  -- -- -  - -     -   -  -   -- - -        -- -   -          -     - - ---  -     -    --    ---
-  --         -      - --     -  --   -        -     -  -   -   - - -         --       -    - -    -
-- -       - -  -     - -  ---    ---        -     - -    -          -- - --   - -  - -  -- -     --
- - --   --  - - - -      -  -          -       - -  -   - -  --  ---    -   ---- - -       - - -- -
-  -          --    -  -  -  -       --  - --  -  -     -     -  - --  --- -   -    - - -- --      -
- - - -  --   --  -   -     -  -- -     - -     --  - -   -          -    - --   --  --   -  -     -
-     -   -    -    - - ---      - - --    -    -  --   -   ----  --  ---- - -  -  -   - -   ---  --
--  -      - -  -        -   -  - -     - -   -     --      --  ----  -  ---       -      -  --    -
-    -     - --   --  ---  - -     -  - -  - -            --      - -- -     -      -    -  -     --
-- --   - - - -  -  -  -            --    -   -      ---       -      -   --     ------ - -   -    -
-    - - -- -     -- --   -             -    - -- - -  - - -   -- - --   -  - --        - --  --   -
-          -  -  -    - -- -  -  ----  - - ----   -- -- -    --  -  - -  --     -  --  --         --
- --       -         -   - -         --   -  --  -            -      -     -  -  ----     -     - --
-   -  -    - -      - -       -   -    -   - - --  - -     --   -    ---       --  -  --         --
---  -   --  -  - ----     -- -    ---             - - -      -   -- -   -  -   -      -   -- -    -
--   -- --        --       -    -  -   - --- --    -    -   -   -     -  -   ---  ---        -  -  -
-  -  -      --     -  -   - ---  -- -- -    -  -  -  --    -  -  -  - - --  -  -       -  -   -  --
-      - - -    - --   --     -         -- -  -   -  -         -   -   - --      - ----  --- --  - -
-  - - --       - -   - -  -  - -      -     -    --- --    -   --      - -    -   -   -           -
-  -      - - - -   --  ---  - - -   -  -        -  -- -    -      - ---          -   - -  - --  ---
-  - -  --   - -       --    -       - - -    ---  -    -   - -- -           -- - - - -  - -    -  -
-  -   - - -     - -            - -    -- --     - -- -      -     -           -     -   -  -      -
-   -   - --      -   -   -  --     - - -- - -  -   - -- - -  --    --   - -  -  - - -  -  - - - - -
-         - -----  -   -- --   - - -  -   -   - -- - -       -  --    --    --   -   ---  -     - --
--  -   - -  --     -    -  ---          --        - --   - - -    -  -  - -- -   - -  -     - -  --
-     --    --   --- --             --- -  -  ----    -         -      --   -   -  -    -  --  - - -
- -      -- --  -     -      - -    -     -    -   -    -  - ---   ---  - - -- -  ---      -- -    -
-    -- - -   -     -- -   -    -   --   --  -   --   -   -  -  -     -  -          -          --  -
- - -  - -   -- -  - --    ---   -     -   -    -      --    -    -    --    -     -    - -- -  -- -
-      - --  --     - -  -  -      -      - -   -        -       -  -   -   -   --  - --   -- - - --
-      -  -  -    -  -         -      -- -- ---  -  ---   - -   -   ----      ---    - - -    --  --
- --     --- --   -      -     - -- -- - -- -  ---           -   --   --   -             - -  -  - -
-     --           -       - -      - --     -      - -- -   ---- --           -   -   -     - -   -
-        -  --   - --     -   - - -  --  -    --  --       -     --   - --      -     - --     -- --
-- -  -      -  -- - -      - - - -     --  -     -  ---       -   -  -     --        -     - -    -
-   -          -     -- - - - - - --     -          - ---    ---   --   -       -  - - - - --  - - -
- - -               - - -  --  --    - - -   -  ---        -            -  --  -      --        -  -
-       --       -    -         -- -- --- - -  - -   - -  -  -   --       -        - -- ---  -   - -
-  --  -     -- --- -   --        -  -     - -   --  --  -     -- - -- --       -      -       --- -
-  - -- - -        -  -       -   -    -       --  - -   -      - --   -  - -    --  -  ---        -
-  - -    -  -  - - - - -   - --        - -      -  -     --    -  -     -- --  -  --      -  --   -
- -  -   -    - -  -- --    --    -   --   -  - - ---   -        - - -  -        -- --   -         -
- -- - -  - - - - -    ---- - -      - - -   --              -     --  - -    -   -      -   -  -- -
-  -   --          -- - -  -- -  - -- --  -            -  -   - --      - -   ---    --     - -    -
- -  ---  - -  - --          - - -  - -    --      --        -   -  -    -  -           -  --  -  --
-   - -  -      -                -     -          -  -  --  -    -   ---  -   - -   -  ---  - --   -
- - - -- -       - - - --  -      -       -   -            -  --  - -       --  -- - -   -      ----
-   -     ---   - -      - -   --  - -   -    -     --- -   --- -     -    -       - - -  -       --
-    -  -       - - -- -  --   -  -  -   -   -  --       -     -   -  - -  --    -  -      --- -   -
-       --          -  -    --   -   -     --     -   - --   --- -    - -    -- -   -   -  ----    -
- -    -   -  -   -        -    - -       -  -         - ---  -- --  -   -   -   -    --      -    -
--    ---- ---      -- -  - -  -  - -        --    -- -      - -      -   -   ---  - - - - -   -   -
-   -       --    --  -    -      -  --   -    -   --   -            -      -    - -  -      -  -  -
-       -- ---   -- - -- -     --   -        ----    --      -- - - ---   -  - -      -- -  --   - -
--     - --  -      - -  -   -- ---- --       --       -----  --  -    -   -- - ----    - - - -- - -
-- - -- -  --   -    -   -      -  -   -    -   -  - -   -               -       -           -  -  -
- -        - - -  -     -  - ---  -  --    -   -        -           -  -  - -   -    -   --      - -
--- -- - --      --  -   --     -   - -  - - - --    --    -    --  --   -  - - - ---  --    --  - -
- -          - -  -  --        - --    -- - -   -     -- -- ---- -    - - - --     -    - -   - - --
-       -----           - ---  -- ---    -  -     --      - -  -- -- -      -- - -- - -  - ----- - -
- - - -  --      -    ----        - --     - - -   -      -  ---     -     - -    - -            - -
--  - -    -    -- -         --  -   --- --    --         -- -  -     - -    -- - - --   - -  ---  -
- -      --  -      -     --       - -      -                ---   -  -  -       - -     -    - - --
-   -  -  -     ----   --    - ---  - - - -   -- - -  ---    - -  -       -       -   - -        - -
-  -  -     --   -       - -      -    ---   - -     -   -  - -  ---      -  -        --  - ---    -
--      --   ---    -      -  -  -- -        - - -       ---   -  - -- --  - --    --      -   -- --
-   -     - - - --     - -  -- ----         -     - --   --       -      --           -         -- -
-  -              -        -   -   -         -    -   - --    --   - -  -  - --    --       -- -   -
-- -- --   - - - --   -   -     -   -  -  -   -     -    - -      - -                 - -    -  -  -
- -    -   - - -  -- - -  -    -   -   - --    - - -   -  -     -     --  -   -    ---  -  -  - -  -
- - -   -     -   -     -    --    -  - -- -      -- - -     -     -    -  -   -      -  -- -  -  --
- --         -    -   - -       -- - -        -         -     - ---  ---    - - --- -- --       -  -
--   --     -- -  ---  -     - --  - -  - ----          -   -  -   -    -   -  -     --            -
- --  -- --  -      -  - -        -   -  -    -  -  - -   -      -      - -  -- - ---  - - - -- - --
- -- -  -   -  - - -  -   -- --      -    -- -     - -    -        -      -   -            -- -  - -
- -- - -   -  -- -- -      -         -  --    -  --- - --- - --  -      -   -  - - ---  -          -
- -- -- --    -  -      - --     --     -  -   ----  -    -  --  -  - --    -    -  - -        --- -
-   ---   -      - -  -     -    -      -   - --   -      --  - - -   - - -- -- -     ---    -     -
-- -     -- - -- --     --   -    ---     --  -   - -      - -  -  -    -      -           -    -- -
-    - - -  -  - -  ----        -   -- -          -  -   - - -     - -    -    - --  -   -    -- ---
-   -- --  --   -  - -- -  -            --- -  - -     - - --  - -   -  - -  - -     -      - - - --
-       -- - --   - -  -  -   - -  ----  --  -    -  -      -        -   - -  --   -    - - -  -   -
-      -      --- - -     - --    -   -  -- - - -   - - - - -   --       -     ----     - -  -    --
- - --     -   -   -   --   -     ----        -- -  - -- -   -            -- --  - - - -        -- -
- --- -        ----   -         --    -  ---       -  - - --     -- --     -  -- --  ---  - -- -   -
--         - -          -     -    -  --       -   -  - -  - - -- - -   -  - -      -  -   -   -   -
-  - -  -   -      -    - ---          --- ----  -   -  -  -         -     --   ---      -  -  -   -
--        -   -  - ---  - - -- - - -     -        -   - - - ---                -     - --   -  -   -
- -- -     - -   -     - -        - -  -    -      ----- -    -  ---   -- - -  -   -- -   -      ---
--  -   -       -  -         --       -   - -    - --   -   -   - --     -   -- -- -- -    -- -  - -
-         - -  -     - -  -   -  --  ----  -       -      - -- --  -   -    -    - -  - - -     -  -
- - ---    -  -   -  ---           -   - --  -      -      -    -         -   - --      -    -     -
----------------------------------------------------------------------------------------------------
