100
100
----------------------------------------------------------------------------------------------------
-      -   - - ----   -   -      - -   -    --  - -  -    -  -    -    -   - -  - --        - --   -
- --- -  --- --     -  -     -- -    -   -    -   - -   - -          - -     ---  -   -    -       -
-   - -   - -- -  -       -   -   -    -- --  -- - - -      -     - --       -           --  ---   -
-    -   - -    -        -         -  -   --  - ---- -      -   -  -     - -  -  - ---  -  -  ---  -
--  ---- - -           -   -    --    - -      -    -     --     --  -  - -  -    - -         ---  -
-  -        -  --  - ----  -        - -    -    -   -  - ---   -   - -   -  - -   -   - -  - -- -- -
--       --- -    -   -       --   - -- - -  --- -      -          -   - -- -   - -  -  -   -  -  --
--  - -     -     ---  -    - --          -    -- -   -      -  ----     - -       -  --  -  --  - -
-       -  -       ---        - -         --           -       -     -    -  ---    --   -         -
-     - - - - -      -     --  - -   - - -   -  -  -      - - -- --   -    - - -     - -  --  -    -
------- --        -                  -- --   - - -- --      -- ---   - -    -       -      -- -    -
-    --      -     -- --  --  -- --    -  - --    --- - --  -      -    --          -   -- - ---   -
-      -  -    -- -  -              --- -    - ---    -- -     - -   --- - --  -  --    ---  -     -
- -  -  -    --  ------    -   -            - -  - - - -    --  -  -         -   - -       -    -- -
- - ---   -  - -       -    - ---   -    -- -  -- - - -  -  --      -   -- -      -  --        -   -
-      --   -        -- - -       -      --     ---   -       -  -     --    -  -- - -        - -  -
-  - -- -    -  -   -   - -   -  -    - -  --  - --- -  - - --- -   -- -- - -   -   - -     - - -  -
-  -     -- -    -   - -  - -    -    -   -- - - - -     -----             -  --    -        -- - --
- -- - -        - -   -      - -    -  -  -  -  - -  - -     -       -  - - - - - - ----     - -   -
-   --     -      - -    -- -     -   - - - -  --  -    -   - -  ---  -         - -     -  -     - -
- --     -- --    - -    --      -- - -- -         -- -- - - -     - - --    - - - -     ---       -
- -- --  - -        -- -   --- -  -  - - -    -  -  -  - ----- --  -       -        -   -- --   -  -
-       --        -  --       -  -    -- - -   -   ---          - -   -     - - -- --- -       --  -
- ---- -     - --   -    - --   -      --    -        - -      ---        -  -- - --  -- -    - -  -
- -      - - - --  -      -       -    - -  -  ----  --   -   -           -   -    -  -  ---  -    -
-- - -  -   --  -     - - -   - --  -   - -  -- --               -   --   --- --  --  - - -   -    -
--  -   - -  --    -      - -- -   -- --    - -               -- ----    -  ----         -- --   - -
-    -   - -  - -  - -          --- -   - - -    - -- ----- - --   - - -  - --    -         - --   -
-  -  - -   - --  -  - -  ---      -  -- -           - - -  -    ---   ---   -  -- -  -  -     - - -
-- -    -     --    -   -     --   ---      -    ---   - -    - -   -   - - - -- - - -  -    -     -
-   -  --   -  -  -          -            --      -  -   ---    -   -- --         -- --    --  -----
- -   - - - --         - -  ----  ----        -       -   -   --    -- -- -  - -      - -- -      --
-   - ---      -   -    -       --      - -   -   --  - - --   -- -    -     - - - -   -       - - -
- -  - -   - -  - -     -      - - - --   -      -- -      -     --      --   -- -  --   -   - -   -
-  -  -      -        -        -           -     -- - - ---  -- -  -         -   -   -  -    -   - -
-   -- -   -     -  -       -- - -- -   - -      -   -      ---   -  - - --   --  -     -      -   -
- -              --     - - - -  -  -   ---    -    -  -- -   -  -  - -   -     -  -- -  -  -     --
-    --   - -  - -      -     -   -  - - - --      -  -      -    -    - --- --     -- -         - -
- -   -  -- --    ---   - -----      - --            -  - -    - - - - --   - -       -      ---   -
- -      --   -- -     -   - - -   - -       ----    -     --     -    -         -  -     --  - -  -
-    -   -  -- -    --   --   ---- - --     -        -   -        -    - - - --     -  -   -- -   --
---   -      -  -   ----  - ---        -          --    ---    -    -  - -   - - - - -- -    - -- --
--  -      - -    -        -   ---   -- - -  -- -    -       --- -  -     -   --    ---  -         -
-    -   -  -    - --      --   -      -    -- -  -  -- ---          --- -   --  --  -    - -  -- --
-  --- -   - - --  -  -       -  - --  -   -  ---      -  - -- -      -        -      - --    -    -
-    - -  -        -  - - -   -     --   -   -   - -  -  --     -       - -  - -  - -   -   --     -
- -   -  -     -- -   -              --- --   -  --            - - -   -   - -        - -    --- - -
-      -          --  --  -  -  -          -        -     -  - -      -            -       -   --  -
-    - -  -  --   -  -      - - -    - -          -    ---   - - --  - - - --  -   -  -      -     -
--  -  -  - - - -  -      - - -    -         -    - ----- - -                   -   - -   - -- -- --
-  - -  -     -- -- -     - --  --  - -    -      - -  - -    - -  -    ---  -   -   -  -   - -   --
---      - -               -    -          - -   - -   -- - - -   -  -- - -- ----  -  -    -  - -  -
-  - --         -    -- -    -   -- -  -- -      -   - - -   -   -   -- - -     - -     -     - - --
-   -- - - --   -  -- - -- -     -  -       --     -    -     -     -   -- ---     --   -  - - -   -
- --      --  - - - -  -- - -- - --   -- -- -    -   -- -    -  -               --      -    - - - -
-  --   -     -   --  -     --- -  --- -      - --     - -           --   -  - -   - - -   -  - -  -
---  --        -          -    ----  -  -   -  -   - -  -  -  --  - - -           -- -   -   --    -
-- - -    - --  - -   -   -  -     ---    - --- -    - - -     -  -         -     --   - -    - -  -
--   -- -       -   -   --     ---  -                --   - -    - -   ---  -    -       - - -     -
-          -- -- - --  -- -   -     - -  - -     -      - -    - --   -     -    -  -   -- --  -   -
-  - -- -- --        -    -   - -   --      -     -    --         -     -- - -    -         - --   -
- - --   -  -       - -        -       - - - -    -- -   --- -    - - - --  - - -    -    - - -   --
-- -  -    -      -   -           - --  ----  ---   -         -      ----   -         - - - -- -  --
- -  -      -   --     -    ---   - - -      - - -          ----       -           -       -     - -
--    -   -  -   -   -      -   -    --       -  - -            --- -- -       --    -      --- - --
-  --       - --         - -  --    - -   --      - - -   -    -   - - - -  -  - ---       -       -
- -   -   - -  -   -      - -  -      -  - - -    - - -   -    --- - -  -   -   --   -      -     --
-   --   -      - -   -     -   -  -       - -     -   -     -    --  --        -  - -   - - --    -
--     -   --  - -   --     -- - --    -- -     - - -     -----  -- -- -    --    -- -     -   - - -
-   -   -  -  -    -  -----   - -    --  - --     -- --    - - -  -  ---- --     -       ---    ----
--  - --       -- - -  -   -    - --     --     -  -   ---- -   -      --                  -- --   -
-   -   --    -   -     -- ---- -    - -  - -    -  ---   -   - -- -      -  -   -   -  --        --
-  -  -    -        - --       - -   - - --  -  -      -  --    -  -  -        -        -  -  --   -
- -      --       -    --   -       -         --   -- -      --  -     -  ---   - -   -  --       --
-      -            --  -   -   - -     --   -   -- -  -   -   --- --   --    --  - -    --- ---  --
-  - -- -   -         -        -- --         -  - -     --    -       - -  - --  -   - -      -    -
-     -     -             -    -     - ---    -   -    -       ---- ---- -   - --       -  -  -  ---
- -  -      --     -             -  -- -        -    -          -   -    -  --  - -  --      -     -
-  -  --      -- --     ---   -     -   --    ----  - -    -  -            -- --  - -         -   --
--  -  -   -       - -      - -  --    -         -  - -  -    -    -   -    --   - -               -
-  - -  --    -  - -    -   -    -   ---  -  - - --- -      - - - - -      -  -  - -  -            -
-   -  - -   -           - --     -  -     --  -  -           -  -   - ---  -  -    --  -  -  -   --
-      - -   -    -  -   --  - -       - --  -   -     - -       -   -     --     -   -- -    -    -
-- -- -   ---- -  -   --  - -      -  - -         -  -     - -   --- - - ---  - - -    -  - ------ -
-    --   --  --    --   ---- --  - - -  -- -          - -- - -    -  - -  - --   -     -- - -     -
--   -              --       --  -   --    - -  - - -  -  - - - - -       --   --     - -     - -  -
-- -    -  - -     - --    -  -- - -       -          -   - --  -  --   - -- -        -        -   -
-   --   -     ---  -  ---  --        -   - -  - -  -     -    --        -   - -  ------ ---    -  -
---   ---  -    -- -     -  -- --      --  -  -   ------     -  -   --- --              - -    -  --
-- - -  -     -     - - -  -  -     -    -- -          -   -     -   - --   - -   -  --  -    - -  -
-   - -  -    -   --      - --- - -  -  -  - - -- - - -     - --   -  -      - - -   -  -       - --
--- -    -   -      ----         -   -- -- -      -   - -- -- - -    -  ---- -- -  - -    --    -  -
-  - --   - -- --  -      --       -     -   -   -   --  -      -          - - -- -        - ----  -
- - --  --  -  -    -  -   -  -   -  -- -  -   ---    --  --- --- -     --  - -     - -- -   ----  -
-       -   -     - --   - ---   - --- -  -  - -  - -        - -  -  -  -    ---- - - -      ----  -
--  -  -    -  -  -- -    -    ---   - - -   -- -   -  - -  -         -  --         -     -- -  -  -
-        --  - -   -    ---     -       --     -  - -   -   - -  -   -- -     - - -    -      -    -
-   - -         -   -  -    -    -   -     - -  -   - -    -    -     -    -    - -        - -- -  -
----------------------------------------------------------------------------------------------------
