100
100
----------------------------------------------------------------------------------------------------
-               - -           -   -    - -   -  -       - -  -   ---      -   -   - -  -  -  - -   -
-      - -    --         -   -  -      -    -  - -- - -     - - -    - --   --      - -  - -     - -
-  - -     --   --  -- --   -   - -  -  -    ---   -     -- -    ---         -   -   -            --
- - -   --- --  --  -   -   -- -   -   -   -     ---     --  -       -  ----- -    --      -  ---  -
-    -         -   - -    -      -   -   -    -  -- - - -   --  - -   -    -      -   --     -   ---
- - - --  - -   -  -   ---  -   -   -    -   -    -  - - -     -   - - ---  -   - --   -   - --    -
-  -   - -  -  --- -     -   -   -      -       -     - -  -- -    - -      -     --    - -- -    --
--      -         - --     -  - -  -  - - -   -   -  -- - --     - -   -    - -- -    ---  - -     -
-      -   -  - - --  --    -    -          - -- --    -     -          --              -    -- -- -
-      --     -     -- - - - -- - -- -    -  - -   -  -  -  -      ----  - - -   -        -    -  --
-    -     -  -   -  -    -    -- -         --        - - - -  -  -            - -    - -    --  - -
- -  -   -   -   -  -  - -      -  - -   - -            - -  ---   --      -      -        -  --  --
- -          -    -- -- - --  ---  -  -        -      -        --   - --   - --       -- -- --     -
- -      -  -  -   -- --   - -     - -   -- - - - - -   -- -   - ---    -  ---  -  -- -  -  -  - - -
-   -         - ---  --   - - - -   --    ---   -     -  - - -  -   --   -  --  -        - -- -- - -
-  - -- --   -         -     -   - -     -  - -  -     -  -   --  -  -  -   -- - --        -- -- - -
---     - --     -- -  - ---  --  -       -  --  -  --    - --    - -         -    - -     --     --
-  -  -- -  - --      -  --  ---   -    -        --   - -  -    -       -      ----  -  -      - - -
-   - - -    -   - --   -   -  - --   - --  - -           - -- -  -    -  - - --   -  -   -    -   -
- -          ---       - --   ---- ---   -    -   -       -   - ----- -  - ---   -- -  -   -    -  -
--   - ---  -  - -      - - --       -    ---  -  -- -         -  - -- -  -   -- -   -   - -       -
-         - -    - - -       --  -     -      -     -    -       -        - --  - ---   -   -- -   -
-- -- - --       -  -  -    - -       -             - -  -- -    -   --   -  --           - - - -  -
-   -       - - -     -  --      -       -     - ----    - ----  - -- - -  -       - -     -     ---
-        -- - - -          -   - - - -   -- --- -  -   -- -     --     - - --   --      - -        -
- -- -  -    -  -  - -  --   -   - -   -    - -     -    - - -  - -  - -- -    -   - -  - -   ---  -
--      -       ---   -     -  -  --  -    -    - -    --     --   --       -  -       - ---   - - -
-- -- -   - -    -   -       ----    -  -          -            --    -    --     -    -  -    --  -
-          - - -- ---  -- - -   --- - -  - -  -   - - --  -  - -   - -  -  --   - -   - - - -    - -
-           - -       - - -    -   -    -     -  ---         -  - ---   - -  - - - -  -       -  - -
--    --- -   ----       -   -  -   - -----       -    -  --   -    -        --  -    -    - - -   -
- -     -    - -  -  -   -       --         -   --   -----    --    -     --         -   -  -   -  -
-     --  - - -  -       -  --        - ----  - --   -    ---            -- -  - -  - --- ----     -
-   -   ---- -  - -   - - - -       -  -     -   -   -  --   - - -   -     --   --              ----
-     -    - - - - -   --   -  -    -     - -  - -- -             - -    -         -   -   - ---   -
--     -     -  -  -                   --    --  - -    ---  - --  -      - -   - --     --        -
-  -    - --  -  ---   - --  -   ---            --    - - -   ---  -- -   -      - - ---   - - -   -
-  -   -      --  - - --   -  - - -   ---  -  -- -              --    --     -      --   -   -  -  -
--  --   -   --    ---    -      - -      -    - -       - - ---  -     -- -   -       -     -   - -
- -  -   -          --  -      -    ---  --- -  - -  - - -     -  - -             --   -     - --- -
-  - --   --  --   -  -  -  -   -        -    ---      --  -      -  -      -  -  --  - -- -       -
- -        -- - --  -  --   -        -    - -     - -   - --  -     -   ---   --      -- --  - - ---
-- -  -       -   -   -    -  -             - --   -   -  --         -      - - -      - -     -   -
--   -  - -   --   -    -     -- --   -   --      -- -    - -      - -  -   -    -  --  - -      - -
-    - -  -  -    -       -       -   -        -        - - - - ----   --  - --   --     -  - - -  -
-   -  -- -  -     - -  -   --   ----- --    -     -   -- - -   -- -       -   -- -  --   -   -    -
- --     -- - ---- - -     -    -    -   -   -- -    -  -         -  -  -- -    -   - -        - ---
---  -  -   --     -   - -   - -     - -  - -   ---   -    - -              -  - -  - -      -     -
-  -      -        - ---       - -         -- -       -  -    -     -  - - -  - - ---- -      -    -
-- -- -       -     -   -          -     - --     -  -  -   --     --- - -   - --  - -  --   - --- -
-      - -   -      -  -  -----      --  -       --   -   - -    -    -   -             --         -
--  -    --- - - - - -          - -    -    -    -  -     -- -    --  -   - -   - -   -    - -   ---
-   -                -- -      -         - -  -    - -         --   - -- -- -   -   ---- -  -      -
--  -    ---  -   - - --     --- - -- - -     ---  -      - --   -    - - - ---   --     -   -    --
-  --  --       - -   - ---- -    -      -  -       --  -   ----- -   --  --    - -         -- -  --
-  -     -  -  -     -  -  -      - --     -          --      - -  - ---      -- -  -   -----    - -
-         -   ---  -      -   - - -   ---          - -     -          - ---   -      - -     -- -  -
-  ---    --            -  -    -   -    -        -  -- -  - -       -   -- -- -   -  - - -  -     -
-   -- -    -   ---  - -  -    --   - -  -    - --         -  -  -       -- - -- --       - -  - ---
-   -       -   - -  -- --     --- - -     -  - -- -      - -     ------ --  -      -  - -   - -  --
- - -    --     -- -      ----   -   --   - -   -    -  -    -  -      -    -- --             -  - -
-   -      -  -    ---  --   -- -   -  -  -----   --       - -     -    -  -  - -      -  -- -   - -
--      -- -- -   -   ---       -     --   -   - - -   - --      - -     -    -  - -    --   -  -  -
-   - -   -       -    -    --    -   -     -        -  - - -       -- -    - ---    -  --- --     -
- - -- -    -  -  -  ----    -      -   - -    -   --    -      --  -       -  -  -   -    - -  -  -
--  -      - --      - -   - -  - - -    -  -   - -     -  -  -- -   --   --  -      - - -  - -  - -
-    ---      - - -  -     -   -     - - - -   - -  -       -  -      - -  -- --    -  --  --     --
-- -  - -          - -  ---   -  -       -   ---   - -     -    -      - -     -   -  -     -  --- -
-   - -    - --  -  -   -   -   -   -       - -  -  -  - ---  -     -     --   - - -   -    ---   --
-   - -   - --             --   - -    -- -     -    -       -   - --   --- -     - --             -
-- - - -  -- - -- - -   -         --    -- -  - -- -   -  -     - -        --      -  ---  - --    -
-  -    -  -        -       - ---- -  -   - -- -   --        -       - -   - - -   - - - - ----    -
-  --  - -   - -  ----      --  - -  -  ---  -   -   -  --- -- --- --  --  -      --     -  -      -
-   - -   -- -        -- - -   -  -  -   - -  --   - -    - - -   -        - --  - - -   -    -    -
-   -   -  ---- ----       -- -      - - -     -   -      -   --   --  - - - -     -  -  -  ---   --
- -    - --  -    -  --              - - - --      ---    -  -        --  - -  - - ---- -  - --    -
-   ---- -  -- -  ---          -   -   -  --    -     -          ----   - - ---  -- -   -- --  --- -
-    -  -  -  -       -  --  -    -  -- -   -     - - - - - - -       --   -  -   --     -  ---   --
- -   ---   - - - ---      -        ---- -  -- -       - -  - - -   - -     -    -      -      - - -
- - - -        -   - - - -- -  -- -    --      -  - - - - -   -----        --  -    -  -  -      - -
---   --     --   -  -  -     ---  - -  - - -   - -    - -   -        --- -- -  ----  --     --  - -
-       -    --   -     - -  -       -      -   - -    -- --     --        ---    -     -  - - -  --
- -- -- - - -  -        - -  --  - -     - -   -   -  -     -     --- -          -      --      -  -
-  - --        - -      - - - -       - -  -  -  - -    - -  --    -----  -   - -  -   -- -- -     -
-  -  -  -  --  -  -  - - - -       - -   --    -       -   - -         -     - - - --  -     -  - -
--   -              -      - - -    -           -   - - ---  - - -   --      -    -    -  -  -     -
- -      ----- - -       - - - -  -          -  --  -      -  -      -           - - --  ---   -   -
- --    -    -  -  -   -  - - - -      - -     - -   -  --   - -   -- -    - -   - - --   - - -    -
-          -     --     --  -   -      -       -- -        -     --      -     -    -- -    - -  - -
-   ---   -        - --- -   - -   -     --- -     - -  -      - - -   --    - --           - -   --
- -             - -- --  --      --   -   -       ---  - -  -  -- -  -- -  -       - --  -  --    --
- - ---  ---  --   -- -       --  - - -  - ---          -- - - -        -     - -      -- - -    - -
- -   -  -  -         ---  - -   - -   -   - - - - - - - -      --     --        -  - --      -    -
-    -  -     -  -   -      -  ---- -- -      - -   -        - - - -  -   -    - -   - ---    --   -
-  --        -   -      -    -  -    ---  -       - -   - -             -     -     - -   - -    - -
-  - - - -   -  -  - -   -    - -- -   - - --     -   --  -        -- - --  --   - -    --  -  -   -
-   - -    -  --  -     - --   -    - -   - --  -   -- -  - -  -     -            -- -    --   --  -
- -       - -    -    -  -   -    --  - - - -   -   -        - -    -   - -   - -    - - -  -  -   -
----------------------------------------------------------------------------------------------------
