100
100
----------------------------------------------------------------------------------------------------
-  -    --  -   - -           -     -     - -  - ---   - - ----    --   -            -   -      -  -
---        - -       -  - -- -    -  -      -   -    - -   - -             -   - -   -  --- -- -   -
-          - -    --    -     -  - --  -   -   -  - --   -     --      -  - -       -- - --- - -   -
-        -- - -     --    --      - - -       -  -   -      --   - - -            -  - -      - - --
-    -  - - - -  -    -   -    -- -    - -- --      - - --  -    -   -     - -  -  -    -- -  - -- -
-- -     -  - --    - - - --    -- -   -     -   -  -- - --     -    - --  -   - -    --  - -  -   -
-   - -       -  -    -- -   --     -  - ---               --        - -  -     --  ---- --  -  -- -
-  - - - -    -   --    - --  -     --   -   -         -       -  ---   -  - --   --    - - - -    -
-      -  ---- --- -       - -  - -      - --  -- - -   -      -      -  --     -   -   --  -- - - -
--  -      -     -      --       --- - -- -- - -       ---        -     -   --    --  -      - - - -
- -  - - -   -   -   -    -   - -  -  - -   -    --         -  - -- -   - - - --     - ---  -   -  -
-  - -  - --  - - -   -     -   --   -  ---   - -- --      -   - -  - --   -      -- - -    -   -  -
-     --   --   -   -   - -     -     --    -      ----       - -   - -          -    -  -         -
--   -  --   -  -- -  --   -- -   --  ---               -      ----         - ---  - -     -  - - --
-  -- - -  --   -   --- --- -   -    - - -   --  ---- -   - --  ---       -- -   -   -   -- -  -   -
- - - - -  - -    --   -         -  -   - -   -     --- -   - -   -          ---     - -    -   ----
-      -  -  --    -    - - --- --  -   -       - -    -   -  - -- -- -  -      -- -       -  -  - -
- ----      - --   -  --  -  -     -      -    - -- ---- -     - - -   -       -      -- - -   -   -
-  --  -  -      -  -          -- -  - -    -- -                 -        --     --- - -      --   -
--   - -       - --          --     -           -     - -    --   -  -       - -   - - - -  -  - - -
-       - -- -   -  -- -  - --  -       -  ----    --     ---  - ----    --   -   -         -      -
-  -   --      --   -     -      -        -     -   -  ---    -  -     --   -   -    -    --  - -- -
- - --  - -     -          -  -    - - -         --   -       --  - --- -   -     -- -- -  -     - -
- - -   - - -  -    -    - --  -     -  - --  -    -  -- -   - - -- - -   - - - -    -  -  -- --   -
-  -  -     -    - - - -  - -  - -   ---       -   -  - -   -    --     -      -- -     -  -   - - -
-- - -   - - --        -         - -      -     -  - - -  -    -  -  -  - -- --  ---- - -  ----    -
--      - -- -  - --- -          - -- - -   - -- -      -  - - ----   -        --     - -- -       -
- --  -   -   -   -    ---     -  -  -- -   - ---   --   -          -     -   -    -  -  -  --  - --
- -   -  -       -    -- -  -- -  --      -        --      --   -- - --    - - --         -  - - - -
- --     --         -     - --   -     - -  -- -  -  -    -        - - -      - -    -     -    -  -
-  - -- - - --  ---   -   -  ---               -   - - --   - -    -      ---    -   -----     -  --
-   -  --  - -           -     - -  - --  --   - -- -  ---- -     - -  -    -   -  -  --       -   -
-  --      --            -- --    --      --     - -    - -   ---   -  -  - - -  -      -         --
- - -- - - -- - -- -   -     -  -  ---- -        --   -        - ---   -    --   - -  - - -  -     -
-   -   -- -  - -       - -       -- -   -              -       -  --   -  - -- - --       - -     -
-- -- -   -     - - - -  -    --                 --  ---      - ---- -    -  -  - -    -      --  --
- - -        -     -  -  -  ---- -- - - -      ---   -  ---  - -       -   -    -    -  - -     -- -
- -     -   -- - -  -    ---  -           - - - -   ---    -  - - -- -  -  -          -    --     --
-      -    --  -  - - - -  -  --   -        -  - -  -       --    --     -    --    - -   -  ---  -
-   ---   ---- -       -  -    ---- -      - --  -     -     -- --   - -   --        -----   -    --
-  -   -  -   - -- -   - -- -     --   - -- -        -    - -        -        ---   -  - ---  -    -
---    -   -- -       -    -     -  -    -     - --    -  -----  ---   - -        -   -   --     - -
--  -     -   -  --- - - -   -        - -    -   - -- - -- - -   -     -  -   -- -- -    -   -     -
-    -       - -- -- - --          -    -      --       - - -     --    - -   -      ---  -     ----
--  -- -       - -    -   -  -    -  - -  - ---  - -- --- - -     - ---    -      - -   - --  -    -
-- -  -    ---    ---- -     -  - - -- ----         -  -  - -- - --    -  -  --    - ----  -     - -
-    -   -  - ---     -        -      -   -   - -    -  - -    -         -- --   -      - ---    - -
-- -      --   -   -----  --- -  -     -   - -  -  - --   -- ---  - ---    -  --  -  --- -  - - - --
-    -      -  - - - --        - - -      -     -- - -         -   -    -- - -   -       -   - -   -
- - - - -    - - -  - - -       -  --  -  - - -  -- --- - --   ---    - -    - -  -- - --          -
- -    -    - -                   -  -  -         -- -  - --  - -  - --  --   - -    -        -  - -
- -  - -    - - - -- - -   --  -     -   --    -   -           - -   -- - -  - -  --  -  -     -   -
-     - - -         --        - -       -  ---       --  - - -  -  -     -   -  -      - -  - - -  -
-     - -  --- --- -- -      -    -      -        --   -       -    -    --   -      - -    ---    -
--  -          -  - - --  -- -    -     - -  - - -    -      -       -    -  --           -        -
-    -   - --    ---  --    -   -         -    - - --   --     -          --         -     ---- -- -
-  -    -               - --  -        -  - -- - -     -    --   --  --      ---   -   -       -  --
- -  --   - ---   --   -    -   ---  -    --         -          -  -- - --    -- -   - -    ----   -
-  -       -     -  -   -  -    - -  -   -    --- -      --         --   -    --   --- - -  -  -   -
- -   - - -    -  --  - - - - - - - - -   --    --  --  -- --  -    -       --  -    - - -    --   -
--- -   --   -   -   -    ---    - -  -         - -     -       --    -   --    -  - -          -- -
-    -       --       --- - - ----                - -   ---    -  -  -   ---  --      - ---   --   -
--        -     -   -                     -  -     - - - -    -    - -  -   - -     -- --- -       -
-  - -   -    -   -     --   -   -    -     -  -   --- -- -     - -   -   - -- -- -  - -   --   -  -
--   -          -   -            -    --  -  --       --        --  - --  -  - -- -- --      --  - -
- -           --        --- -  ---       --    - -- -  - - -  -- - -- -- -  - -    -     -- -      -
-      -     - - --           -       -   --  - -  - -  -  -  - --  - -   --   -  -  -        - -  -
-- -          - -     - - -  --      -  -  - -   --   --  -  --     --   -  -  -- -  - -  -   -    -
-     - -    - -- -     -          - --  - - -    -  -   - -    ---   - -       -  -- -    -   -   -
- -  - - -     -     -     -     -       - - -  -   -   -  --       - --- -    -  -     - --     - -
-  --   - --     --      - - - --   -- -  ---   -  -    - - --     -  -  -    -   -  - -- - -    - -
- -    - -   - --   ------ -   -  -   -    -- -- -    - -   -  --- -  -   ----  -         --       -
-  --- -    -- - --   -    - - -  -  -         --     -      -   -  - --  -  -      ---    ---     -
--        - -- - -     - -      - -          -     - -   -     -   -     - - -    -   -- -- - --   -
-    --- -   - - -        -  -  -- -    --  -           -    --- - -      - --   - -   --        - -
-  -  -   - -  -   - -  -- -  -- -  -     - -- -   - --        - -    -- -     - -  ---  -     --  -
--   - - --    -   --- -    -- -         - -        -  -- --      -   - - ---      -      - -    - -
--      ---    -      -    -   --   -  -- - -- -    -       -- -   - -  -     -      -- - -        -
-- -  - -  - -          --   -   - - -  - -      ---       -   ---   -   -    - -    -             -
-  --   - -   -- -- -- - -  - -            - -   - -     -- - - -       - --- -  --    - --  --    -
-- --   -   -   -      -     ---     -          -       -     -- - -- --  -  -            -  - -   -
-  -     -       - ---- -  -       --  - - -      --  - - -  -      -    -      -  --       -  -  --
-  --              -    - -              --  -- -        -- --       -    -   --         -- - --  --
--    -  -    -  -  --  --- --     - -         -  --  --       -   -   --     -  ----       -  --  -
- -    - -   -        --   -         - -   -       - -  -  --  -         - -  - - -  -  --  --  - --
--               -----  - -   -    -- -   - - ---- -    -    - - -     - -   -   -         -      --
-  -    -     --  -- - --- --    - ---    -    -   -  -- -- -       -  -  -   --  -        -- -    -
--   - -  -    -  - - -  -   -        -      -  -  - -          -    -   -    --    - -  - --   -  -
- - -        --     -   -  -  --- -- -                      -  -   -- - -  -     ---   -  -     -  -
-- -  -  - -  -- --    -  - - ---  --  -- -   -  -                          -     - - -  - --   ----
- - -    -    --         -    --  ---  - - -  -   -    -      - -   -     -             -     ---  -
-      -  --       -   -   -   -- -  - -     -    --            -    -    --   -    --  -        ---
----   -  ---   -   - --   - -  -  -- - - -           ---    -  - - -      - -        - - -    -  --
-     -       -        -  -           - - -       - --  - -  -  -      --       - - - -  -     - - -
---   -  -   -  -  - --  -  ---   ---    -  --  -   -  ----    - - - -  -    - - - -   - -  -- - ---
- -   - --  -   -   -  -                           - - -  -  -  -  - --  - ---      - ----    --   -
-  -    --        --- - --    ---        --  -      ---   --   - -      -  -  -- -         -- -    -
-    -     -- --    -       -     -              - -   -   - --  -- -  - - ---    -                -
----------------------------------------------------------------------------------------------------
