100
100
----------------------------------------------------------------------------------------------------
-          -   -  ---   -   -  -       - - - --    -    -         -              - --      -  - -  -
--- -- - --    ---            - -- - - - -     -    --         - -  - -   -  --    - -- -   - - -- -
- - -   -       --- -    - --   -      -   --       -- -     - - - - -           -    - -    - -   -
-- -- --         - -  ---        --  -  -   -       -- -       --   --- -- - - - - -        --    --
-- -  ---    - -  -  -  -     -    - - -       -  -     -     --   -   -   --         -   - -   - --
- - -       ----  -  -      -  --   -      --   -- -  - -- -       -    -- - - -  -  - -  -    -   -
-      - --       --  --           -           -     -    -       - ---    -- -    -- -     --     -
-    - -- --    -     - -     ----  --        -      -     -  - -        -    -  --    - --      - -
- -               -         - - -    -      - -          -    -  - - -- - -    -   -  - - -  -   - -
- -- -    --    --- -  - --  --    -   --   -   -   -  --  -    -  - - --          -       -       -
- - -        -       -    --   -   -     -      --   -             ---    - - --  -      -  -      -
- - -    -     -   -   -   -  --       -  - - ---      --   -  -- - -  -  --    - -    - -     - - -
-  -  -    -- -           -  -           - -         -   --   -  -   - ---     -         ---     - -
-   - -- -    - --     -    -     -    -- --- --   - -        --     --  -  -         -         -  -
-- -     --      - -     - - -  -    - ---     - -  -   -   -     - -  --    -  --  - -      - - - -
-  -     -   - -   -        -  -   --     --- --  -  --          -  -         -  -   -  -  -       -
-  -   -   --  ---  -   - - -   -  -         -  ---    - --- -     - - -  -     --       - --    - -
-  -   -- --  - -     -- -   --  -  - - -  -  -      -  -   -     -  -   -  -      - -- -      -   -
----   -       - - - -   - - -  --   --- -- -   -     -    - - - - -  --  --    -      -           -
-  - -  ---- -   -  -   --    -  -         - -  -  -- ---     ---        -- -  -  - - -    -   -   -
-    -   -     - -  -   - --   --     -  - - - --  -      -   -  -    -     -- - - -   ---      - --
-       -      -  -  --  -  ----   -- -     -   -   ---  - --    -   - ---    - - -- -        -    -
--     --        --- -  -  -  - -      - -   ----- -  - -   -    --  - -   - - - -    - -          -
-   -       -- - - -   - - -        --   - - -          --  - -  -  -   -         ---     -     -  -
-   ----          --   - --  -- --      - - - -    --  --     --  -   -   -   - -  - --      --    -
- -         --  -  -    -  --      ---- -    --   -  -   -    - ----    -    ---      -     -  -   -
- -- - --       - -   - --       -  - -   --   -- -   -     -   -           -    -----  -     --   -
-   - --   -     - -  -- - -   --      - -      - -  -        - --  - - -         --   - ---    -  -
-  - - -  -        -- ---  - -  - - -   -  -- -    -- -        -   - - - -       -     --  -     - -
- -    --    ---  - - - - -     -    --  -    -- -     - --      -        -   -   -  --   - -    - -
-   -    - -         --  -   --  --     -   -    ---   -  - -  --   - ---- --   -   - - --    -    -
-    -         ---- - -  -- -         -    -   -- - --      -    --  - - -   ---  - -          -----
-  --    - -   - -     - - -    - - -        -     -  --  --          -    --    -     -  - -   -  -
-    -   --    -     - - - - -  -     - - --  -  -  - - -   --    --    -   - -     - -        - ---
-    -     -      --   --         -   -    -   -  --  -    - -    -   -- -   -- -  --    --        -
- --      -- -- --        -    --- -     - -   --      -  -- ---        - -   -  -      -   --     -
-      -            - -           -  - -  - -     -  -       - ---    -     -  -    -  - --  -   - -
--      - --- -       -   ---   --          -              -   - -  - -    -    -   -   -      - - -
-    -  -     - - -  -       - -  -  -  -   -   --       - --    -   -    -       -   - - - -    - -
-    - - -  -  --   --   -  -       -   --     ------ -  - -- --    -   -   --      - - -- -     - -
-  -  -                 -- - - --     - -- --- - - - - -       - --    -  -        - -      -  --  -
-     --    -- - - -   -       -  -- -      -          -- - -    ---   - -   -  -    - - - -  - -- -
-  - -   -- - -    - -   -    -  -    --- --   -- --- -     -  --    --   - -  -      -  -  -- -- --
-  -   - -   -- -     -        --   -   -- -    - - -    - - -      -  - -- -    -      ---    -   -
----   -      -   - - -  - -    ----  -      -  -  - --  -    -     - --   -   ---  -  -   --      -
-        -    - -    -- -  -  -     -- --  -  -- -   ---  -----      ---   -   -  -- -  --- -   -- -
-        -   - -- -  -     -  -  --- --    -    - -         -    - - -  -    -      -     -   -  ---
-       -    ---- -  - -  -   -  - - ---   -  -   - -  - -  - -   - - -    - - -  -  -  -  -    -  -
-  -      -  --    - -   -   -  -  -   -   -    --      -        - -- -    - --     -      -  --   -
-   - -  --     -      - - - - -      - -   - -   - -  - -  - -   --  - -- -   -- -     -          -
- - -    -        -    -   -    - - - -   -      -  -  -   - --     - -  -  ---  -    -- ----   -  -
-   --      -  ---       --    ---   - -  - ---  -   -  -- -  -   --     - -   --  -        --    --
-     -   - - -  -   --  - ---   -- -   - -    -   - --- -  -  -    - -   --  -  --- --   -      - -
- - -       -            -      -    -  -       -   -      ---  --   -   - --  --      -     --  ---
-   -   -         -    - --- -      --      -   -       -  --    -  - -          --     ----- - -  -
-- -  -  -   --      - -      -- --     - -             -   -  --  --- --  - --- -   --       -    -
-       -- - -      -  -    -     - ------      --  -   -  -    --    - -   --  -- - - --  - -  - --
-     -   -   -  -       - - -     -   -  - -     -      - - -- - ---     -  -     -    -   -- -   -
- -    -       -  --- --  -    -  -  --- - - - -     --     -  - -  -  --- -   -- -     -    --    -
-     --    - - --       -    - - -   -  -   --  -   -    --  - ---  ---  - -  -   -     -      -  -
- ---  -               -  --    - -  -   ----   -  -- --   -      --    -     -      ---  -   --   -
- -      -      --   - --  - -    -  -      ---   --   -- --  -  -     -   -  -- - -- - - - -  - - -
--  - --   - -   --  - -- - -  -     ---    - -  -   -   -   -  -- -   - - -   -       - -  - -  - -
-  - -      - --            -  - -- -   --     -     -   -   -   --   --- -- - - -    --    -   -  -
-    -      -   - -    - -- - -    -   -     -- --     -      --- - - -        - -  -- - - -  -   --
-       -  -     -      -   - --         -   -     --- -  -  - -  --   -     - - ----    - -  -    -
-   - -       -    - -    -  -   -- -     -  -- --   - -     -----  -- -       ---      - -     -  -
-- -  - -   -  -    -   -                   - --   -- -- -- -   -  -   - - -   -       - -     -   -
- --           -   -    - ----  - - -- - --     -    -    -  ---    --- -     ---     -- --  - - - -
- -  -  - -      - -      --- -    --- -  - -  -   ---  -       -      -  -- -  -   - -   -      - -
- ----  --    --    -     -     - --         - -  - -  -  - ----   --   --  -  -    - -         - --
- -   - - -   -- -   -          -     -- -  -   -  - -   - -                   -      -   ----     -
-     -  - - --   - - - --   --  -- -  -- -        --   -      -  - - --       -     -     -    -  -
- -        -        --  ---   -          - - - --      - --    --  -     -    - -    -   -  ----   -
-        - -  ---- -   -  --  -   -  ---- --           - - -      - -- -       --       -  -   -- --
- -   - -   -  --       -    - - --  -        --     --   -  -               - - - -   --  ---    --
- -  - -  -  - -     -   - --      --   - -   - - - - --  -----  -  -  -- -     - - - -     - -    -
-   -      -  -- - -    --    -----   - -       --   -     - -     - -- -     -    -- -    -    ----
- --   -  -     -- -  -- - --  - - - -- - - -  -  -      -     -  -   - -   -  - - --    - -  --   -
-       -   ---   -  - -  -  - -   -      -  --  -- --    -  -   - ---   - -     -  --   -      - --
-      --    --    -       ----     -  --     -    -  -       -        --- --   --            -    -
- -  -   - -   --  --- -   --     - ---  --    --     -  - - -      ---   -    -  - -   -     - -  -
-   - -    -  - --     -  -  --    ---  -     --  ----  - -  -- - - -  --   -      --  --  - - --  -
--                 -     -   - -- -       - -   -        ---  - - -   --  - - --       - -       - -
- -   -- -   - - --   -        -   - --    --     -       - --     --    -   -  -         -  - -   -
-  - -    - --  - -   - -   - -   - -  ---    ---   --   -  --   - -  -- -   -      --   -  - - -  -
- -- -      --- -   -    --  - - - --    --- --        -     --  -- -        -  - -- - - -- --     -
- ---  - --    - -     - - ----           -    - ---        - - -      -- ---  -  - -   ---  -    --
-         - -        --  --  -   -     - -  --   -      --  -     - - --         - -  -  -      -  -
---   --    - -    -    -    - -    -      --  -   --  --        -  -   --- -  -   ---  -   --   - -
-  --     - - - - -- - -  -  - - -- -    --  -   --  -  -    - -   - - - -      --    -  -     - - -
-    -- -             - -   -   -      -- -     -     -   - -          -  - - - -    --  --       --
-           --  - - --   -   -    - --  -- - - ---    -                -         --- - - - -    -  -
-   -- --   -  -   -          -  - - --   -  --     - --- -- - - ----   -        --  -     - --  - -
--       ---    -    -   ---  -       - -  - -  -        -      -   -          - -       - --- - ---
-    -       -     -    -  - -       -   -- -    - --          --     --            -    - -   - - -
-       -  --- ---     -          -  --    -- ---     -  -    -- --- -      -   -   - -   - -     --
-     -  -   - -            -  -    -   --     -       - -          -  -    -     - - -    - -- -  -
----------------------------------------------------------------------------------------------------
