100
100
----------------------------------------------------------------------------------------------------
- -  --  -  -  - -              - -       --   -             - -       - -     -   -  --      -    -
-     -   -  --   -  - -  -----   --    - -   -- -    - ---- -  --    - -  -     - -  -  -     -   -
-   -  -      -- - - -     -  - -    -  -  --- -  - -      - - -      --  -       -       - --     -
- -  - --  -   --               - --   -  --  -   -  - ---     - -     -        --   -- - -- -  -  -
-    -    -  -      -- - ----   -  -      - - -- -   - -  - --    -- -   ----   --  -   -      -   -
-   - -   - - - -  -         - - -   - -      -  -  -   -      - -  -       ---    --             --
-  -   -  -- -   - --  -  --   --  -     -           ---- -           - -  -      - -   - - - - -  -
-    -  - -  -    -   --        - -    -- - --          -   - --   -    - - ---   --    ---  -  ----
-     -     -  -    -      -     --  -     -      -   - - -  -  - -    -         --  -  -     -    -
-   -         - - --   - --   -       - --    --      --   - -   - -- - -  ---     --  - -      -- -
-       --  ---    - - --- --      -  --   - -    -          -  -        - -   - --    -    -     --
--      -   -   -   ---     -        -   - - -    --  ---      -    -    - -        -----   -     --
----         -  - -  --   - -    - - - - - - -   --   -  --  -    -     - -    -  -     -  -- -- ---
--     ---   - -      - --        -            - - - - - -  - -  - --           - --- -  - ---   ---
-  -       --  -  -- --    -- - -  ----  -   -    -       -   - --- -  -   --- -- -  --    --      -
- -- -   -     ---   -     -      -       - -   --    -  -     -       -  -  - -  --  -  -   -  -- -
--   --  -  - --   -   -- - -   --  - ---      - -              - -      -  -       -   -   -  - - -
- -     ----    -  - -    -    - -         - -   -     -    -  --       - -    -   -     ---   -   -
-- - ---  - -      -   - -    -    -  -              -  -    - --  --     - -   -       --  -- -   -
---  -  - - --       - -  -   -  -        --   -      ---  - --   -  --      -   --   --  --- -  - -
-      -  -        -  -   -    - -- --  -             -- --        --      -- - -  -        -   -  -
-  - --   --  --    -  -  - -  - -  - - - -- - - -  - -   -      --      -  -  -  - -   --- -- --  -
- -- -   --  - -- -        - -     - --   -   -        -- - -  - --        - -   --  -    -     - --
-   -  -   -  -  - -       --   - --  -     --    -  -  --      -  --  - -        --  -    --  - - -
-  -           -- - - -  - -- -          ---  -   -    -    - -----   --           --  - -- - -   --
- -     - -     - - -    -       -   -      -  -       -  --         -     --   -     --  ---- -  --
--    --     -    ---    -  - ----   - - - -  --  - -      -     -- -  - - - -   - - -             -
-    - - - -    --    -   -      -         -          ----    - -     -  - -  -    -  - - - --- - --
- --- -    -    -      -     -    -  ----    -  -   --    ----    -  -- - --   - -  - - -  -  -   --
-      --  -         -- - - - -  -   - - - -     - -  -   -- - ---   - -    --  - -    --  ---    --
-  -- -  -    -      - --  - -- -    --     - -    -   ---          -- -   -        -- --      -- --
- -  -   - -            -   -   -  -    -    - --      -    -       - -        -  -   -    -  -   --
-  --   -- - -      - ---    -   -    --            --  -      -   --   -- - -   - --  - -    -    -
-    -   -   - -     - --   -- -  - --    -    -      - --    --   -  -        - -     -         - -
---- -        -    -  -  -  -- --- -     -     ----  -    - - --      - -- -  - -  - -       -     -
-   -- -  --  -- -- -- -   --             -  -     -  -    - ----           - --   -    -  - -  -- -
-  -        -   --  - -   -       -   --  - -- ---    - -- -      -   -  --    -   - -    - -      -
- -  -- -  -  -       -- -- -   - - -- -   -- -      - - -- ---    - -- -  --- - -  -- - - - ---   -
-       -   --   -  ---     - -    - -    --     --       - ---   -   -  --   -    -            -  -
-- -      -   --  -  -   - -  -  -    --  -  -  --    ---        -         --             - --    --
-      -    --     --- --     -  --      -  - -    -   -  -    -     - - -   -      --   -  -   - --
-   -- -  -  - - -             ----- -          - -   - -- -     -  -  --  ----       --- --    -  -
-     - - -    --      --       -      -- -    -         -    --  -  -           -       - - -     -
-  -   - - - --  -  - -     -- - --   - --  -  - -  -     ---    - - - - - -- - --   -- -  -  -    -
- -     -  - - -   - -   - --  -  - -- - -  --- --       --    -    -  -- -  ----           ---    -
-- -- -- - -- -  -- -     -   --      -       -       -            -- -  -       -- -----  -   - ---
- -                -  -  -  --  -     --  - --  -- -     -       -   -  - -     - - - -    -   -   -
-   --   -- -     ---  - ---  --       - --   ---- -    -    --   --   - -- --  -   -  - -    -  ---
-   -  -     - - -     --  --  ---   -    - -     -- -    - - -     - ---     --   -           -  --
- --  -         -  ---   -   -- -  --     --- -    -- - - --          -  -----  --  -  - -         -
-  - -  -  -  --       --    - --    -     - -  ---     -      --- ---  -  -     - ---- -      -  --
-    - - --      - -   -     -  --- - -   --  - -  -  -    ---  -      ---- -  -  -   -  -- -   -  -
--     -    -  -  ----       - ---   -    --  -    -      -   -              - -   - - -      ---  -
- -  - - -     - -  -  -- --      - --  --  -- ---  -   --        -   - -- --    -- - ----       - -
-       -- --    -    -  - -   -  - -   -     -  -  -  --     --   -   -- --    - -- -     -  ---  -
--  --       --    -     -- ---      -        -     -  -- - ---      -              - --- -  - -   -
-   -  -   - - - -- --- -  - -        - -  -     - - -   - -      -  - ---     - -     -  --   - - -
-- - --   - -   -        ---    ---  --  - -  -- -  - -           --  --     - - -   -      - -    -
-   --    -   -  -  -           -   --    - -        -   -  -  - -   - -   - -   --       -   ---  -
-  -- -  -   -  -   - ----   -     -     -- - - - -     -          -        - -  --  --  - ---   ---
--   -- - - --    -  -          - -   -   -    - ---   ---  -    - --        -    -  -    -   - -  -
-  -  -  - -       - - -   -      -    -    -  - -       -  --- - -     -- - --   --    -      -  --
--    -   -           -     -        - --  - -        - - -       - -   - --   - -   --  --  -     -
-    -   -    --           - -  - -- --    - -- - -  - - ---  --     -          -  - - -  - -      -
- ----   ---      -  --- - -     -    --     - - -   - ---  -  -    -          --  - -- -     -- - -
-      -    ---  -       ---   -  -  - -        -  - --   -   - -  -         -    -    --  - - --  -
--  -- --  - - -     --         ---     -     -     -  -     -   - -  - -    - -- - --    -        -
-     --   - -- - -  -   -  - -    - --- -       - -    -          -  - --  -- - -        -  - -  --
-  -- -  -   -   -  -          - -    -  -  -  - -     -- -     -- -- -    -      ---    - - -  -- -
- --    -       -   -      - - -     -   -        -      -    -      -  -    -  --  --           - -
--  -- --   --    - ---  - -     -  -- - -     -    --- - -  -- -      - -       ---   -           -
- -    --    --        - -  -     -   --           -      -     - -   -- -     -             - -- --
- --  --  -   -   -  --- --   -   -- ----    ---            --    - -    --   --     -      ----  --
- - -        -  --  - -    -   -- - - -    --       - - - -  -  -  -  ---       --  - -    -  -    -
-     -    -  -  --         -  -  -  - -   --   - -- - ---       -  - -  - --   -- -      - ---  ---
--   -       --       --      ---   -- --             -    - -     -    -  - - --   --- ---- - -   -
--  - -    -     -  ---    -     -          -    -  -     -  -  - -    -- -  - -  -  -  -    -   - -
-    -  --       --  --         -  -     -- -    -    - - -   - -- --   -         -   -     -  - - -
-     -  - -   - -  - --     - - -   -- -  --         - - - -     -       -    -   -         --- - -
-   -- -  -- -   - --   ----        -   -- - -  --  -   -  --  -  -      - - -   -   - -    -  -   -
-   -   - -       -  - ---   -      -        - - - - -- - --   -  -  -   - - -   - --     - - -    -
--   -- -   -      -  -    -              -- -  -          -    -      - -   -     -  --    - -    -
-  -     - -    --   - -      -      -      --  -  -   - -- - - -- -   - -     -- -     - - -      -
--  - -       - - -   -         - -        -  -- - - -  -  -  -    -     - -     - - -    -   -  - -
----- -     -   -    ---   - - -- -  -  - --  -  -     -   --    -      -   - -   -       --  - -  -
--- - -   - - - -   --         - - -     - -    - --    --         -          -      -          -- -
-  -  --  - ---                    --           --     -- -  - -  -   --- ---   -   - -  ---    -  -
--      --      -        -- -- -    -   -   ---  --    - -     --  -   -- - -   -   -   -  -     - -
-- -- -        --   -  -   --   -     -  - -    -         - -   -   -           - --  -  -  -   -  -
-  --       -  -  -   - - -  - -  -- -     - --     --       --  --    -  -   -   -          -     -
---- --        -   -       - -  -  -        - -  --  -- -----    -  -          -    -  - -     - - -
-  -   -       - --     -   -     --     -   - -   - -   -   --  - -  -      -  -- -  - - ---- -   -
- - -  -  -   -- -   - - -       - -  - -   -   -  -  -   -   -    --   - -    - -  -   -         --
-    -       -              -             -    -  - -- - -  -- -      - -       - --  -  -   -  - --
-  -     -   -        - -- -  -       - - -   - - -- - - -- -         -   -    - -       ---  -- - -
-   - -          --     - -   --  - --    - -   - -  --  ---  --     - - -           -          -- -
-  -      --   - --     -         ----  - - -  - -  -   -    --    -- - - -   -      - -  --     ---
-    --     -- -    -           -    -             -  -    -      -     - --       --     -  -  -  -
----------------------------------------------------------------------------------------------------
