100
100
----------------------------------------------------------------------------------------------------
-         -    - - -       -  -        -   -    -                       -     - -   -     - - -    -
---- --- -    - - -  -  - ---     --  -       -     -   -  --- -  --        -   - -   - - - --  - --
-  - - -  --- -  - --    -----   - -   -  -  -   -- -  -       - - -    -    --     -  -   -      --
-     - -    --      ---  -    - -            -     - ----   - -    -   - ---   -         -    - - -
-     - -  - - --       -  - -    - - - -        --        -         -   -   ----         - -- - ---
--  --  - -     -- -   --    -     - --        -             --  -        -        -- -   - - - -  -
-  - -   - --   -- -- -   -    ---      -- - -       --    -   -    -  -        ---  - -    -     --
- --   - - - - -   --  -  - - -   -   - -   ---   --  -----  -   --- - -    -    -         -   -   -
-   -- -   - - ----     -     - -      -   -   ----   - ---    -  -  -   --  -   - - ---          --
-   -  -   -  -  -  -   -- -    --     - ----  - -  - - - -- ---        - -        -        -  -   -
-       - - - -  -- -      --- -- -  ----   -       -- -  -      ----   -     - -   --   ---       -
- - --  - --  --       -      - -   --   -- --           -  ----     ----    -  -- -   --  --  - - -
-    -  -     -  -  -   -  --  - -- -   - -    -   -  -  - --    - -     --    -    -   --  - --  --
- -   -         -      --   -    -   --   -  -  -   -   - --     - -   -  -     -    -       -     -
-   - - ---  -           -               - -     --  ---  - - ------ ---    -   --        -- -- -- -
- -      --    -   -   --   -        -          ---- -           -      -   -- -   -    -    -     -
-  - -  -  -  -  -      - -  -- -   -    -  -  --   ---  --     - --    -   -- -     -  --       - -
- -   - --   --   -   -  - -   - - -        ---  -             -  -   -  - - -     -  -       - -  -
--  -  -   - -  -  -       -     -    -     -   -   ---    - -    --  --- - - -   --  --   - -     -
-- -  -     -      -      -   - ---                     -    - -  - -     -      - --           -  -
--   - -       -   - -    -    - -  - --- --    --  -   - - -          --      -  - --  --     -   -
--  -          -  -  - -  -     -     - - -  -   -  - --  - - ---   --  --- -  - -  - --   - - - ---
- -    --   --  - -  -  -     -- ----     - - --      - --  -  --  -  -  -          -     -  -     -
--  -       -  - -    -       -  - - -- --         ---     ----   --   - -  - - -  --     --      --
--        -    -  -  -- -        - -  - -     -- -       -  -   - ---      -  -    -        --   - -
-  -    -   -  ---    - -   -   -  -    -       - -    - --     --  ---  -   - --  -   ---       - -
- -  -- -- -      -- -    -   -     ---  -   -          -  -   -   --        --       -      -- -  -
-- ---    --   - - --  -   -- - -     -  ----               - -  -    -  -  -   -- -  -   ----  -  -
-   -        -  -     -  -   ---            --     --     -  -     -- - -- - --   -       -     - --
-        - -- - --  -  --- -    -  -- -   --   -      - -      ---- -      -     - --- -           -
- - -            -  -   -      - - -         -   -  - -   ---  -       --- - - - -        -- --    -
-    - - - -- --   - -    -   - -   -- -     -  ---   ----- -   -  -              ---- -   --  --  -
-   -   -      -    - --   --- -   -  --            ---   -   - -    --- -  - -  -        -       --
- - - --  - -  -    -    --  -      -     --  -    -    -   - -- --  - - --        -  - --   -     -
-     -     -         -   - -     -- - --     - -- -       --   - -  - -   -- -   -       --  -    -
- - --        - -- --       -  -         --    --     -   -- -  - - - -      ---    - -- -      -  -
- -   - - ----   --  -  - -        -      - -   -   -  - - - -  -  -  ---  --  - -    ---- -- -  ---
-  -      -    -  -   -    --   -   ------ - ----    - - -- - -    -- -  -   -  - -  --    --  --- -
-    -      - - - - -- -- -  -    -       - -      -  -- -- -  -  -  -  --- -   - - -              -
-      ---   -   -  -  --      - -   --      -   -     - -   - - -- - -      -  -  - - -         - -
- - -- --       -   -    -         -  -  -     - --  -         - -      -  -    -    - -   --    ---
-     - -   ---   -  -  -  -  - - -      -- ---         - -   ----   --            ---- -      -- --
-  -      -  -     --     -      - -  - -         --  - -- -  -   -  -  -  -          -  ---    -  -
-- - - -  - -   -    -     -  - -   - -     -    - - -   -  -- -   - -  -  - -   -   - - ---      --
-   ---  - --     ---   --- -        - -      -      -  -             -     -   -      --  -       -
- - -        -  - -   - ---  -- --  -   - -      - -       ----     -    --  -   -  -    -  - -    -
-      -   -    - - - -  -            - -        -- -  -- -   --     -     --    -    -   -  --    -
-         --   -   ---       -  --   -  -  -  -   -  --  ----   - -----   - -   -  ---        - - --
-                --  -- - ---    - --  - - -  - --   -        - -     - - - -- -    -   -  -       -
-  -  - --      -  -   -      -      - -   - - --  - - --- -- --  -   -    ---   ---     - - -   - -
-     -           - -  -           --  -   - - -  -    -  --- -           - -   --   -- -  --   -  -
--       --  - --   -   ---     --    - -   -   -     --   - -   -  -  - -         - --  -  -     --
-  -  ----- - -      -  - -- -  -     -        -  -      -  - -    -       -   - -  -  - ---- --   -
---   --     - --          - -  - ---  - ---  -        - --    -   -       - -   -- --   -         -
-       - -  - -  -    - -  -           -  -  -           - -     -  -   -    -  -     -   -  - -  -
-   -     -  -   - - -- -  -  -   --    - -   --  -    -    - -- -  -    -  -    - -  - -   -  -   -
-           -    - - -- -      --  -    - ---   -  - --    -  -  - -- ---      -     --   - - - -- -
-  --        - -  --     --   -  ---    -    -   -- --- -  --    -        - -  ---         - -- -  -
-  --- ---  -    --         - - -- ---      -   -     -   - --  -  --- -  -  - -  -- - - -- -- - - -
- -- --     -  -  -  --    -  -               -     -   --     -  -   -  -    -  ---   -   - -    --
- - -           -       --   -      - -    -- --          -  ---           -    -     -   -       --
-  -      - -     -- -          -  -    - - -   -- -    --         -  -   - -  - - -       - -- -  -
-     -  -         -  - --   -  -  --   - -- - - -  --  - - -- -      - -- - - - -  -       -   -  -
-     -    -- --      -    -    --     - - -     --    -       -   -   -   - - --  - - -   --    - -
- - -           --  -       -    -   -  -        - -    -- - -- ---- -   -    --         -  -  -   -
- --  - -    - - -     - -                --  ---   --  -    --       -  -      --  --    -- -     -
-  - -  - -    - -         -- ---      --    -  -  ---       -  -      --        -  -    - -    - --
--  -        - - -  - --   - -       -        -         - - - -   ---     - -- --  - -  - - - - -- -
-   -   --              -  -  - ---  - - --     -- -  -    ---  --  -  --   - -              --   --
- -  - -      - - -  --    -  -     - -  -  -    -    --- - - - --- - - --- - -  -      --   --  - -
-     -   -- -  ----  - - - -    -     - --  --        -     -  -            ---   -  - - -- --    -
- - - - ---      -        - - -   - --   -    -   -  --   - -  -    --   --   -      - - -  -     --
-  -   -- - -- --  -   - - -  -- -      -  -    - -       -    --         - - -  -- - -   -  -  - --
-   --              --  -    - -   - -   -    -    -  - -  -   -  -   --      -          -    - -  -
-  -   - -       - -- --      -       -   --  -   -- -           -    -      -    -  - - -       ---
-- -   -     --      -  -  -  ---   -  --    - - -      - -    -  -- - -  --   -  -   -  ---       -
- -- - -  -        -   -      -  -    - -    -- -- -- -  --  -   - - ---- -   -                  - -
- - -  -      -     --   - - - -  - --        -   - -- -        -   --         --   ---   -   ---  -
- --  - --     -- --         --  --         -    --   - --  -            - --  -  - -   --      - --
-   -  -                  -        -      -  -   - -    - - ------    - -    -   --   - - -  --   --
-  -   - -- --- - -- -      -   - --    --       -   --   -          -       - -    -   - -     -- -
- -  - --   -- -    -     -- --        --   ---   --              -    --     - - ----    -    - - -
-        - -     -  -   - -  - -- ---  -   --   -       - - --        - -  -   --      - -   -    --
---  - - ---  -- -   - -  - - -- -      --   -  - -- - - ---   - -            - -    -   --  -   - -
-    -       -   -   -    -      -  -       -  -      -    - - -  - ---    -        -      - -    --
-      - -  --    --- -  -  --  ---      --  -   - - - -- -- -  --             -   -      -        -
-   -    -    - - -           ---- -     -        -  -  -  - ----    - --  -- -- -  -      -       -
-          - - -- - - - - -       -        --- -  --   -      -    - - - -- - - -     -  - -  -  - -
- - -  --   -- - --      -   -  -    -          -   ---          - -- -- --          --  --    -   -
-  -  -   --  -  --  -  -  -      -      - - -  - -  -    - --      - -     -  - --    --  -    -  -
- -   ---      --  -  - -    -  --  -   -       -    -  -     --- -- -    --   -  --    -      - ---
- -      ---     --     -   -        -       -      - - - - --      ---  -    -            --      -
-- --       --    - ---      -      -      -      - -       - - - - - -     --        ----  -   -  -
-     -      -   -   -  --   -   -       - ---  -   -- - -- - -      - - -   -  -  -    -- - -   - -
--  - --   -   - -- -         -   -  --- -    -- --- -   -           - - --    -   -  --  -  -- - --
- -   -   -  -  -     - -        -  -       -   - --- -    -      -  -  -      --  - -  -   - - -  -
-  -   -          - -   - -   --- -- --  --       - -  --- - - -- --  -  --    - -       ---    -  -
-  --  --    - --        - -                 -  - --          -   -  -  -  -      -       - - -    -
----------------------------------------------------------------------------------------------------
