100
100
----------------------------------------------------------------------------------------------------
-  -             -- -  ---     - -   - -   - - -    -   -  --       -          -   -    -- -   - - -
--          - --            --- -         -  --   - - -   ---  --- - -   - - -   --  --   --  -   --
--     --  -  -   --   -  - -  - -          - -  -  --             -  --- -  -    - -   --      -  -
-- -   - -       -  - --   -        --  -    - -           -      -  - -    -   -- --     --       -
-       ---  -      -   -   -   ---  -    -  -           -      -   -  - -  - --  -  --- - - -  -  -
-    -    ----      - - -   - -   - -   -  ----     - ---  --    - --   -- -     -   -     -  -   --
- ---         -    --          - ---      -   -    -  - --      - - -  -      - ---  -- - -   ---- -
-- - - - - -   - -- -         --     -- -    --    -        - -    -- -  -- -    - -- --    -   - --
-         -   --            -- - - -   - - --    - -   - --  --  -  -     ---  - - -  - -  -  -    -
-        -- - - - - - -- - - ---   -----        --  -  -     ----                - - - --   -     --
-       -  -        --    ---- --       --  - -  - -      -       -- - -   --   --        -   - -  -
- - -   -- -   --       - --  - -  --  -   -- -  -     -          -    -   -    -    - -- -    -- --
-    -   - -   -- -  -  - - - -   -      --   - -   -   - -        -   --- -   - --    - -----    --
-- --   --           - --  -  --  - - -   --  - -  -   -  - -   --   --    -     - ---   -         -
---- -    -- -- -- --  - -    -  -  -  --    ---  - -    -   -  -   -   ---   -  -   - -  --       -
-    --       - -     -- ----  --    --- - - -  --- -     -   -     -- -   -     -  - -  -     -   -
- --  - --    - ---    -- --   -- ---   --     --  - --  -      -- -   -      --  -  - -    -      -
-    --     --            - -  - -  -  -   -  --   --  - - --  --    -              -   -  -- - - --
--- -  -- -    -  --  - -  --   -  -  -         - - -  - - ---     -  --  --     - --   -     -    -
-    -- --  - --    -- -     --    - ---- -   - - --     -      -        --  -        -  ---    -- -
-  --   - -         --       -  -  -   -     -       - - -- --     -  -   - -  -  - -              -
----   --   -- --     -     -         - -          -  - - --    -   -    -       -    -- - -  -- - -
---- - -- -  -         -          -   -     - -     - -- -  -     - - - -  -- -           -  -    --
-   -   - -- -  -- -   ---      -- -   -  -  -       -      - --  - --- --      --   -  --  - -- - -
---- - - - --- -     -   -                    -- -     ---  -    -  -- - - -- -- -      - --       -
- - - -        - ---  -   --  - -   -   -  - -  -    --    --           -      --  --      -- ---- -
- - - --  -    -        - - -         -    -     --     -      -       ---- - -- -- -   --   -- -  -
-       -    - ---           -   - - - -       --   --          - --- - - -              - -- -- ---
-       -   -  -  --        -    -- -      -  -   - --- --  --      - - -     -   ----- - -      - -
-  - -    - -      --    - -   -      -  -     ---   -     -- ----      -     - - - -   -          -
-     - --     -  ---  -  -  -  - - -  -   --     --    -- -        - --- - - --      -- - -       -
--    -      --          --  -    -    - - -   ---           --- -     - -     -   -- -   -   -  ---
- -    -  -    -   - ---    -      --  --- - - -   -  --   -   -   -- -- - -        --     - -     -
---  -   --  -    -  -     - ---   - ---  - -       -   -       -   --  --  - - -- -          ---  -
-       - - - - - -   --     - - --      -          - -- - -  -  -     -- -    - -   -   -   -   ---
-   -- -   - -  -   --         - -- -   -    - - - - -         --  -      -   -    -  -  - -   -   -
--         -   -    ----    --  -- - -        -  -   -  -     -  -- -     - - - -  -- - --  -      -
-- -  --  - -  ---     - -    -  -    -   - -   -- - - -   -   - --      -  - ---- -       -- -   --
-       -  - -     -  -  - -   -  - - - -    --  -   -     -  -   -         --      - ---     - -- -
-   -    -  - -  ---  - --       --  - -  --  -     -  -        ---             -     - -   - -    -
-      - -   -      -    -  -  --       -      --  - -     -  --   -  --    --    - ---  ----  -   -
-    -  -  --    -   -         -  - -- -   -      -  - -  -              -    -  -  --  -  -  -  - -
-   -                 --        -   -    -     - -  -  ---          -- -    -  --   - - -   --    --
-  - --- ---      ---  --    -   --    - -    -  ---  --    --  -    --   -- -     -   - --   -    -
-- -    --      -       -  - -- --   -    - -  -    --   -       - -    -     --     --  -   -   - -
- -     - - --  --       -  -- --       - -   -     - --  - --   -   - -- -  - --       -  ---     -
- -  -     -  -      -         - -  -      - --  --   --     --  -  --     -- -   -    -  -        -
--  --   -   ---    - --- -    -    -             - -    - -    -  -           -- - -   -  -- --   -
- --       --    - -  -   -           -   -  - --     -    - -        - -   -       -  -  -  - -  --
----       -   - -     -     -   --  --    -      - -   -    -   -     -          - -  -  --   - - -
- -  -    --         -    -  --    -             -  --  -   -- -- -        -  ---      -  - - -- - -
-  -     - -  -       --    - -           -  -   -- - - -   -  --      - - --       -    --      - -
-  -  -  -           -    --- -   - -- - --      -  - -          - -  - - -  - -  -     -   -- -  --
-  - -  - -   -   -- - -        -     -    - -    --   -  -    -  -      --           - - -  - --  -
- -  - --  --  --  --   --  ----     - -    --  - --     -   -   - - -   - - -   ----   - -     -  -
-     -  -           -    - --     -     - -     --- - --          --   -- - -  - --      -       --
-        --    -       -  -  --     -  -  -- --      -        - - - -           - -   -  -    ---  -
-                ---   -    -    -    -  -   -  --  -     ---- - - -     --  --  --   -   -  -     -
-     - - --  -     - - -  - -       -   -       -   -  -- -  -       -   -    -   ---   ---    -  -
- --- ---      -     -    --       - --       -- - -       ---    - -      -  ------  -     -  - - -
-       --    --    -  --    -          -- -    -       - ---  -   -  -      - -    -      -  -   --
-     --   --   -- - -  -    -       --    - - -     - -     -       - -- -       - - - - -- -  -  -
---     -    --   -      -   - - -- -  - -       -    -   -   --        -- -- -   -- - - -    --   -
-  -   -- -   - -       -    -       -    -    -  --  -      - -        - -     - -  -      -   -  -
- -  -  - -       - -     -   -    --   - -  -  ---     -  ---    -   -      -        -  -      - --
-  - -  - -  -    -  -  -    -- -    -  -    --     --   --   -   - -    -    - -      -  - - -- - -
-         - -      --    -  - -   -    - - -     -         -      - -   ----- -  -  - - - --      --
- -    -    -  ------ -      -    -  -- --   -    -       -    - -  -        -  - -       --       -
- -  - - - -    -  - -  --  -  ---       - -  -- - -- -   - -         -   --   -    - - -   -- -- --
-  -- - -   - --  - -        --    -      -      --    -  -    -   --   - -     ---   -   -   - -- -
-  - - --    --    - -   --      -         -           -   - -   --      -       -          --     -
-   ---  - -   -   --          -   -   -- -  -  -- -   - -   -   - -         -- -    -  --       - -
- -   -       - -         -  - -- -  -     -  -     -   -    --   -               - - -    -----  --
-     - -  --- --  -       -     -   -- -          -  --        -        -    -           -  - - - -
-   -    -  -     -   --- - - --   -     -     - -  -  -  - -   -      -- --   -    -      -     ---
---- -  - -  -    ------       -   --  --   -- -  -    -              -     --- - - -- -      - -  -
-  -  --      --- -  --  - -  - --        -  -- -   -    -  - -   -    --      -- -  --  -- -   - --
--   -     -     -    -   -- -           -  - - -        --   -  --       - --    --  - --    - -  -
-   -  - - - -  --- -   -   -  -- --   -     -   ---  ---     -     - - -  -   -  - --   -      - --
---   -    -        -      -  -     -   - --   -   -  -  - -    - - - -      --     --       --  - -
--      --  -   -- --  - -     ----  --      -     --  - -   - - --  - - - --    -   - -        -  -
-  -- - -      -  -- -- -  - -   - -- - -  - -  -      -  -   -    -   -       -- -  -  --- -  -  --
--   - - -    -  - --       -  -   -  -  -- -- - --     -    ----                   -  -     -  -  -
---         -           - -    -  - -   -      --- - -- - --          -   -  ---  - -     - -      -
---  -     -    - -----        -- -        -  -     --       -  -  -  -  --             - -      - -
--    -      -      -      -    -  -   - -    -  -  - -- - - --- - -    - - ---  -        -   -  - -
-  - -- - - ---  - --    -      --  -        - --- -    - ---       --  --- -     --  ----  --  -  -
-         -    -     -- -   -- ----- - -- -  -  --    ---     -   - -- -     -      --     -  -    -
-   --  -      - -    -  - -     -  -  -           --     - --   -      -   --- --   -   -   - -   -
-     -      -    -     -  -       - - -  - --- --     -  - - - -   - -- --      -   - -    -      -
- --     --  --  -      - -- -- -   -    --- - - - -- ----  - - -   --    -  - --     - -          -
-  -        -           -- - -- ---   -         - -- -    -- - -  -      -    -   -  -- -     -  - -
--  ---  - -  ---  - -   -    --   -  -  --   -   -  - -    -      - -     -      -- -  -   -  -   -
--    -- -  -          ----  -      ---  -    - -   - -    -   - - -    -     ---  -- - ---  -  -  -
- ----             -- -  -        -    -- -- -       - -  -      -   ---     - -  - - --   -  --   -
--    -- -      -     ---    -  -  -       - - - -  -- -      -  - -      - - - --   --  - - -- -- -
- -  -  -  -           -    -  -  -          - - --      - --   -      ---- - - - --    -         --
-  - -          -  --   - -  -                  -                -   -        -- -     -   -    -- -
----------------------------------------------------------------------------------------------------
