100
100
----------------------------------------------------------------------------------------------------
-  - - ----   -   - - -            - ---   -         - -       - -       -   -       - -     - -   -
-   -  -  -   - -  -    -   ----   - --      -   - -  -  --   - - -  - -       ---  --  -  -    -  -
-  ---- -     -  - -  -  -          -     -  - - - -   -  - - ---- - -   --  -       ---     -- -  -
- -    --- -      - -  -       - -      -     -  -          -        - -      - -  -     -         -
- ---       - --- --- --          -- ---  -   -    -  - -- - ---      - - -  -   - - --- -   - - - -
-       -        -         --    -- -  --  -     --  --  -  - -      -        - - ----  - -  -  -  -
-         -      --   -   -             -       -       -       -  - --    - -  -- -      --  --   -
-      --- -     --   -    - -    --   - - - -     ---- -  -                     -  -- -  -   -  - -
- -- -  -       -       --    -      -  --      - -   --  -   -  - -  -   - -   - -     - -- ---   -
-      -      -    -    - -      -  - -    -   - -       -   -   -  -    - -            --  -   -  -
-  -     ----  -  - -       --- - -  -- --      -        -      -      -   ----        -         ---
-  - - -  -     -      --    -   -       - -     -  --  --  --     -- -  -  - --    -   - -     - --
- - --   --     -  -   --  -      - -  - - -   - ---       -    -- -         --  - -------  -    - -
-  -- ---          - -    --- -       ---  --  --    - -  - -     - -   - - -   -          --   -  -
--     --     -    -  - -          - - - -         -       -  - - - -  -    -       -- - -         -
-    --  --   -   -        --  -       -    -- --     -                -  -     - - -     -     -  -
- -         -   - -      - - - -  -  - -  --  -       - - -  -   -- -- - -         -   --          -
-    -   --- --   -   --        -    - - -  ----    - --     - -   -           -   -  -     -    - -
--    -- --   -  - -   ---  -    ---    --       - -    -   - -       - - -          -  - ---   -- -
-   -      -   - - - -    -  -         - ---  --      - --      - --       -   -   --  -   -  - -- -
- -       -    -  -  - -  -    - ---          --    ----   - -  -   - - --    -  --  -    -  - -- --
-  -    - --   -  -   -  -    -   -   - - - - -  -  - -   --- -   --- -    -  -    -- -  -      - --
- - - - - -  -  -   - - -     - ---- ---       -  -  -   -     - -        -     --    -  - -     - -
-- -   --- - - --  -  - - -  --  -     ---   -- -        -    --  -- -    -  - -   -   - -   -     -
-  - -     -  -            -      --  -       - -    --         -    - -  -         -- -  --       -
- -   - - -    - -  ---             --- -  --   --  - -   ---    -- -- -         -   -  -          -
--     -   -  - -- -- -- --- -        -     -        -  ---   -    - -  -- - -   -     -  -   ---  -
-  -  -        -  - -  - -  -     - -- - - -      -       -  -- - -   -   -  --       - - -   -   --
-  -      - ----   -  -    -  -       --    ---       -      - ---  --  - - - - --    - - --- - - --
---  -     -   -  -     --  -- - -- -  --   -  - -    - - --       --   - - -- - -      -    - --- -
---- -  --  --  -  - -        --- -       -     -  -   -- -   -- -        -       - ---- - - -  -- -
-  -   - - - ---     -  -  ----   ---   -        - -- -- -   -   -  -----    -          -  -       -
--- -    --       - -- -         - -      - -  --    -  -      - --     -  -    -            - - ---
---  - -     -  -  --        -     -- ----   - -  -   -   -          --   --      --      - -     --
--  -    --            -  - -  - -   - -  -    -  -  - - -  -- -- --   ---    -  --          - - ---
-  - -- -    -  -    - -         -- -      -   --      -  -  -      --  -  - -  - --  -       -    -
- -  - -     -    - -    - - - -  -     -    -- - - - - -      -  ----        - -  -  -  -- -- - - -
-     --   -   --   -             -         - -  -    -       -     - -   - - -   -     - -  -   - -
---- - -     - -  -     -  -  - -  - --        -      --  -  - -     -  - --  -  -   -  - -      - -
- -      - - - --     -  - --  - - - -      - -        -    -  --   -  --   -        -  -- - ---   -
--  --       --  -    --  -   -  -       -    -- - -- -    - - -          -  ------          -  -  -
-       -- - - - -  -        - --          --   -  -      -   --     - - --  -  -  - - -  -  ---   -
-     --    -   -       -    -   --       --- -      - -- -          - - -  - --  --      - -   -  -
---  -     --       -  --   -  --     ----   -     -   -- -- - -     - - -    - -   -  -    --  -  -
- -    -      - -     -  - - -    -                - -      -   -    -- -       --    - -   -   -  -
- -       -  -- - --        - - --  -- -  -   -       ---       -   --         -    - - -  -  --   -
-    -    -- -   --  - - - --      -         -  -        --  -   -   - -- -     --       -    --   -
- -  -   --   -    -- -- --  -  - - -  - -       -  -   - --       -- - --  --   -    -   --       -
--      - --- -- -   -      -- -      - -  ------       --   - -  --       - -   -   -   -     -   -
- -  - --  - --      --  ---  -  - -      -  -             -  -       --     -   -  - --      -    -
- - - -         -    -  -     --  -  -  - - -      -    - - - - - --     - -      -- -     --  --  -
-    - -  -- -     -   - ---    --  -    -  -    ---   -   -- -         -        -   - --- - - -  --
-     - ---  -   -       - -  -    - -- -        -     -        -  --    -        --   --  --- -   -
-    - -   -- -   - -- - - -    - ---                 - --  ---      --     - ----- --   -       - -
- - -     -  -- -    - -  -  --    --    ---    - - -  -   -     -     ----    -  --- -  -  --    --
- -- -   -  -- -  -  -   - --  -    -  --   --    -- -       -  -- --  -    -   -    -    -- -     -
- - -  --   --  -   -         --       - --     -   -   -   - -  - -  -  -    -- --   --  -  --  - -
- -    -    -  --   -  -      - -   -      - -  - -    --  -  --     ---  - -   -  ---    - - - -  -
-  --      -  - -         --   - - -  -    - - --  - - - - --    - -     -   --     - - --      ----
-     ---    -  --   - --  -  - -     -   -- -              --     -       -  -       --  -   - ----
-    ---  - -  -   ---    - - - - -         - -- -  -  -  --  -- --      --   - - -      -    - -  -
-   -    --      --        -       --   --- -    --        - -     -  -    --    -   --- ---   -   -
--   --     -  -----    --  -- -  -                  - --  -   - -- - ---        -  -       - -    -
-    - --- -- --  -   -       -   -    -  -    ----    - -  --   -- -   - -- - -   -  -     - -    -
- -             -   -           -   -- --   -    ---  - - -        -    -   -  -   -   - - -  -- - -
- - -  -        --   ---  -     -  -     -   --      -    - - -  --  ---- -- -     - --   - ----- --
-- -- -- -     -   - --         -     - ----   -- -      -  -       - -- -   --      -    ---      -
-           -     --- - -- -         -        -      --    --      --   - -    -    - -  -    -- - -
- ----   -    - -     -    ---  -- -  ---  --    -   -   ---  --  - -          -    - - --     -  --
- -  -- -    - - -  -   --  ---           -    -    - -  -  -  -      - - --        ----  -  -     -
-  -   - -        --  -   -- -       --     -     -   - -   -    -- -     -   --    -   -  - -- - --
--       - - - -      -     - -   --   - -       - - -   -        -  -  -     -- -- - --  -     - --
-  - -    -      --  -     - --  - -  -  - -   -  -       -   -   -  -  - -- -    - ----- - -      -
--             -  -----   -  -       -        -  -  - -   - - - - -  --     - ----    -  -  -- -   -
-- -          --  -    - -  -  ---     ------ -      -  -       -  - - - ------     -  - --        -
- -- -     -  - -     - ---         ---   -   -   - -  -   -   -        -   -     -     -       -  -
-  -  -  --   - -- -             - -   -            -- -  --   -- ---   - -- -  ---   - -  -      --
- - --           -   -   -  -- -    -- -  -- -- --    - -     - --    - - -    -   - - -  --   - ---
-   - --  -         - ------   --  - - -       -        -- - - - -  -      -   -  -  -  -  - -  -- -
--  --  -  -     -     -  -      -      -   - -- -    -  -   -  - -       - --       -    - - --  --
--    -    --  - -          -   --- --   -      -   ---   - -     -- -      -    -  - - -  -   -   -
- -- --           -     -  -       -      ----      -   - -     -   -  -  -     -    -- - --  -   --
-   -  -      -    -       - -             -      -     - --- -          --- -  -     -    --  -- --
-    - -        -----     --     -    -     - ----  - -      -         -      --      -           --
-  - -    - -       --  --  - -     -  -     -- - ---    -- -- - --     -       -- -   -  -     -  -
-   - - -  --    - -  --      -       - - --   --   - --- -         -    -   -   --     --   --  - -
---     - - -  -    ---   -  -- -   -    -   -- -  -- -    -   - --  ---      - -   --             -
-  -   -     - -    - --    -   -   -       -  -  -  -      -  -   --    ---  -  -      -  - ---  --
-   - - - -    ---- -    - - -- -- -     -      -       - -         --   --- --    -  -   - -      -
-  -     -          -  -     -  -               --       - -     --  -          - --   -  --       -
- -   - - - -   - -- -          - -   - --- --- -  --        -  - -  -  --  - --    -   - - ---  - -
- - - -  -      --  -  -     -   --   - -     --    -  -   -       -   -    - --  -  ---  -      - -
-         - -  - - - -   ---   - -  -  ---- -   - - -          - ---  -    --     -             -- -
---      -  - -     -        --- --      - - -  -   -    -   -   - -   - -   - -   --   --- -    - -
-    --   --    ---             - -    -   - -   -  -  - --- - -   - -  - - -   - --  --   -      --
--      -       -  ---- -- -- ----  -            -- - -  -    --   -    -           -  -   --      -
-      - --   -  ---   -     -  -   --      -   -  -     - -- -  -   -  --  --    - --     -     - -
-  - -    - - -      -  -     - -      -   -- --     - -   -   -          -        -  - - -        -
----------------------------------------------------------------------------------------------------
