100
100
----------------------------------------------------------------------------------------------------
-    --     -     -  -      --  -    -           -   -                -   - -    -  - -   --  ---  -
- -         - - -   -   -- -    -     - - ---  - -      - -     - - -- --  - --- -      -    -     -
-   -     -  -     - -      ---  -   -  -   -- ---  - -    --        --   - -  -    -    --   ---  -
-- -- -  -  -- -      -  -    -     - -- - --  -   ---  -   - -  - -  ----    -      --   -       --
-     --  -   -     - ----     ----  -  -    -   --    -  --   -  - -   - -   -     - -   -    --  -
-  -    - - -  - - -    --   -     ---         ----    -       -    --  - -   -       --- -       --
--   - --   -- - -   -           -    --  -  -           -       -- -        -  -- -- - -  -  - -  -
--   - -  -  -   -- - -     - -  - - --  -      - -         -       -   - - -              -    -  -
- - -      --   --  --- -      - -          --         ----    -- -  - -     -- -   -    - --   -  -
-- -    -- - -            ---  -      - -               -    -    --     --  - --        - -  --- --
- ---     --   --- - -              ------- --  -  -     - -------     --  - -   ---   -- -  -  - --
-       -  -  -   --  --  ------ -  -  -     -   -- -  -     -  - -        - - --      -  - -   -  -
-    --  -   - -      -     -   -   -    -  -  -       -- -   -  - --           - -        --- -   -
- -  -  -- -     -  --  -      -      ---  - ---          -  -- - -   -   -    -    -      -   -   -
-  -    - -   -     --    - -  -   -     ----   -    ---- -- -    -   - -- -     - - -   -  - - -  -
-  --  -    - --    -  --   -- -       -     -   --- --- -        --   -     - - - - - --     - -  -
-- -         -       -    -         -    -          -        -- - -     -- -  -  - ---       -   - -
- - -- -   -   ------     -  - - - -   -   - -       -   -     -   --    -             -     - --  -
-  -    -- ---    -  -     -  -      -- -  - - --- -          -     -   - -- - - -      --  -    - -
--- --      - -  --  - -  - -- -        -    - -     -  -  -      --  -      - -     --  -   -  -- -
-  -  -       --- -      -  - -      --     - --   - - -      --    -- - -      -  -     -    ---  -
- -   -  -     -      --    -   --    --   --    -   ---        - --   -          -  -    - -    - -
-    -   --     -  -         -      -   - - -  - --   ---      -    -   --- -        -       -    --
- - - -    -  -  - - - --  -     -  ---    -  -  -  -- --  --      - --         --  --    -- - -  --
-  -    -   -   --       -    -    -      -    - ----    - --  - --  - -  --- -     - -   -        -
--       -      -    -  -- - - - - ---  -  -   -      ---     - -      -    -   -       - - --     -
- -  ---  --  - --  --- ---- - - -      - ---  -   --   - - -       -   -----    - -  - - -        -
-  -- - -          -   --   -  - -- -     -    - -   -  -    -- -     -     --    -- - ---   - -  --
- - -         - - - -   ---   -   --    -       --- -    ---   --       -  -- -      - - -       - -
-     -  -   -- -  -- --   - -   -   -          -        - --     -    --    - -    -       -      -
------           -  - -     -      - - -- --      -- -   -    --  -  - ---  --- -  -    -  -- --   -
- -       - - -  - -     -      -     -  -  - -       -       -     -     -    - -     - --  --- - -
-  -   --     --  - -  - - - -   - -  - - --    -    -   -  -- ----         -       -  - -    -  - -
-    - -- - --    -   - -  -      -      --  -  --  - ----  -    ---   - -- - -  -      --   - -   -
--- --       - -  -   - - - -  - -    -  -  -   - --  -      - -     --     -        --   -- -    --
-    - -  -- -    --- -- -      -   -       --      - ---  - -     -  - -   - - - - - --        -- -
-      - -   -- --   - -       -   - ---        -  --      -     - --    -  -    --     -     - -  -
- -     -   -         -  -          -        -   -  -      -  - --   - --   - -  - - -     --    - -
-      -- -  -  -         -  - - -          -      --   - -  -    - -  -   -   -  - -        - -  --
-- -  --  - -   -- -     --         -  -      - -  - - -  -   --        -    --  -   -   - - -    --
-- -   - -         -       -   -       -- -         - -          --    -    - --  ---         -    -
-- -- -   - -- -    --    ---  - -  -   -  --    -    --  --- -   -  -  - - - --  -       - - -  - -
-       -         -    --  - -   --   --    - --        -            - -- - -   -        -  -      -
- -- --        -    -  -      - -  --  - -    - --          - - -- - -      -  -    -   -  -   -- --
- - - -  -    - -     - --     -  -  - -      - -  - -    -     -       - -      -    -  -- -- -   -
-   --  -   -  -        -         -  - -     - ---    -   --  -- -   --  -    -----  -      - --   -
--  -    - -  --    -   -     --  -- -   -  -     -     -  -    -  -        -  -    - -       -   --
- ---        -       - -      -  - -  - - -  --  ---      -       -- - -         - -    -  -   -   -
- -  -- -    - -   -    - -- -       -  -   - - -    - --  --  -     -  -  -  - -   ---    -    ----
--   -  -   - - --  -- - - -- -     - -  - --   - -  -- -       -  -  -  - - --  - -  -       -  - -
-- - - -  -  -  -   - - -    - -  -   -- -     - -  - - -  --  -       -  -- --          -- --  - --
- -    -  -      -    - - -- -  -  --- -       --   --- --  -       -                ---  -      ---
-- --    -- - -- - - - - - -  - --   -   -  ----   - - -       --  -  ---    -  -                  -
-- -  -   ---  - - - --    -  -       -           ---- -  -- -     -      -    -    -   -       ----
-     - - - -- -      -  - -   ----  -    -   ----     - -   --   -       -  --    --    -     - - -
-  -    -     --  -             -   -  - -    -   - - -    --    -  -     - -  -     - -   -  -  - -
-     - --- --    - --    - - -       -   -- -  -       -    - - -    - --      -  - - -     -    --
-        -   - -  - -         - -  -  -    -  - - -   ---  - -     - -   -  -- --- -  - --   -     -
--    -    -  - - -- -    -     --  --  ---       -    -    --    -  -   - - -     - -      - -    -
- -   -  -- -    - -  - -          -    -       --   -    -    -    -       -   -    - -   - - -- --
- -        --  -             -      - -  -          - -- -  ---- -- ----    -    --- -    -  -  -  -
-     - - -   - --    -   -- -  - -    - --     --                   - --  -  -     - -- - -- -  - -
- - -    --   - - - - ---      -   -        -   --   -    -- -   --  - - - -     -   -  - -        -
-    - --    -              -         --   --  -  -   -  --     -        -    - - -  -  -     - - --
-    -- -     -  -      --    -----    -   -    -- -    -  -           --  -          ---       - --
- --     -    -       -             -  --  -     -        -  -   -   -    - -  ------    - - - --  -
-  ---         - -   - -  - - - -  -  -    - - -   ---  -  - - - -  -  -  -   -   -  - -       -   -
- -  -      - - ----     --     -  --  -   --        -- - --    -  -   - -  --  -  - --  --- -- -  -
--  -       --  - -     - -- -    --       - - - - --      - -- --   - - -- - -  -- -   -   - - -  -
-     -         -       - ----   - - -  --   - -     ---  -     - - --  -  -    - -   -- ---  -    -
- -    - - -- -   - -        --  - -- -    --  - -- -    - --- - -    -  -  - -  - - -  -      --  -
- - -       - -        - --  -- -    -  -- -   - -- -  - -  -   -   -   -    -   -- -  -     --    -
- - --      -  - -              - -  - -    -   ---   -   - --- -      -   -  -    -  -  -  - - -  -
-           --    - -   - - --- -        -    - -- -  - -  - -     - - -     -   -          - -    -
-   --- -          -- -  -- - - -- --     - -        ---  -   --   - -    -  - --   -  --  - -     -
-       - --  - - -     --   -- -      -  -     - -    -   -     --  -       -     - - - -     -- --
-  -   --   --- -- -  - -      - - --  - --                  ----   --    --    -  - - - -    - -  -
- -  -    -  - - -  -  -   -  --             --  - - -- -   -     -   - - -- --  -          --- -- -
- -    -    - -         - -            - - --          - -   - -  -- -      -   -----  - - ---- -  -
- -- - -   - --   -   -       --    ---   -   -    --- - -- -   - --  - -  -  -   - - - -  -   -   -
-      -   --       -   - - --     -  -    -   --   -  -     ---   -    -  --   -      - -  -     --
-   -  -  ---                       -    -   -    -      - -  -           - --  ---  - -          --
-     -       - --- - -  -  --  --   -   -  -   -   --  -     - -       --     - - ---      - -  - -
-  --   - --   - -  -  -  - -   -  -                    --  --    -  -    ---- --    ---  -    -   -
---- -- -    -   --   --   -  --  -     --       -  -   - -  --      - -      -   -       --   -   -
-   -   -        - - - --    -       -  - -    -   -       -  -      -   -    -  -      --         -
--     -  - - ---    -   -    - ---  - -  -   -  -   - - --  -     --               -     -   -- - -
-   --     - -   -    -  - -  -   - -    -           -- -  -   -  -     -- --   -    - - --     -  -
---  -  --- --           - -       - --      -- -     ----    --        --       -  -   -- - ---   -
---     -   -  - - -   -- -  --  --    -- -   -     - -- - - --      -     -     -    - - --  -    -
--   -  -    -  ---        --  -   -       - --  -     - -      -       --  -  -   --  -  -     -  -
--- --   - --      - - - -   - -      -   - -          -   --- --     -  - -    -         -  -    --
-  -  -   -- --     - -   --   - --        ---- -   - -      - -   -  - --  - - -    - --  -   -   -
-     ---  -       - - - -  -       - - -        -  -- - -      ---  ---  -  - ---  -  -- - -  - - -
-- -  -  --  -    -  --   --   ---  -       - --      -     - -- -  -- - - ---  -  -   - -  - ---- -
-       -      -        -    ---              -    --   -- -   ---                   --            -
-        ---    --        --      - -        -   -     --- - -- -   - -        ---     -    --     -
- -- - -                    -  --   - --  - - --        -   --    -- - ----   -   -  -         -   -
----------------------------------------------------------------------------------------------------
