41
27
+++++++++++++++++++++++++++++++++++++++++
+              -                        +
+              -                        +
+              D                        +
+              -               ---------+
+              -               -        +
+              -               -        +
+              -               -        +
+        -----------------     -        +
+                                       +
+                                       +
+                                       +
+-W--------------                       +
+               ---                     +
+               -                       +
+               -                       +
+               -         ---    -------+
+        --------         -             +
+        -                -             +
+        -                -             +
+        -                -             +
+        -          -------             +
+        -                -             +
+                         -             +
+                         -             +
+                  T      -             +
+++++++++++++++++++++++++++++++++++++++++
