100
100
----------------------------------------------------------------------------------------------------
-  -  -  -    - -    -  -  -     -- - -  -   -      --  ------ - -  --  -    - - -- --- --   - -   -
--- --  - ----     --- - -   -- -  - - -- --   -  -- - ----  -   - - ---  --- --    -  -  --   -- --
- --  ---- - - -  --  - - ---  --   -- -  -  ---   -- --  -  -    -         - -- --- - ---   --  - -
- - -  - - -  -      -- - -  --   --  - - --- - --    ---- -   -     ---- -  --- -  -   - - -  -   -
- - -   -     --- --- -- -   -  --    -     --   -   -    -- -   ---- -    --   -      -- --- --   -
- -  - ----        -  - -  --  -- - -  - - -  - ---  -  -  - -- -    -    - -    -- ---  -   -- - --
- - - - ----  --        -- --   - - - - ----  -  -- -   -- ---- --- -   ---   - - -       ---  -   -
- -   -- -  --  -- ---  -   - -- -  - - -    -       --- -     -  -  - -    -    - --        ----  -
- - --- ---- - -- -     -  -    --   --   --- -  - --- -   - - --- --- - -   --- --    --- -  -  ---
-- -   -  -    -  -- --   -  ---   - - - - -   -- -   -   --    --  - -  - --   -   -- -       --  -
---  ----   --      -- -- - -   -     -   - ---  --- - - -          --- -----  -  --   - ------    -
-     --   -  - --    ---- -   --  --  -     - -  - -- -- -  --- -   -    - -   --  --  -    - --  -
- ---- -     -- -  --- - - - ----  - -  -   ------        --     -            -     ----- ----- -- -
-  - --    ---   --  -- -- -     - - ---    -   -  -- - - - -  -- -- - -   - - - ---     -- - - - --
- - -  - -- -  - - - - -    - - -   -   ---- - -  -             -   - - ---- ---    --- -   -      -
-  - - - - - - -- ---    --- ------- -   - -    -     --   - ---  - -       -     -  --  - ---- -- -
-  --   -  -   --- ----- -  -    -   -   - - - ---         --- - --  -  ---- --- -   -- - -        -
-- -  - --  -   --       - --   - -  -  - --  -   - - -- --     --    -     -   --   -  --------- --
- -  --   - - ---     --  -   -   -- --     -- --   --    -   -- - ---  ----   - - - - -     - --  -
- -  ---   -     -- - -- --- -  --  -- -    - -- - -  --  ---- --  - -  -- --      ---  - - - -- - -
- - -- ---  ----- -- -  - - - - - -  - --- - -   ----    -   --  - -    - --  --  - --- -      - - -
-   --   --- --- - -  - -    -- -  -- - --- -  -- -- ------- - -    -      -    - - -    ----  -----
- --  -    -- - --   -- - -  -- -- ---      - - --  ---     - -- --    - -  -- -  -  -   --- --    -
- -   - -  -   --   - -- - -  --  -   -- --- - -- -    - - -  ---- --    - -   ---     -  --  - -- -
--   ----  -     --- -    - - - - -- -  - - - - --  ----  --- -   - --- -   -- -- - - -- ------  - -
-     -  --   --  -  --  ------ -- -   -  -       -- -   -  - ----   - ---   -   ----  - - - - -- --
- -- ---   -- - --  -  - -- -  -   -  - - - -   --   -    - -- - -  -  -   -  - -       - -   -- - -
- - -  - --  ---   - -  -  -  -- -  -  --  -- -  --    ----- ---  --  -  -- ----  ---   -- ---  -- -
-        - --   ---  --       - -   --  - - --  --  --- -  -  - -  - --- -     -   -   -  - -  - - -
--   - -  --   --   --    -   - - -   -  - --- - ---   ---  - - - ---    --- -    -- -      - - -- -
-  --     - --  -- -      -- --- -- - -- -  -       --- -  -    -- -  - - --- -  -   - - -  - -  - -
- - ---- -    -- -   -- ----    - --     - - --------     - - -   - - -       - -   - ---   ---- - -
-   -  -  -- - -  --- --     ---  - - ---    - ---   -----  - -  --- - -   - --   - --  -     -- - -
- -- -- -- - - - - --  - -- -   -   -    --  -    - -       - -    ----    -  --- - -  --   -  - ---
-- - - --   - --  -      -  ----- --  ---  --  --  - ---    -   --  -  --   -- -- -  -  - -- -     -
--    -   -  -  -   -- -  -- -----   -  --   --  -            --- -- -  --    -  - - -  ---   ------
- --  - -  -  - - -   - - - -   -  - ----   ---- -- - ---- - -- - --       --- --- ----    - -   - -
-  - ------    --- ----   -  - -- ---       -   --  - -   ---- -    -  -   ---- -  -   --- -  - -- -
--- - -    - --   -   - -   --     -  --- --  -- --  -    - ---  - -       -      -- ---  - -   -- -
--  -  ---  - --  --------     - --    -    -- --  - - -  --   --- - ---  -    -      -     -     --
-- -   -   -  -   -  -        - - --- ----- -   -- -  -       -- -          -    ----   -  -- ---- -
-  --    - -       -  --   -- -       - --  - --     -   --        --  ---- -    - -  -  --  - -  --
- --  -- -   -  - -  - - -  -  ---- -- - -- -- ---   -  --- -- -   -   -  -  --- - --  - --- - -   -
- -   - -     --  --       -  -   -     -   ---  --  ---  - ---- -   -  - ---  --   -           - --
- -     --- - - -       -- - ---      ---- --  --  -- -  - -    -  -  - -   -- ----- -   - ---  -- -
- - - ----- -- -- - ----     -  --  --  - -  - - --     - -   - -- --         -      - -   -  - -- -
- -  -   -- -- -   - --   --       - - - ----- - -  - -- - - - - -- - - -- ---- - -  -  - - -   -- -
-  ----    --  --- -      -- - ------ -- -    - - - -    -  - -- -  -  - --    -  -- --    -   -  --
-- -   -- - - -          - -- --- - - - - - -- -    - --   - - -  --- -    ---- -- -- --- - - -   --
- -    - - -- -    --- - -  --  - -  -  -   --   ---- -  --- -  -   --- --    --     -    - -   - --
----  -  --- -  - -  - -  -  -----  -  - -    ----      -- - - -- --   -    --- ----   ----   - -- -
-  -   -- --------   - ---  -     -- -  - ---     -  ---    -       - - -- -- -- -  - - -    ----  -
--  ---  -   - -- -- -   -  -  -- -    --   - -      - -- - - - -       -  -   -    - -- - ---   - -
-  -   - ---  -- - - - --- -- - ----  --    -   - -   -  -- - - -  - -- - - -    -  -         ---- -
-    - - --  -- -- ---- - -- --  - -- --    -- - - ------    - ---      - -   -  --- -  ---- -    --
- - - - - - --   -   - --  - - -  --   -   -  - -- -    - -  - -   -----   -     - --- -   -   -- --
-  --  ----   --- ---- -  --- -  -  --- - ---    -- ---  -  --- - -    -    -   -       - - -      -
- --    - -  --    -  - -    ----  - -  -    --  -         -  - - ----  ---  - -   ---- - --- --  --
- - -- --- - -   --    -- - -       --   --    -- -- ---   - -   - -- --       --- -         - - - -
---   - - -     --  -- -     - - - - --    - - - - - - -  -- - - -    -  ----   -   -  -  - -- --- -
-  -         -- --  -- - ----  - --   -   --    --  -    ---    - -   - --   - - ---- -  -    --   -
--- --- -- ------   ----    -     -  -   -    -     ------   --- -    -  - ---  - -    -- ----   - -
--- - -   - - -   - -    -- -   -  -- - - -      --  -    - -          ---   --    --     -   -  - -
----  - -  ---   - -   -    - -- - ---  --    - -  -- -- - -  --  -- -    -  -   - - --  -  -- -   -
--- - -      - --- -  -   -  -       -  -  -- - --  -- ---  --  -   -- ---- - - -  -  ---   -- -- --
-  -      - -    -     --- -- --------- --  - - --- -  -      -- - -  -   --- - ----   --    -- -  -
---  -  --    - - -    - -     ---  - -   -       -- ----  -   --  ---- --    -    -  -- -  -    - -
-     -    - - - -- -    - -  - - --- -  -- --  -  --  -       -- --  -     -  - - - --     ---  ---
-  -  -    - --- - -   --- -- -- --     --- -  -  -- --   --        -  ------ -   -   - - -   -  - -
-   --- -   -- - - - -   -    -    - -    - ---  -  - ----  - ---- --  --   - -- ------  -      - --
- --    - -  -    --  - -- - - ---   -  --    -   --- - - - -        -   ---  -  -   ---- -     -- -
--   - -- ----- -   --- -- --   - --     - --     - - - -  -   -----   --   - -- -  - - -  - - -----
-  -    -    - ---- -  -   -  - -- -- - ---   ---    - -- -  - -        ---  -   -- - - -  -       -
-   - - -- -- - -- - - -     - -     - - - ---      ---  -      ---   -   - - - --          -   - --
-      - -    - -  --    -       - -- --  -     - --  - --- --  -     - ----  - -   - -        - - -
--   ---   - -- -  - - --- -      - -      - -- - - -- -  - -  - -  -- - -- --- -- - - - -   -- -  -
-   -- - -   - --  - - --- - - -- - -  -  - -   - ---- ---  - ---   - --- -       -- - -   - --    -
--   -  -  -   -- - -   --    - -  - - - -------    - -   --  ----  --  -  -   - - - -   -- -- -   -
- - -- - --- --  --  --   -  --- --   - - - --   --     -  ----  -  - - -- --   ---    ---   --- - -
-  - - --- - -    -  - ------  --  -- -- - - -- -- -  -  -   - --- -      -   --      -- -    ---- -
- - -  -   - - ---- ---   -   --    - -    - -      -  --- - --   -- -    - - - -- - -     - -   - -
- --- ----         ---   - -- -- -- -- ----   --  -- ---  -- - -- --- -    - ---   --    - -  -- - -
-- -      ---- ---     -   - -- - --       ---  -   -  ---  - -- -   - -     -  ---- --     --  -- -
-  - ------  - - - ----  --    ---  -- -----   - ------      -   --  -  - -- - -  ---   -  --  - ---
--  -     --- -- -    - -  --    --    - - -  - - -  - - - -  - - -     -  -   ---   ---   -  --   -
---- - ----     - - --- --   ---- -  -   -     -    -- - - - -- -  - -- -  - --     --- - - - -- ---
- - -       - -   -   - -   -  --  -   --  -     --  -   -   -  --   -- -----  -   -          -    -
-  ---- --  - -- -- - -   -  --   - -  - -- - - - - --  ---       - -- -  -   --  --  - -    - -   -
- -    - - -- --   - --- -  - - -    --- -  -- --   -     ----  -  - - --   -    -  -  -- - - -- - -
- ---   -  --   -- --    -- - -  -  - - -  --   - --    -- - ---  -  - - -   - ------ --- - - - -- -
- - - -- - --- -  --    - -- -- - ---- --- - --- --   --    - - -  - -   - -- -     - -  - -   -   -
- -- -    --  --- -- -  - - -- --    - -   - - - -  -   - - - -- - - -  -- -    -  -  - -   -  - ---
--     -- - ------ --     --   --  ----- ---  -       - --    - - -  -- -- --- --   - -  -      -  -
-  ----- - - -  - --     -  -   - - - -- -  -    ----  - - ---   -        -   -   - --  --  - -- ---
--- -  - - -- - -   -     --- --- --       --  - --- -        -      - ---  --  - --  -    ------  -
-  - - -  ----   -  - --     -   -   - - -   -        - ------- ----   -  --   --  ----  --- -  - --
-  -    -     -   -   - --- -  - - -    ----  - -    -- - --  -- -  - -    ---- - - --    - - --   -
-    --  --- -- - -   -  -- - - -  -- --    -  - - - -   - - -    - - - ---   -     --- --      -- -
----------------------------------------------------------------------------------------------------
