100
100
----------------------------------------------------------------------------------------------------
- - -   -  -   - - --  - -  -- -     -    --   ---     - - -  -    - ---     - -  - -  -- - - -- - -
-   - -    -- - ---  ---  -   -  --   ----   --    --- - - ---  -   - - - -  - --  - --  -- -    - -
- - -  --- -   -     -- -- -  - - - - - - - ------    -   -     ------ - -    -  - - -  -  - - - - -
- --  -   -  - - -    -   - - -  - --  -  -  -  -   -  -  -- --- -- -- -- ---         --- -    - - -
- -  -- ---  -   -- -  - -- - ---- -  -  - -- -- -- -  ---  - --   -- - -- -- - - ---       -- -  --
--     -   -- --      - --    -   -- -  -   ------ -  -   -  - -  -  - -- - -    - - -- - -     -  -
-- -  --  -       -  - -   - ---      - -   -     --  - - -  - ------- - --- - -  -     - -  -  -- -
---      --  -   -- --- --  - -  --- ---- - -  - -   -    - -   - --   --   --- --------  -- --  - -
-    ----      -   -  -   ---- -----  -   - --     -- --  -  ---    --    --  -       -   - -  --  -
- -  -- --   --  - --     - - - -   - -  ---  -   --    -- -   ----   - -    ---  ---  -- - ---- - -
--   -- - -- -- -- --    -    ---   -- -- - -  - - -- --   -----  - -   -   - -   ---  - --     - --
-   -  ---  --  --- -   -  -- --  -    -  - -    -- - - - --- -  -- - - ---  --   -  -     - -   - -
- --   -- -- ---       ----  -  --- -   - -  -  -  -  -     - -   - -  - - -  -  -  -- --- -    ----
- - -     - -   - -   -   ---- ----   -  - -   --- --  -   --  ---   - -   - -   - --     --  -- - -
-  --    -- -- -  -  - ---        - - -- -     --       --    -  - --- -- -    ----     --       - -
- -  -    - - ---- --- -  ----  - -  -   - -- --  --- -  - - - - -    -  -    - -  --  - -  -      -
----  --- - -- - ----- --   -   - - - -------    -  - -      -  -- --  -- --- -  - -    -   - -- - -
-  - - -  - - --     --   --     - ----- -    --  --   - - --   - --       - -  - - - -----   -  - -
- - -- -  -     ------ --- - -    ----   -   -  ---- -      - --  -  --- -  - - -  - -     ---  - --
- -- - -- -    -  -       -   - -     --  - -- -     -  ---- -   - -      - -  - --- - - -    -- - -
- - - - -   -- -----    -- ----    ---  -   - -   - -- -  -- - -   -    -   -- --   -  - - -  ------
-- -- --  ---   -    -  -       --    -- -- -  ----    ---   --  - - - - ----   -------- - - - - - -
--       -   ---   - - - - ----   -- -- - -  - -  --   - -      -- --- - --   -      - - - - - - - -
- -- ---    - --    - -- -    - -   -      --   - -  - - - - -  -  -  ---    -      ---     - -  - -
- - --- -- ---    ---  - - - -   - - ------   -  - -- -     - -- -- --     --  - ----  -   --  -   -
--- -  --- --   - - -  - -          -  -    -    -   --- -- -- - ---  - - -- --      --  - ------ --
-  - -  -   --  - - ---- ------  -- --       - -- - - -     - -   - -   -  -  -   ---   -   --    --
----   --       -- --   -      -  - -- -- --     - -- ------   - - - --- - --  -- - - - - --  - -- -
-  - --     -    - - --   --    ---   -    -  - - - -      ---- -- - - - - -- ----   - -    ------ -
- -  - --  - ---- - - ----  -- ---   - -  -  - --- - --     -     -   - --   -      -- - ----   -  -
- -- - - -   - -- - -  -  --  -   --   - ----  -  --    -   -- -   - -     -   - - -   -- - -  - ---
-- - -  - -  - -  - --  --  --- -  ----   -      - - ---- --   - - - -- ------   -  -         -- - -
- -       -   ---     --   -   - --  - --- ---- - - ---  - --- - -- - -  - - -  -   -  --  -- - - --
--  --- - - -    - -- -- -   -  -- - -  ---    --  -   -    - --   - -- -  -   -   - -      -  --- -
-  -  ---- - ---- -- -   - -   --  ---     ---- - - -  --     --  -    -  -  -   ---  - ---  -   ---
- -  -  - ---       --  - - -    -    -----  - -  - - -   - -  - - -   - -   - - --- -   -   - -   -
- -     - -  ---- - --  ---- -   ----- - - ---    --    - - --  -  --  - --- - -     ---   -  -    -
- --  -  - -- - --- - - -    --  -    -    - - ---  ---  - -  -    - -  - -- ---  -  -  - - ----  --
--- - --   -   -     --   --    - ----- - -  -   -   - --    ----- -- -   -   -- ---  -  -      - --
--  - -  - - -   --- -     -- -   -  --- -----  - ---- -  - -  -       -- --- - -   -   ---  - -   -
-- -- - - --  - -  --  - -- -      --  --        -  - -   -- --      - - -  ----  --   - -     - - -
--  -- -  -   -- -- -   - --  - - - - - ---      -- --   - -   - -- - --- --    -- - -- -  --- --- -
-  ----  --   --  -- -- - - -  -- --  -     - -  - - --     -  -             - - -  -     - - - -  -
-----  -- --- - -   - - - - - --    --   -- - --  -     - ----   --    --  -   --  -- - --   --  - -
-  - -- - - - - - --- ---   -  ----  - -- ---   --- -   -    - ---        -- - - --- --- --      ---
- --   - ---  -- - -- -   -   -- - -   -    --  - --   -   ----- - ----- - --    -  -- --   - -    -
-- - -   - - -  ---     -- - --- -  -   ---  -    - --   ----- --       - -  -- - --  -   -- --   --
--- -----     -    - - - - -  -  ----- -   - --- ---- ---         ----- --- -   - -- -  - -  - -  --
-     --  -- -  --- -  - ------ -- -  -  --- -  - -- - ---  -   - - -  - --- - --   --  -       -  -
-----  -  -- --- - - -- -    - -    ----    --- --      -  -  - - - - --   ---  -  -    --- -    - -
----   - -    --  -  - -    - -----   -  -  -         -- - --  --- -  - -- -        --- -  - - --- -
---  - -  - --      - - - - --    - -- - -   --     ------- - - --- -- - -- -  - --    - ------  - -
-  -- -   --  ---- - -- -  --  - -- --    -  -    - - -   ---   -- -   --        - ---    -  - --- -
-    -- -  - --   -   - -  -- - - -- ---- -- --- -   - -  -   -- - ---  - -  -   --  - - -       - -
---- -   --- -  -  - --  - -  -    --  -- ---   -  --  -- -- --  --   -- - -      - -  -  -- ----  -
--- -    -- - -  -   -- -- -     -   -   - -     -      --- -   - - ----     - ---- - -- - - -   - -
- -    --    - - -- -  - -  - - -  -- -  --- - - --    -  - ----  - --    --- -   -- - - - - - --- -
-  -   -  - ---  -    - - -- - -  - - - - - - -- - - - -- --   -   - --   - - -   - -- -   - - - - -
- -  --- - --    ----  -   - - --  - -- -  -  -- -- --   -- ---          - -- --  -   - - ---- -  --
-     --   -- - -    ---       -- - -  -  -   -- - - - -- --    -  -  - -- -      -----    -- - -- -
--  - -   -    -  -  - - ---------    -- --     -    - - --  -    - -  ----  - - --   - - - - --   -
- --  - -  ----       - -              - -     - - -       --    --- --     -       --  -- -- - -  -
- -- --  ---  -    - -- - - --    -  - - - -     -  ---  -   - -  -  -- -  -     --- ---  -- -- - --
-  - -  -      --- -   -    - - --  -  -  -  - --  -  - -   - - --  -    -      -     -- -- - - -- -
-  - --  - -  -     -- - ---   ---- --    --  -   -- -- -  --- -- - - -  -  -- - -     -  -    - - -
- - --   - - --  ---  ---  ---   - - -     - - -  --  -      --  ----- -  -- - -    -- --  -   - - -
-- --   -- -   --   -     -   -- - --  - -  -    -  --  -   - -      --    - -- - - -  --   --  -  -
--  - - -- - ---   ------ ---  -     -------   --  -----   -    -- -- - -- --   --- - -  --- -    --
--   -      -     -   --  - -- - -  --   -- -    --      -      --- ---       - -  ------  -  - - --
-    -      -  -- -  - -   -       -  ----    - -  - - -      -  -- -  -     - - --      ---  - -- -
--       -- - -  - -- - --  - - -   --    - ---- - - - ----    -- - - -  -  - -   --    - --    - --
-  --    --  - ----- -- -   - - -  - ----  -    ---   -   --  ----- ------  ---   -   - -  --  --  -
--  -- - - - - - -  -   - - -  -   -     -  ----   -   ---  --    -- - - -  -    - - - - -- --   - -
- --     -- --         - -- -   -- -  -  -- -- -  - --  - -- ----- -   -  - ---- -      -   -   -- -
-  - - - -- --  - - -- ---   - -- ---  --    - - -    -- -- -   --       -    --    - -- -   ----- -
--- -   - --  -  -         - -   -   - -  --- - -  --    -----  -   ---   --    - --   - ---  -  - -
-- ---- -  --- -- --  ---- - - --- -  -  -  - -- ----- -     - - --  - --    ---    - - -- -    -  -
-  -           - ---- - -- -----   ---    -       -  -  - -- - -   -   - --- - --- --    - - --    -
- --    - - -- --  -   -- ---   -  -  -  -- --- -   ---  --  - ----   -    -- --- -- ---- ---- -   -
--    - -   -  - --  --   -  - -  -  - -- -- ---         -  -   -  -   ----        - -  --    --- --
- --  -  -       -   - - - - - --- --- -   -    - - ---   -- - -    - --  - -- ---- -  - -- -      -
- -- - -- -  - -    -- -   - --  --   --  -  -   - -    -   --  - - - ---            -  -- - - --  -
--- ---  --- -- - -   -    -   - -  -     --   - - - ---  --  - -   - --- - ------ -- --       - - -
-  - -   ----   -  --   ---  - - -- ---    --- - ---    - -      --  --  - - -    -  - -- -- -     -
--- - - - -   --- -- -- -   -  -      --   -         --   -  -- -- - -   - --  -    --   - -- - - --
---- -   -    -  - -- -   - - -- - ----  - - -  --- - ---          - -    - -    ---    -  -     ---
- -- --- --     --  - ---  -  -  ----- -   -     --    -  - -     - - --  -     -   --- - -- ----- -
-  ---  -   - --    -   ---- -           --    -  -  -   - - - --- --   -   --- ----   ---        --
---      ---- - -- - ---   - - --- - --  -  -  - ---  -- - - -     - - - -- -     - -   -  -  -  - -
- ---  -  -  - -   --  -- - - -      - -   - ----  -   -    --- -   -- -  -- -- -  --  - -    -    -
-   -   -  - -  -  - --  -- -      - -  - ---    --  ---   - - -- -- - -- -----  -   ---  --- -  - -
-   -  - - -  --- - -    - - -  -     -   - - --- --  - -- - --    - -    -    --  -- -     -     --
-  - --  ---  -  - - -- - - --   - -    -  -     - ---- - - -    - -- -    - --  - -  - ---- ---  --
--     - -  - ---- -- -- --  -  -- -     -  - ---  --   - - -----          - -- -- -      --     - -
-      - --  --   - - -   - - -    ---- -       - -  -    - -    -  ---  - - - --- ---- - - - --- --
-----  - -- -- --- -    -- -  - -    ---    -- --  ---   ---  --    --   - --- - --- - --  -- -    -
-- -     -    - -            -   - --  ---         - ---    -  -  --     --  - -   - -   - - - --  -
- - -    - - -- -    -     - --- - - -    - -- -- - -   -    - --  -- - -   - - --    ---- -    -- -
----------------------------------------------------------------------------------------------------
