100
100
----------------------------------------------------------------------------------------------------
-    --      -- -  - -- ---- - - -      - - -- -- -- -- --  -   --   - - -  -  -- -- - --  -  -  - -
-----  ------- ---- -- -    -- -- ------- --  -- -- -- - --- ---- ---- - --- -- - - -- - -- ----- --
- -- --  -    -  - -  ------  -- -     - ----- - - -- ----  --- - - - -- -- ----- - --- --- - -- - -
-- - ---- -------- --- - -- --- ---------     --- -- ---- --   -- - --  - -- -   -- - -- - -- -- ---
- - --  - -- ---- - - - - - -- -- -  - - --------- - --  - ----- - -- --- --- ---  - --- ---- ---  -
- --- -- -- - -  ------ - - - -- - ---- ---  -    - -  --- - -  -- -- -- -   - -------- -    --- ---
- - - - - - -- --     - ----- -- --  - -- --- ----- ---  -- - -- - - -- -------  - - - ------  - - -
---- -- -- - ---------- --   -- - --- --- --- --- - -- --- -- -- -- ----- - -- -- --- - -  - -- - --
-   - --- ----   -  - --  --- - - -  --- -   -  - - -- - ---- -- ---  -  --- -----   --- --- -- - --
----- - --  ----- -- - ---- -- -------  ---------- ----- - - ------ -- --  --  -- --- -- - - - -- --
---- ---  --     - - - -   ----       --- --    ---- -  -- - -- - - --- ---- -- - -- - - - --- --- -
-   --  --- ------ ---- ---   --------   -- ----  --- -- - ---- -- - -- -  - ----- - - ----   - -- -
----- --- - -  -  - -  - ------- - -- ---  - - ----  -- - --   --- -- - --- -   ---- -- - ------ - -
-  -- - -- - ------ ------ -   - -- - -  --- - - - -- ----  ---- - -- ---  ----- - - -- -- - - - ---
--- - -- - -----   --    -- --- -- -- --- ----- - --- -- ---   -- -- -   -- - - - ----- --- --- - --
- - -- - -- - - ---  ----- - ---  ----  -- - - ---  --  - ------ --- ---- - -- --- -- -- - -  - -- -
- -- -- ---- ----  -- --  ---  ----   -- -- -- - --- -----    --- -- - - ---- -- - - - - - ------- -
--  -  - - - - - -- --  -- ------ ---- --- -  -- - --- -------  - -- -- - - ----- - ----- --- -   --
- ------ - --- ----- --- --   - - - - -- - ---  - -  - -     -------- ---- - -  ----   ---  - ---- -
- -    -- - -- -  - ---- - --- - -- --  --- - --- --- - -----   -- ---  -- - --- - ---- - -- - - - -
-- ----- ---  ---- -  - -- - - --  -- -- -----  - - - - -- - --- - - --- - ------ -   - --- --- ----
-- -- -- -  -- -  ----- -- - - - -- ----- - ----- - - --- --- --- - -  - ---    - ------- - - ---  -
--- - -- --- - --- -- - - - -- - --- - - --- -  -- ---  - ----  - - ------- ---- -     - -----   ---
-- - -- - - ---- - -- - ----------  - -- -- - --- --  ---- - --------  - - - - - -------- -   ---- -
- --- - ------ - -- - --   -     ----- ---- --- -- ---- -- - -   -  --- -- ---- -- -- -- - ----  - -
-- - -- --  -- --  - -- --- ------ - --    -- - - - - -- -- ----- --   -  -- -- -- - -- -- -   --- -
- -- -- - --  - ----- -- - - - - -- -  ---- - - ---- - --  - -  - - ------ - - -- ---  -- -----   --
- --- -- - ---- - -- - ----- -- - ----- - -- - -   - --- ---- -- ----------- --- -   -- ---  - -----
---- - - --   - -- - --  -  -  ----- -----  ---------   -  --- --  -       - -- ----- --   -- - - --
-  - - - ------ - - -- --------     --  - --    --- ------- -- ---- ------- --- - - - - --- - -- - -
--- ---- - -- - - - --- -- --  -----  --- - ----   --   ----- -- - -    -- - -- -- ------  --- --- -
- - - - -- -- - ---- - -  -- -- ------- - --  - ---- --- - -- -- - ----- - - -- -- -- - --- ---- - -
-- -- - -- -- ---  - ------ --- ----  - - - --- - - - - ---  - - ---   - ----  --- - - -- -- - -- --
- ---- - - ---   --- -- -  - -- -   ---- ----- - -- ----- ----- - - -------  ---  -- ---- ---- --- -
---   --- - - ------ -- ---- --- --- -- - -  - - - --  - --- - --- ---   - -- ----  ---  -   -- -- -
-  ---  --- - --- - -  - - - -  --- - - -- --- -- -  --- -- - -- - -  --------    ---- ------- - ---
--- - ---  - -  - ------ - - ---  - ---- - -- --- --- - -- ---  --- --- -    -----   --     - --- --
-- -- -- --- ---- - --  - -- -- ---- - --- - - -- ----- - ----------   - ------ - ---  ------ - - --
-- - --- -- -  - - - ----- --- -- - - - - ----- -- -   -----  - --- -----  -   ---- --- -  - -- - --
- ---- - -- --- -- --    --  -- - - --- -- -   ---- --- -   -- -  - -- - -- ---  - - - - -- -  --- -
---  - - -- ------ ------- -- ---- - - - - ------ -- --- --- -------  ---- -  --- -- ---- - --- ----
- --- - -- -  -  -- - -  - - - - - - - --- - -  - - - - - ---- ---  ---- ------  - -- - - - - --   -
- -- -- -- --- --- - - ----- - -- -- - -  --- -- - ---- ---   -  --- -  -- - - --- --- -- - - - ----
--  - --- - -- -  ---- -  - ----- - -- ---  ---- -- - - -- ------- - ---  - --- - - --- ------ -   -
- ----  - - ------ - -- ----   ---- ---  ---- ------ ---- - -- -- ---   ----  - ---- ---    --------
--- ------- - -  - -- -- ------- ---- --- - -- -    -   - --  -  - - ---   ----- -- - ------  -    -
-  --    - - - ----  ----  -    -- - -- - --  - -------- --------- --- ----- - - -- -- -   --- -----
--- ----- -- -- -  -- - --- ---- -- --- --- ------  - - -      - --  --    - - - ---- - ---  ----- -
- -- - - -- --- ---- - -----  - - -- - -  - -    --- - -------- ------ ----- - ---- - --  ----   - -
- - - - - -- --- ------    ---- - -- - --- ------   --- --  ---- - -- --- --- -  - --- ------ --- --
-- -- ---- - - --    - ---- ------  ------ - -   ----  -  --  - - -- -- --   ----- - - - --  ----- -
- -- - --- --- - ------   - -  - --- - --- -- -----  ----- ---- -- - - -  ---- --- - - - - -- -  ---
-- - - ----   ---    - ----- --- - - -- - -- --    -- -   - - - - - - ---- -- --  - -- -- - -- --  -
- -- - -   --- - ----- -   --   --- ---- -- -- ---- - ----- - - --- -- ----- -  ---- --  -- - - ----
---- ------ - --- - - - --- ---- - - -- -- - -- -- --- -  --- - -- --- ---  ---- - - - --- -- - -  -
--  -  -   ---- - - - - --- ------ - -- -- - --- - - -- --- -- - - - - -  -- - --- --- - ---- -- ---
- -----------  - - -----  - -   - -- ----- - -  --- -- -- - - -- - - -- -- - --   -  --- -- -- - - -
- -   - -- - --- --  - --------- - - -   --- ---  --- -  --- ------ ---- ----  ------   --- ---- - -
- ---- -- ----- -- -- ---  -   - ---- ---  ---- -- -- ---  -- -  ---  -- -  ---  -- ----   --  -- --
-- -  -  --  -- -- ---   -- ----- - - ------ - -- - ---  -- -- -- - --- - -------  --   ---  --- - -
-- ------  --  - ---  --- - - - - - - --- --- - - - - ---- - -- ------ --- -  -  -- ----- ---- - - -
- - -   --- ----- - -- -- - - -- - ---  - -  -- ---- --- --- - -   -- ----- ----- - ----- - -- - - -
---- --- - -   - -- - - ---- ------ - -- ----- - -  -  - -  -- ---- --    -- - - -- -  - ---  ------
-  - --- - ----- -- ---- - --- -   ----- -   ---------- ---- - -- -- ------ --- - -- -- - - -- - - -
--- --  ---    - -- -  --- - - ----    -- ----  - - - - -  ----  ----  - - - ---- -- - -- --- - - --
--- - -- - ------ -- ---  - ---   -------- -- -- - --- ---- -- -- -  --- - --  --- -------  - ---- -
-  ------- -- - --- -   ----   --- -  -- -- - ---- ------ --  -- ---- -- - - --- --    - --- - - - -
----  -   - - - -  ----- -- --- - - --- - -- --  --  --  -- -- - --- - - ---- - -- ---- - ---- -- --
--  -- ---- - - --- -- - -- --- ----- - - - -  -- ---  ---- -- ----- -- -  - --- --  - ---- -- -----
- --- - -  -- - - - -- - - - - - -  -- -- - --- ---- --  - - -- --  - - ---- --- - ---- - - ---  - -
----- - ------ - - -  ---- - - -- -- - ------- -   --- --- - ---- --- -- - - -  - --- -- - - - -- --
--  --- -  - --- - ---  ---- ---- - - --     - ----  --  - - -- - -- - - -- ------ - - - - - -- ----
- --  ----- - - --- ---- -- -  - -- --  -------  ---- ------- -- -- -- -- ---- - -- -- --- - -- -  -
------  -- --- -  ---  -- - ----- --- -- - ------  ---- -- -- - - - -- ---  -- - - --- -- ------ ---
--  ----  -- - ----- --- -- --   -- -- -- --   - -- - -- --  -- ---- - -- --  --- -  - - - -  - - --
- ---   -- -- -     - - - -- ---- - --- --  ---- --- ---- --- -- -  ---- - --- ------- - -- --- -- -
--   ---- -- -------- - - -- - - ---   - ---  --- --- -- -  --- ----- - -- -  -      - ---- - - - --
----- ----- -  - ---------- --- --- ---- -- --  - -- -- ---- ---  ---- - - ------------   - - - - --
-   -- -  - --- --   - --  - -- -- - - -- - - ----- -  -------  --  -- ---- -   -- - ------- -- - --
---- ----- -----  ---- - ---- --- -----  -- - -  - ----   - - -- ---- -   -- ---- - -- --  - -- - --
- - -  -  - --- -- -- --- -- - - - -- --- ------- ---- --- --- - -- - ---- --   - ---- - --- -- ----
-- ---- --- --- - -  - -- - -- ----  --- - - - --- --- ----- --- - -- -   - ---- - - - - --- - -- --
- -- -- - --  - - ----- --- - -  - --- - -- - -  - ---- -  - -  - --- ----- - -- -- -- --  - --- - -
-- --  -- - --- - ---- - ---- -----  -- - - -------  - - -- ------ - - - - -- --- -- - - ---- - ----
--- ---- - ---- - -  - - --  -   - --- ----- - - - --- -- -- -   - ------ -- -   ---- - -- --- -   -
-- -  - -----  --- --- --- ------- -- -  -  - -- -- -- - - -- -----  -  - - -----  -- -- - - -------
- ----- - -- -- ---  --  --   --- - - --------  --- ---- - --- - - -- --- --- -  -- -- --- - -  - --
----------  - --  ---- --- ---  - - -- ---    -- ----  ----  - - - - --- --- - -- - --- - --- ---- -
- -----   --- ----- --- - - - ----- - -  ----- --  - -- -- ---- -- -- - --- -- - ---  - --   --   --
- -    --- -- - -- -- - --- ----   -------    -- -- --- -- - -- ----- - -  -- -- - -----  ---  --- -
-- ----- - -----  ---- - -- -  ----   -- ------ -- --  -- - - --    - - ----- -- - - -- -- - --  ---
- - - --- - - - --  - --- - --- - ----- - -- - -- - --- - - --- ----- --  -- -- - -- -- -- - - -- --
- ----  - -- ---- -- -  ----  - --  --- - -- - -----  - -----  - - - -- -- --- ---  ----- -- - - - -
-- -  --- ---- - -- ------  -- -  --   --- - --   - --- -   ----- ---- --- - - - --- -  --- -- - - -
-- --- - -   -- -- - ---  --- ---- ---- - -- - ---- -- - ---  -- - -- -  ---- - - --- ---- - --- - -
- - --- ------ -- -- -  --  - -- --   - --- - ---- --- ---- -- --- -- --- -- -- -- -- -  - - - --- -
- ---  --   --- -- ----- ---- -- - ------- -- -  - -  -   - - - ---- --  -- -- - -- -- --- - -- -- -
- -  --  ----  -- -   - -   - - - -     - - - --- --------- - - -   -- --- - - - - -- --  ---  - - -
----------------------------------------------------------------------------------------------------
