100
100
----------------------------------------------------------------------------------------------------
-            -   -            -     -      -----  -            -                -    -  -    -     -
- -    -  -    -   -    -  -    --    -   ---- - -      --   --    - -       -    -  -     -  -   --
- -  -            -         -           --                 -              -   -         -          -
-   -   -               -    -      - -           - -                 -    -- - -    -             -
-                -     -                   --       -           -   - -  -        -            -   -
-  -  -        - -                -           -   --    -             -    - -        -      -     -
- -            -                -     --    -       -- - -    -    --   -         - -   -      -   -
-    -        -      -        -     -   -       - -  -       -   - -   - --  -      - -   -      - -
- - - -     --   - -               -                  -         -    -       -    -        -- -    -
-    -  -               - -   ---  --         -        -                                -      -   -
-   - -      -     -  -     - - -               -          -     -       -    --          -      - -
-    -    -       -         -     - - - --- - -   -  -              - - -      -  - ---    -       -
- -               -    - -  -  -  -        -    -        -            - - -   -      --       - -- -
-    -    -     -      -        -  - -     -         -     -  -   -   -          -      -          -
- -        -          -            -      -    ---   - -    - -    --   -            -    -  -     -
--      -    - -- -                   -        --             - - --             -       -         -
-        --     -     -  -   --         ----   --    --- -         -               -    - -      - -
-     -             -- -  --     - -         -- -    -  -  -- -- -    --       - --      -  -      -
- -   -    -     -   -                 -  -           -         -   -     - -       -  -        -- -
-- -    --   -           -         - -    --            -   -                       -            - -
-- -   -         -           -       -        -   -  -    -               - -          - - -    -  -
-           --  - -  -                   -   - --   -     -    - -  -       -- - -            -   --
-  -      -        -      - -     - -   -  -      ---  - ---     -         -              - -      -
-     - - -                 -       -  -    - -              -    -  --- -  -      -      -        -
- - - --  -  -          -                      -   -     - -   -    -     -   --     --   -   -    -
-  -        -- - -     -    -        -               -          -     -    -    -        -     -   -
--         -          - -    -     ---       -          -   - - -             - -  -      -   -    -
-   -  -   - - -           --   - -      -                  -       - -    --   --    -            -
-              --     -       -   -   -           -    -             -  -   -       -      -  -    -
--  -     -       -   - -  - -     -                    -  - --                 -     -  -  -    ---
-               -    --       -            - -      -           - -- - -- --        - -       -    -
-  -  -       -          -  -   -    -   -     -    --    -       -           - -   -        --    -
--  -    --  - -                          -             -  -- --      -  - - -    -  -      -     --
---      -   -                              -       - -  --       -            --                - -
-          - -           -    -            -         --   -        -   -          -                -
-  -         -          --  -           -      -                                    -- -       - - -
-  -    -- -   -   -  -               - -       - -    - - -  -  -        - -    - -    -         --
-   -   --         -  -    - --     -       - -    -    --              - -    --   -              -
-    --        -           -       - -  -- --   -  - -   -    -       - -               -   -     --
--                  -   - -     - -   --  -      - -         -         -      -                -  --
-    --       - -       -    -       -  - -       -                 --            - -- - -   -     -
-             -    -     -              -                     -   -     - -          -    -     - --
-    -    -- -   -     -       ---    --  - --  -  -  -           --     --     -  - -             -
-    -        - -      -  -         -       - -                     -   -  -      -    - -      -- -
-                        -          -        - -               -     -   - --- -             -   - -
--   -  -          -                 -            -  -    -              -      - -  -   -         -
-     -      -              -        -  ----   -                             ---  -   - -   -   -  -
- -           --    -  - -       -                         -      ---  -    -         -     -      -
--    - - - --     -   -   -    -   -        -  -    -              -      -    - -  -    -    - ---
--  --    -   -        --  --     -  -                    -               -    -   -      -    -   -
-  -   -  - -      -      -- -    - -   -   -  -                     -           - --        -  - --
-        -     -  -- -  -     --        -      -               ---   - - --          -         -   -
-    -         --           -       -    - - --       --           --    - -            --  -    - -
--    -   -   -  -- -    -                      -    -       -       -   -         - -  --  -  -   -
-- -      - -  -             --             -   -         -  -                 - -     --     -   --
-        -    - --   ---      -     -                     -   -  -                              -  -
-  --    -                        - --    --      -      -        - --  -                - -       -
- -  - -                  -   - -             -      --       - -               -     -           --
-        - - - --  - - -      -      -  -      -      -  -       --       -     --- -       --     -
-   - -       -     -  -        -    -       -        --          -           -      -   -    -    -
-             - -  -   -         -      -                         -              --  -    --     - -
-- -    ---   -     -          - -   -            -   -    -       --               --    -        -
- -   -        -    -  -   -     -      -      -      -     -   -            -   -  -          - - -
-    --  -   --     -       -         -- - - --      -         -  -   --    -  --   -       -      -
--- -      -   -    -      -         -     -        -  -        -   -       -  -  --  -        -   -
-     -                   -           -             - --           --      -    -- -       -       -
-     --         - - -                          -   -   -   -   -  -  -    -         -             -
- -                        -           - -               -  -                         -         -  -
-  - -      -    -      -  -  -     -   -  -                   -        -   --           -   -   - -
- -     -  - -           --    -      -  -           - -           -   -  -            -     -     -
- -   ---  - -    - -     -      -       -                   -            - -          -  -    -   -
-          -               -       -  --     - -                       - -          -       - -  ---
-    --             -   -  - -    --         --        - -     - -     -   - -                 -- --
-       --     -  -  -      -  -      --     --  -     -       -  -   --- -    -  -  -  -          -
- -     -   - -    - -             -      -  -  -    -   -      -   -           -         - -      -
- -                -  -     -   -       -    --  - --       -- - - -        -     -       - -  -   -
-   -- --   -- -            -- -       --                         -  -        -  -       -         -
- -       - -  - - - -   -  - -       -                     - -              -                     -
-        - -   -- - -    -     -- --    -- - -   - --           --  -             - -  --   -  --  -
-                 -            -   -   -       -    --     -  - -  -           -         -     -   -
-     - - -   -      -      ---       -     -       - -  -       --   -   -  -           -      -  -
-    -                         --  -- -    -       -         - -         -         -              --
-                      -- --                 -  -- -   - -      -     -      -  -    -             -
-  -  - -    -  -  -     -       - -    -     -                     -          -   -     -     -   -
-       - - -  -      -- -          -          -    - -      -  --   -   - -        -      - -     -
-         -      --     -    -       --   -   -      -  - --          - -       --   -  ---       --
-  -   - -      -   -         - -            -   -     -   --         -         -              -  --
-                 -   --    -     -   -  -      -   -       -         - -   -    - -        -    - -
-  -         -               - - -    -  -      - --  -     -        -  -      -    -      -       -
-            -     -  -        - -     --    -       -  - -          -    ---     -    -    -      -
-   - -     -            -   -   - -               -  - -      -          -    -      -            -
-           -      -    -      -  -  ---     -       -    -  -                -                    -
-- -       - -            ---             -         - -   -    -   - -   -          --      - - -  -
-   -            -   - -  -  - --             -         --- --          -                 -      - -
--      -   -  -            -  -    --          -       -  --- --        -       -   -  -   - -    -
-           -  -     -       -      -    -  -      --      --  -  -       -         --    -      - -
-       -     -   -                   -   - -            --               -              - -  --   -
-         ---                  -             - -  -   -        -   -                -- -           -
----------------------------------------------------------------------------------------------------