100
100
----------------------------------------------------------------------------------------------------
- -- - - - - - - - - -- --    - -   --   - -      - -    --  - -    --   --     - - - --   -- ---  -
-   -    - --  -  - -  -  -- -  -- -    -     -    -  --   ---      -    - ----- -   - - --      ---
- - - - ---  -  --      -       - -- -  - ----  ----- -  ---  - --    --- --- -   - - -    - ----  -
-  -- -    --     --      ---- --   -     - -- - - -- -   - -- - - -    --      - -  - ---- -    - -
-- - - - --   -- -   -----  ---  --- -- -- -   - - - - -      -- --   -  -- -   -- -- --   - -  -  -
- ----- -   -- -- ---    -  -   - -- -    ---- --  - -  -   - ---  --      -     -  -      - --  - -
-       -- - - - -     - -     - -  --- -  - -    --- - -- - -  -  -- -     - ----- -  - - - - --  -
-- -- -- - -- ---   -- -- -    -- --   -  -     -- --   -    - - - - -  - - --  ---   -  -    -  - -
-   -   - --   - --   - - --- - -   --  - ---- - -    - -   - -- --  - --  -- - -  - - -   - -- -- -
-   ------  -  -- ---- -    -  - --   - ---  - -   -   -- -  ---- -  - -  - --   ---   --  ---  - --
- -   --  -- -- --   - - --  - - ---  -- -  -    - ---     -      - -    - -  -  - -- -       --  --
--- -    -  -- -    ---  --  - -  -    -- -     -       -  -  -  -   ----- -- -- - - - ---- -    - -
- - - - - -  -   - -  - --   - -- -    - -  -  -  ----   - -  - -- -  -   --   -- - - -   --  - -- -
-- -       - -  ---- --- ---- - - --    -    -   -- ---  - --   -- -   -- - - - - -- - ---  -- -- --
- -- - -      -   -   - -         - --  - -   -        ------  --   -----  -         --  ---     ---
-   -- --   -   --    - --- -----   ------- -      -     -   - - -        -  --   - --  -- -  --   -
- -  -- - --- ---  -  ----  -  -       - -   - -  -  - -  ---  - -   -   - --- --   - -  - -    -- -
- -  -  - -- - - - - -     - - - - -- - - --   ----    - -   -   -   - --       - - - --      --   -
--- - - -   ---  -- - --    - -   - -   -- - --       ------- ---    -   -- - -      --   -----   --
-  --   - - -   -  -   -- -  -    -    -   - ---  - --- -   --        ---   - -  -     -  -    - - -
--- - -      -- -- ----  - --  - -      --  - --   -- - - -  -- -----   -- - - - -  ---    --  -   -
-   - -- ----    - - - -  -   --- -  - - - --- - -- -   - - - -      ---- - - - - -   - -- ---- -  -
--  ---- - - --  - -  -- -  --         - -- - --- - - --     - -  -- - - - --  -  ----       --  ---
-- - -  -- --  - ----   --- -  -  ---- -  --    -  - -  -- --- -   - - - -   -  -    -  - --- ---  -
-   - -   -  --  -  ---  -- --       -  -    - ----      --      --    -- - - - -- ----     - - ----
-  --- ---  -  -  --        -   -  -- -- -- - - -   -- -    - ---    -- - --    -   -  ---  - -   --
- --      --  ---- - -- ------- -- -  -- - ----- --   --- -- - -  --  --    - --   -  ------ - - - -
-  -   --   -    - --- -         --  -    --    -    - - - - -  -- -   - ----  -     --    ---  -  -
-    -   ---  -- --  -  ---------      -    --  --- -  -   --  -  -  -  --   -  ----- - -    --- - -
- -  ---    - --   - - -     -  -  -- - ---- - -   --------    -      --     -      --      -   -  -
-       - -- -     - -- --  - --   - --- - -- -  -  -  -- -    --- ---   --  - -  -  ----      - ---
-- ----  - - --  - - -- -   - -   - - -    -- --- -   -  --- --  --      - -- - --  ---  - - -   - -
-    --     -  -   - -    --   - --    - -- -   - -   ---  - -     ---   --  --         ---  -    --
- ---    --  -   -- - - -   -- --        -  - - -  -- -- -  - -- --- -- -     - - -  -  -   - -- - -
-  - - -  -  -- -   --   -  -   --  --  ----- - - -  --- --- - -        -     -  ---  - - - --  ----
- -  -- - --- ---   -   -   - - -     --  - --   --- -- - -  -- -- -    -     -  -- - -  ----      -
--  - -  -   - - -- ------     - --   - -- -- ---    -  -  --  -- -   - -  --  -     -  - -  -  - --
- - - - - ---  - -  -       -- -- -  ----   -    --- - --   - -  ---- -   -     -----  ---- --   - -
- -  --    -  - -     -----  ----- -    ----   -    --   - -- --    -- -  - -- - - ---     - ---   -
-- - -- - ---   -   -      -        --         -  -  --- - --- ----   -        -  -    -  -   - -- -
-  - -     -   --- -    ---- -         ---    - --     ---     - --- - --  -     - -- - - ----- -  -
- -    -   -  - -  ---  -    --   - - --- --  - -- -  -   - -  -   -- - - -- - -  ----   --  -   ---
-- --  ---   -  ---   -  - -- - ---        -  -  --- -  -   ---  -- -- - --- -    -   ---  --- --- -
--   - --   -     ---  --   - -   - ------  ----   -  - --- -  - ---     -    - -  --     - - -   --
-- - --- --  - --  - -- --  -  ---  -- --  --  -- --  -  - -   -  -- - -- - - - ---- -  -- -- ---  -
-- -- - - ---  --   -  -- - -    - -  - --   -- - -  - ----- -- ---     - -   -    --- -   -   -   -
-- -   --       -    --   -  --- -- - -   - - ---  - --   -   -    -- -- -   -   -  --- - -  - - - -
-  ---  - --        -  ---     --   --- --- - --   - - -     -- -  -   - --  ---- -- - -- -  - - ---
---   --    -  - --  - -           - - -    - - -- -  -  - --   - - ----- - -      - - - - -  - -  -
-- ---  ---- -  - --   ------  --- -- - -  -- -  -  -- - --  ---- - -  - ---  ----  - --- - -- -- --
-       -        - --  -      - - -  -  --     -- -  --   --    -    -     - - - - - - -  -- -- - --
-- -  -- --  - - --  --  --- -- -   - --   --- -  -    --   --   - - --   --        -  ----    -   -
-  -   -  ---   ---     - --   ---  - -    -  -  --     --  -  - -     -   - -- ----  -    -  ---  -
-       -   -  -  -  -  --   - -    -- -   ----- -- -- -   -  --   - -  --    --  -   -- --  --   --
- --- --  -   -- -  - -- ---     - -  -   -   - -  -   - -   --- -  -  -         ---- - - ---- - - -
--  - - -- --      -  -   - -  -   -----  - --- --  - - -- --  - --- ------ -  - -- -  - -  - --- --
- --- - -- -  --- ---- -- -   -   - -      - - -  - -  -   ------   -    - -- -    -  -- --    - - -
-        - -- ----   --  -- - - ---- --   -- ---  - -- ---- -  ----  --  - - - --- -- - -- -  -  ---
-  --- - -    -   --        -      - -     -- -  - -       - -- ----   -   -  -   - -  -- -  -  -  -
-  -   -  -    - -- -     -    ---- - -- ---    --- - -  -    --  -  --     --   - ----    -  - ----
--  --  - -- - -  - - - - -  --   -  - ---  --- --- ----  ---  -----  - --  - -- -      -   -    ---
-- -   -   - - -   --- ---  -  - -- --    -- --- - --   -       ---  -    --  - -  - -- ---  - - ---
-- - -   --- - - -   -     -      - - - -- -     - - - ----  -- -   --- -- -- - --  -      -- ---  -
- - -- - - - - -- -  -  -- --  -      -     ---- --          - ---     - - -  --  -- -- ---      ---
- ---  ---- -  -- --- --         -     - --     -  - - -  -- - -- -- -- -  --   -   -   -- -----   -
-   - - - ---  -- - - - - - -  -   - - --    ---   --    - ----- --- - -    - -  -   ----  - -     -
-  - -  - -      -  ----- ---- -     --  -      --    -   -   -   -- --- -  -  --   - -- ---  ------
- -- -   --      -    -  - --   -  -  -  - -----  - -  -- ----  - - --  - - - - -       - - -    - -
- -  - -- --  -  -  - -  -- - - -  - -  --- -    - - -          --- -     -   - - - -- -- - --  -  -
- -   -  -     - -- --- - --- --   -   -- - ---  - -  -   - - -    --- -- --- - -    -- --  ------ -
-- - -- --    ----   - - -    -  --     -   - -- ---- -  - - -   -- - ----         --- - -  -   -- -
-  - - - -   -  - ---  - - - -  --        -    - --  - - --- -- -  - - -- --- --      --  -  --- - -
-  - --- - ---- -- -  - -  - -  - -     -     - -   --      -    - - ---  -   - -  --  ---      - --
- - --- -   -     - - --   - -   -   - -  - -   -  -    - --- - -  -    - -  - - -   - - -- -  --- -
- --  -  --- ---- ----  --  -- - - - -  -   ---- -   - ---  -  --     - -     - -- -  - -  -   - ---
- -     - - -  -  - -- - -- -- -    - - -  -     - ---- -  -  -     ---   - - --- -- - - -  -   -- -
- - --   -- -- -      -    - --- -- -- -- -  -- - -    -   - -  --- - ----    - - - -     --   -- --
-  -   -- - -  -   - -- -- ---- --   -- --- -  --- -  ---    --  - -  -  ---  -    -- - - -      - -
--     -- --      -    -  - -     ----     - -   -   -   ---- - --  -  -    --  -  --   - -- -  -- -
--  --   ---- -    - -- -     ---   --    -- - --  ---  -   - - -   --  ---   --   ---  -        - -
-- -    - -- ---  -    - -- --     - -    -  - - - -        - - --  - ---  --- -    - - -- --  - - -
- ---- -- - - --   -- ---  -  - --   - -- - - - ------- -   --  -   -      -     --    -  - - ---- -
-    -    -  -  -       - - ---   -    -- - ---          -- - -  - - -  -- -   -  -   - --    -  ---
- - ---  -  - -- -    --  -  - -- -- -   -- -  - - -  --  -          -- -   - -  --   --    -- - - -
-  - - -- -      -  - -    - -  - - -        -   - --- - --  -- -   -  -   -    --  - - --   -  - --
- -  - - - -  -  - - - - -- - - -     -- -- -     - -- -  - -- - --  -- ---    -- - - -- -----  - --
- - - -  -   -   - - -  -  -  -- - -   - ----  --   ---- --- - -   ----- ---  -- - --     - - -  - -
- - -- -  -- ---- -   -   ----   - - -  - -   -  - -   --      --      - -  --  --  --------   --- -
--  --   -  -    -   - --   -      -  -    -  ---- --- - -    -   - -- --  --- -  ---  --------    -
-  --- --    ------ -- --- --  --  --   -   - - -- -    - ---    -    --     -- ---     -       -- -
- -   - -- --  --- -  - -- -- -    -  - - - - -   -  -- - - -------- - - ---        --   --  --- - -
-- - - - -   -   -  --- - ---- ---  -- - -- -- ------ - -- -       - ---  -    -----  --    ---   --
-  -   --- --   - -     --  --  - -    - -- - -- -     - -   ---  --    ---- -   -- ---  -  --- -- -
-  ---            -    -  --  - -- - -    -    -         - -           -   -  -    --- -- - -  -   -
-- -- --  - -- -- -    - -- --  - - - --- - -   --    -- - - -  - ---  --- - - ---   -   -    -- - -
- - -- -  -     - -  -    -   -    -- -- -    -   -  - --   --  - - --     --   -  -- -  - -- - -- -
--  --  - - - - --     -- - --  --- -  -- --- --- - --  - -  --  - -- --  - --  - - - -- - --- -- --
-       --- -     - - -   - -- ---- -    -  --    --  ---  --   ---  -        --  -- -      - -    -
----------------------------------------------------------------------------------------------------
