100
100
----------------------------------------------------------------------------------------------------
- -  ---  --    -   - -     ---    -- - -- - -   -  - -  --   --   -   -    ---  --- -      --   - -
-   -   - -      ---- - --   - -     -- -  -   - --  -  -   -  -    -     --   ---   ---   -  - -  -
- -  --  -     - ---- -    -- --       - --     --     - --  --- - -        - -- --- -     -- - - --
-  - -  --   -  -   - - --  - -- -- -  -- -  - - -- - ---- -   -- -            - - - -   -    - -- -
-   - ---- -  -  - --   -- --    -       -  -  -   -----  -   -     - -   - -- --  -- -----    --- -
-   --  - - --- -  - - -   -- --- -    ------    --     ---  -      -   - -   -- -   --     - -    -
- -   -- ---      -    ---       - - -  --- --  - - -  --- - - - - -  -- -    -   --   -- ---- - - -
- --  -   -  -    -           ---  -  -       -   -  --   -   -  -  ---  -  - --  -  -----  -- -   -
-- - -  -        - - - ---  -  --- --    ---- -     -- ---   --  --      - -- - -  -     --  -  -  -
- -  -- - -   - - -  --     - -   --- - --  -    --        -- --  --  --     - --- --- --- --    ---
- -- --  -- - -     -  - ---    -- -- -   -   - --    - - -- - - -     --  -- - -     -- - - ----  -
-- --    ------ - -- -  -  ---  - -  - -   ----      -  --   - -  --  --  -  ---  ----    - -    ---
-   --   -  --  -    -   -- -----  --  - -      -- - -  - ----- -- - - - - --  --   - --- -- --- - -
- - -     -- -- --- -  --  -  - --  - -- ---  -- -   - -  -    -- - --  -------  -    -  -  -  -   -
-  -  -  - - --   - ---   -     - -         ---- -  -  --   -   - - -- --   - -       - ---  --  ---
---    -     --    -    - - --   -- - -   -   - - -  - ---   -- ---   -- ---    - -     -- -  - - --
-  - ----  --    - -   -- -    ------   -------   -   - -- -- - -   -   -- -   -- -- - --   - --- --
---- -   -     -  -    - - -   -     --- --   - --- ----    ---- --- - - - - --  -        --   -   -
--    - -  -    -    - ------ - - ---  - -    - - -  -   ---  -        -  --       - --    ----  - -
- --   ----    -   -- --     -   -- ----   --   - -  - - -   -  - - - - -     -  ----- - -- - --  --
-  - -   - ---   -- --   ---    - --  -  -    -- ----   - -- - - - - -  - -  - --     -    -- --   -
-  -  -   ---  ----   - - -- -   -  -- -- --- - -   --  - -  -     - -- - - - - - - - --- - - -- ---
- ---- - - - - -  - --- - - ----  -  -    - -  -----  - -   -- -- - -  - --  - ---  -  --- - -- -- -
- -    - -  ---  --  --  --   - -   -   -    ----- - - - -  - --    - ---      -  - ---  -  -  - - -
-  -  --    -  - -   - --   - - - - -- -- -  - - -   ---- --   -- -      -    --  - -  --  - - -- --
-- - -  - -   - - - -- -  - -   -----  - - ---- -   -       -- -  -  --           - -    - ---- -  -
-- ------       -  -  - -    - --- - -  --      -  -  - -   --   -  - -  --  - --  - -  --  ---  ---
- -   - - -- -----   - -   --  ---  - - -   - -    - ----    - -  --- --- -- - ---   - -  - -- --- -
- -  -   - --  -- -    - -     -  ---  -- -  - - -- -     - ---- -- -   - -  -  -    - --- -      --
--     -     --  -   - - --- -- -    --   --  ----  ---  - --    - -- -- - -   -   -    -  - -   ---
- - --- -- -   --- - - - -- -    ---- --        - -----  --     -- --  -   -   -    --   -  --    --
-     - -  -    -   --- ---   --  -  --- -  ----    -  -- ----    -      -- --  -  -- - -    - --- -
- --    --  ---  -- -- --   --   -  - - - - -    ---  - -- - - ----- -  -  -  -  - --- - -   -     -
-  - -   - -  - - - - -  - -   - -   - -- - -- -   --   -- -     -  ---   ----  -     -  --    --- -
- -- ---  ---  --   -------   -  - - -         -- -   - -  -   -  --   --   -----   - -     -    ---
- --  - -    --  - -   - --    - --    ---- --  -- - -   -    - - ----- - --     - -  - ---  - --  -
-- -    - ---  - - --   -            -    -  --    -  - - - - -  - -- --    --  --   - --   -      -
- -  --   -  - - --   - -- ---- - -     --   --  - - -- -    -   -   ---  ---   -  - -- - -  -   - -
- --  - ----- -- - ---  -- --- - - -- -- - -     -  -   - -- - -   -- - -      -  -------- ---  - --
---- --- -  -       - --- -    -   -  --- ----- -- -- -   -- --  --    -      - -     -   -  ---  --
-   - -- --- - --   --    --- --- --  -   -  --- -   - --- - - --  - -- -   -  - ----  -  --   -----
-- - -    -  - -   - -- --- - - --   - --     - -   - - -  -- - - -    - - - --  -- --   ---- - -  -
-   - --- -  -- -   --    -     -  - --- - - -     -     -- - -- -  - -  - -   -- - -  -   -  -  - -
-  - -  -  - -     - - --  --  --- -  - -             --- - - --  -     - -- -  ---   - ---   - -  -
- -   -  -     - - - -- -- - --  -  ---  -  -----   - - -   - - ---   - -- - -----  --  ---- - - ---
- -- - -- ----- -  --- - - --  --- -    -   -     - - - - - ---- -  -- ---  --    -    -  -  - -  --
-- - -  -- -    - -  - - --   - -   --- -     -  -- - - -  - -- - -    -      - -- -- -- -  --  -- -
-- - - - -    -  --  - -    - -  -    - - --  --     - --  -   -- - - - -- -  -   - - -      --    -
- -    -- - --- - --      -- -  -  ---- -  - -- ------    --   - -- -   -  --- - --   - -----  --- -
--     -  -   -   -  --  - -  -- -      - -    - -- --  --  -   - --  -- ---  - - -- --- -  --     -
-  -- -  -- -   ---   - -- --   ----  -  -- - -  -         -   --      --   - -------   - --   --  -
- --        - ---    -- -- -  -   ---  -  - ---- ------------  - - - - ----    -      ---  --    - -
--- ---- -   -     - - - - - - -  ---  - - --   -    -   ---    --- -- -  - --- --- -  -- -   - -- -
-  --  - -  -  - - - --  ----- -- -   -    - ------ - ---  ---          - --  ----  - -  -  - --- --
---- -  -   - - ----    -- -  - -  --- ---      -  -     - - -  --- - -   - --    ---   - -- -  -  -
-- - -- -  - - - - - -   --  --- - -  -  -  --  ---  -   -- ---      -  - -- --   - - -    - ---  --
- -   -- --  - - -  -- - -- -   - -   -- --    -    -- --  - - - -  - -      -- -   - --   - -- - --
-  -  - -    -  - -     -   - ---  -- - - - -  - - -  -- -- --   - --  - -  -   --  - -     -  --  -
-   - -  - - --  -        - -    - ---  --- -- -   ---  -  -  ----  -   -   -----  - ---     -- -- -
- -  -   --    - - -- -   - -  - - -- - -  - - -- --- --  -  -- -  - -   -        -- - ------- - - -
--  - -- -  ---  -  - --  -     - -  -     - --   -- - --   -      - ---  ---  ---- - --      ---- -
- --- --- --      --   --- - -   - --- --- - - --   -- -   - -- -- - --  -  - --------  ---- -     -
-- -- - -    -    -  -- -      -  -  -   -       -- --  - -- -- -      --  -     -    --      ------
- -    - --- - --- -  - -    ---- --- -- -- ----- --  - -  - - -  -   --  - - --    -- -- --  -    -
--   - ---   -   - -        --    -- -- -- -  -   -- - - -   - -- - -  -  --  -    -- -  -- --  -- -
-  - -  -   - - -- -  --- -    - - ---   - --  -- -  - -  - - --- - -- ---  ---   -  - --  ----   --
----  -     -   -        - -- - - -   -- --- -- --  -  - -  - -- - -   -  -     - -- -  --       - -
-  - -  -   - --    --- - - -     -  -      -- -- - -- --  -- -    -  -  -- -   -   -  - -   ---   -
- - -  --- - - -- --   -  - -- ----    ----  ---  --    --  --  -   -     -- - -- -  ---- -      ---
--    - -   ---  -- -----  - ---    -   -  -- -    - -- --  - ---   ---  - --    - -  -- ----- -- --
-    - --  -  -    -- --        ---   -- -- - - --       --   ---       -  -- -- - - -   --   -    -
--  - - -- -    -   --     - - --- - - - - -     ---- --- ----   --   -    - -----    - -        ---
--    -     - ------   --   -   - -  --- - -   -              -- - --  -    -       -   - -   --   -
-  -  - ---        -   - - --- -  - - - ---  - - - - -  -  --- -    - -   - ------     - - -- - ----
-- -   -    ---     -- --        -   -  - ---------  ---  -  -- --- ------ - -    -  -- -    -- - --
- -   -  -  -  - -- - -  -- - --   --  - -  - -    -    -  -      - -    -- - -   - -   -      --  -
- -   --- -  -   - -- --- - -  - -   -  --   -  -   ----    -  - -   - - - ---   -  --- ---- -   ---
-- -  -    - -- --  -    --   - - ---- -  -- - - -----  -    - -      -- - -- ---  -- -- -- -----  -
-   -  --- - - -     -   --           -     -- - -- - -     -  - -- --       -- ---  -- - - ---  ---
- --   ---   - - - - -- - -  -   -- -     - - --- --    - -  --- --  -  -----  -    - - --  -   - --
-- -   -  -  -    - - - - -- -  -  -  --   ---- -      - - -- -- -  - - - -  --   ---  -- -----  ---
-  -  -  -    ---  -------- - -- -  --    -   -  - --- - -- --  -     -- -   -----  -- ----      ---
-   -   - -----   - -        - - - -- ---  --  -  -- - -- - - --- - --   - --     --  -    - ----  -
- -   -  - --  ----   --  - -  - -- --- ----  - - - --  -    - -- --  -- - -- - - - - - --     - ---
--     -     -- -  - -  -  -  -- -  -  -     --  - -  -- -- -   -- --- - --    --- --    --  - - ---
- -    -   - - - --- - -    -  -- --  -  -- - -   --     -- --    -  - --   - - - - -  -- - -  - ---
- ----   - - - -       - - - --  -   ---     - --   -      - - -  - --- -  - -  - - -  --      - - -
- -   --- --  - -- - --   - - ---- --   ----  - -- -   -   - --     - ---    - - ---     - ----    -
- ----  - -       -  - ------   -  - -   -  - - ---- -   -  -  - -   -    -- - --- -  --     -   ---
-- -  - - -- - --      -          -    -- --- - -  - - - --  --- -    ---     -- -   -  - -- -     -
-- -  - - - --- -  -  - ----  -   --    --     - - - - - -  - -    - -  -  -  - -- -- -- - - -- -- -
-   -  -  -- - - -----    - - - - -  -    -   - - -- ---- ---   --- -     ---   - - - - --- -   -  -
-   ---  - --  -- -  ----      - -   ----      - --    - - -    - - -- -- --  -    - -  -  -- -  ---
- - --   -    -- -    -- - - --  -- - - - - -- -  --  -  -  -  --  - - -- - -  -- -   -    - -- -  -
- -   ---- -   - --   - -- - - -  -     --  - - -       ---  --  --  - - --  - ---  -  -      -    -
---     -- --- - - -- -  - - - ---- - - -  ----   - - -  -    --   - - -  - -- - --  -        - -  -
-  --- ---    -- - -- -     --- --    -    -   --     ---- - - --     --  - - - -   --     -       -
-   - -      -   - - - -      - -  -- -- -- --      -     -    -- - -   - -  --       --     ---   -
----------------------------------------------------------------------------------------------------
