100
100
----------------------------------------------------------------------------------------------------
-      -  -    -     -    -    -  -    -  -        -  -         -                 -              - -
--    - - -           -      -  -      -      -  -  -                - -   -    ---   -   --   -   -
-    -                   --  -           --  -  -        -   -  -             -      -       -   - -
-              -   -               -          -       -   -                ---      -          -- --
-               -    -  ---     -   -              -                 -           -      --         -
-  - -    -  -               - -   - --    -  - -     -                 -     -  - -               -
-    -    ---            -  -       -     -       --          - -     -             -            ---
-   --   - -  -                 ---      -           -      - - - -- -     -          -  - -     - -
-         -  -    -  -  -   -  -         --    --   -                - -    -  -         -         -
- - -          -    -       -      - -       --             -      --              -   - --  --    -
---    -   - -            - -    -      -       - -   -   -    --             -  - -   --      --- -
-         -     -- -   --       -           --    -        -      -     -    -            -      - -
-    - --     --- -   -  -   -            -    -        -  -               -  -     -    -       - -
- - -  -     -   -      -     -          -     - -        -                          -        -  - -
- - -   -     -    - -              -   -- -      --- -    -    -       - -       -      -         -
- -   - - - -         -     -         --         -      -     -                       -         -- -
-  -    -- -    - -       -        -                      - -     --  -        -            -      -
- -      -        -   -      -         -                     -              - -            -       -
-  -  --   -- -                             -      -              - -  - -     -   -  - - --   -   -
- - -          -        -              --        --         -               -  -     -  -          -
-     -  -    -       -        -            -     -   -   - -    ---  -    --          -      -    -
-  -   - -     -       -- -   -              -- - -       -   --   -   -      -       -  - -   - ---
- -     -  --   -        -               -                 -    --                     -           -
-         -  -          ---         - - -      -      -    -       -         -- -      -   -  -   --
- --  -            -             -         -  --- -     -          -                  -  -        --
--     --    -     --  --      -       ---               -  -       -           --        --       -
-        --  - -                   -    - -   ----           -       --  -    -    --              -
-           - - -       ----    --      -    --    -   --      --            -                 -   -
-           -      --      ----       - -  - --      - - -    -               --   -       -    -- -
-      -                            -          -       -     --- -    -       -       ---  -   -----
-     --    -  -    -      -  -                       -  ---      -   -     -   -  - -   -   -     -
- - -  -   -    -    -       -  -    -  -    -  -    - - -           -- -       -    -             -
-   -    - -     - -           -  -   -               -      -        -   -          -   -         -
-   -   -    - -         -   -                -  - -  -  -      -   - -              -     --     --
-       - --       -  -            - -  --             -             --- -       - - -  -   -  --  -
-      - -         -           -  -    ---          -   -    --           -            - - -  --   -
-   -- - -                --   -     -          -         -  -               -        -    -      --
--  -   -                  -         -  -    -      -         --  -   - -       -   -              -
-       --    -        --           -          -   -   -    --       -  ---  -          --         -
-    -       - - - -  -  -   - --        -                      -          -              -   - -  -
-         --         -    -   -      -   -     - -   -     -          -      -   -      -  -       -
-    -       -        -  -   -   -        -  -      - --    -  -  -     -      -      -     -    - -
- -   -         -    -      - -    - -           ---  -             -    --  -     - -        -    -
- --  -         --                              --           -     -- - -          -          -    -
- -- - -    -             - -  -  -  --         -   -     - -   -         - - -  --   --  -  --    -
-           - -                 -                       --   -  -     -      -    --   -  --       -
-    -    -    -       -              -    -  -  -      -   - -            - -  -     -   -    -   -
-   -        -       -- -          -  - -            -            -   -   -    -        --  - -    -
-   -             -                      -    -               --   -               -    -        ---
-  - - -       -   -          -  - -         -         -  -    -- -    - - -   -         -         -
-  -  --   -    -                       ---     -  -         -   -     -     -         --  -    -  -
-   -                  --   -     - -        -  -       -             -  -- --    -        -      --
- -           -  -             -            -        -   - -    -     -               -   -  - -   -
-               -       -        -- -  - -   -        -  -  - -   --   -  -    --- -   - - -       -
-       -      - -     -  -      -      -  --  -     - -   -     --    -          -- -             -
-             --      -- --     -   -        -      -      -  -    -  -   -         ---        -   -
-        -                            -          -     - -           -    -     -      -           -
--        -    -- --     -  -  --        -     - --       --      -     - -         - -      -     -
-    -       -       -        -       --   -   -    -      -      -- -  -     --                   -
-       -  -   -  - -   -   -   -   -     --   -     -    -  -           --      -   -- -  -   -  --
-       - -    -    -       --   -          --    -   -   -  -     ---     -       -         -     -
-    -       -               --        -           -  - -      -   -     --          --   - -     --
--       -       --                       -     --   - -    --  - -  -    - -      - --   - --  -  -
-  -      -      -                 -  -        -   --    -             -   -     -                 -
--   -     -         --           -      -   - --  -     -                ---     -        - -     -
- --          -    -            -            -   - - -    --   -   -     -  -  - -   - - -  - -    -
-   -         - -         -        --  -             -  --   -  -   -    --- -   ---      -        -
-    -     -          -    -              -           -        - -      -   -    -           -     -
-          - -  --   -   -      - ---  -      -  --   -   --                 - -           -       -
-   -               -   - -       -  -                -    -      -   -         -         -      - -
-    -  -  -        -     - --       -       -   -   -  --              -    -      -           -  -
-       -       -            -         -  -   --     -                -        ----            -   -
--  - - -      -      -  -     - --   -  --   --     - -  -    --   -  -                     -     -
-           -                       -            --                       -    -           -   - - -
-    -   -         --     -     -    - -       -  -     -   -        -     -  -     -        -   - -
-           -- -   -               -          -     -        - -           -           -     --    -
-             -                 -       -- -             -        - -   - -    -     -  -        - -
-         -       -           -      -   -    -   -    -    -  - -         - -     -   -           -
-    -            -  ---     -  -    -     -   -             - - -              - -     - -        -
-     ---  -    -     - ---                    -   -   -        ---      -     -        -          -
-    -            -           -                      - --   ---  - -              ---  - --        -
-   -   -     -              -     --     -       -                  -  - -  -        -            -
--    -   -   - -    -   - -                --  -          -                 -  -    -     -     - -
-  -    -    -          -  -  -  - -   -      -       -- - - --            -- -  -    --   --      -
-   - -   -       -   --            -    -   - --        -             -  -                -      --
-      -    -    - -           -      --  -- - -               -     -    -   -      -             -
- -             -     --       -              -  -     -     - -    -   --     - -  -      --- -   -
-             -  - -  -                    -   -    -         -       - -    -                     -
--                     ---       -            -                 -     -   -  -      -     --      --
-   -         -   - --   -  -  - -      -                -        -    - -        -         --     -
-               -         -               --  -        -   -    -            -  -    -- -  -     - -
-       --      -    -          -  -    -  -    -              -     -- - -   -    -  - -    - --  -
-       -    -          -        -  -          -  - --        -   -            -         -       - -
- -     --        -     - --         -      --  --      -     -    ---     -  -   -                -
-          --  -   -  -   -      - - -      - -   - -  -                -   -      -   -           -
--     -- - -  -- - -       -    -      - -       -       --  -                  -   -    -     - --
- -            -  -         -  --        - -       -     --         - - -  - -          - - -      -
-     - --        -                  - --               - ---       -  -        -             -    -
----------------------------------------------------------------------------------------------------