100
100
----------------------------------------------------------------------------------------------------
-  -  - ----    -   --  --- - - -  - -   - ---       --  -   -  -     - ----  - -   --- - -        -
-   -   -      - - -  ---  --  -  - -  -  -   --  --    - - --    ---- -   -     - -  - --  -- - - -
- -  ---  --   - - -     -- -  -    ---- - --      -          ---     -----  --- ----- -  --    -  -
- --   -   -----  - -   -   -   --   -     -   - --- -- -- --- ---  --  - - -   - -   - ---  ---   -
- -   ----  -   - --- - - --  -      -- -   --  --  --   - -          --   --       - - -  -  -- - -
--   -- - -- --  --     --   - -  - -    - -----   - - - - -    - ---    --     - -- -   - -    -  -
-      -- -- -        -    -   - -- ------        --   - -- -   - ---  - - --- - - --    -  -  -- --
- - - --       - --  -    --- --    - ---  - --- -  - ---  - --        -  -  --  ---- --  --   -   -
- - - -  - ----    - -       - -  -   -  - - - -  -  -   -   - -- -- --- - -  --     ---  -- -- -- -
-  -- -- --- - -  --- ---- - -      --    -- -   -  - ---    --   -- -   --- - -  --- - - --  --   -
---    -      -- - --- -  -  ---   -   --   -- -  - --  --  -  ---  -- --  -   - - -    - - - ---  -
------  ----          - ------- - - -- - ---    --- -  - -    - -  - -  -   ---  -  - - -   -   - --
-   - --   - ---- - -   - --  - - - - -      ---  -- -       ----- - -    -    - --    - -    ---- -
-- -   ----  -- ----  - -       -  - - - - - --- --- - --- ---   - --- -------  -  -  - -  --   -  -
-  - -- ------ - - --- -  --  -  -     -     -  -  - -- -     - -   -     -   - -   -  -  - - -   --
- - -- -      --- - - -- - --     - -   -- -- - ---- -  - --  -      ----- --- - -   -  - - -- - ---
-- -   ---     --   ---   - ----- - ----     -  --     -      - - -   -    - - -- --- - -- ---  - --
- --  -  - --  - -   --  -      --   -   - --  -  -- -- ---- - - - -    -- -  - - -  -    -  -  -  -
--   - -   -- -- - - - ---- ----    -  ---    - --  -- --   -  -- -    -  -   - -  ---   -- --- ----
-- ----  - -   ----         -- --  - -  --  - -    -  -  --- ---  --- ---  -- --- -  -  -          -
-- -    --- ---     -  --- -     -  ---  --- - - - -- -   -    -   -- - - -- -  --    --  --- -  - -
--  -- -  - -   - - -   - -- ---   -- - -   -- - - -  --         --  --   -- - --  ---  -     -   --
-- -     -   -   - -   -- - -   -    --  --  -    - -   --    -  -  -- - -  --   -- -  - --      - -
- ---    - - - --  --- -  -  -- -  --- --   - - - - --      -      -- --  -   - -    - --  -   --  -
--   -   - - --    -  - -  -    --  - - -- -  - -  -  ----    ---- -     ------- - -   - --- -   - -
- --   - -  ----  ---    -- --  - --- -  - -   -  -    - - --- - --  -     -      ---- -- - --   ---
-  - -   ---     -    --- --   -    - -   -- --   - --   - -- --   --    - --  ----     --  -  -  --
--  - --- - --  - ----- -  -   - - ---   - - - - -     --    ---  -  - --    - -   - -     - --  - -
-  - -    - -   - -- -    -- -      - -- - -- ---  ----    --   -  -- -   -- -   --  - - - --    - -
- --    - -    ---  -   - -- - - --  - -    -  ----- -    --- --- -  ---       - --   ---- -  - -- -
-  - -     - - -  --- -- -- - -- - - - - --- - --     -- - - - --  - -  -- ---     --- -  -- --    -
- -- ---- -- - ---      --- - -  -- --  - - - -  -- -- - --  --   - -- -   - - ---   --      --  ---
--   -  - -- -    --- --     ---- - -   -   - --        --     --    -     - - --   -  -- - -  -   -
- -  -   - - ---- --- -  - -  ---- --    - -- -- ------   -  -   - -  -------    --  - --  --- - ---
-  - - -   -   - -  - -  - ---      -  -- -- -    -   - --     - -- --   ---  --    - -       - - --
- --  -- --- -- --   -- -   - ---- --         ----  -- -  - -- -- - - - -  --     - - -- -   - - ---
- - - -  -   -   -- -  ----  -   - --  -    -  - - -  - -  - - -   --  -       -- - ---  -- - -  ---
--    -- -  -     -  --    - -- -     --   - - -   --   - - --  - -  - - - ----   - -       -   ----
--  -  -- - - --- --  ----- - -- -- -   ---   - -- -   -  --   -    --      - - - - --    -   -   --
- --  -  -  ---     --- --   - -  --- ----   -- - -  -- -   - -    - -  - -- -  - -   -- - - -- -  -
-- - --  --    -   - -  - ---  -   --   - -  -  --- - - - - - --- --- - -      -    -- -  --- -- - -
- -  - --  - -- - -     - ----  -    -- - - -   -  -- ------- - -   - - - - --- ---- -  -- - -  - --
--- -    -  - -   - -   -   --  - -  - -  - ---  -         ---   - - -  -- - - -- --   -- -  - --  -
- - - -  --    -- -   - -- -  -- -  --   ----   -- - - ---- ---   -   - -   -  - -    -- -- - -- - -
-- -       -   - -- - -  - ----- --     --   -- - --  - - -- - - -  - -   - - -  -- -     -- - --  -
-    - - - - - --       -  -- - -  --- --  --   - - -  - ---- -- -- - -   - - --  -- ----     -  ---
- -  - -  ---    -   ---     -    - -- - --     - -- -- -  --  ----     - - - - -     -  --- - - - -
- --  - - - - --- - - --- -   - - - --  - - - --  - -  ----  --    -- -  --   - - -- - --   --- - --
--- -  -  - - - - -  -   - - --   -  --    - -   ----  -- - -    -- - --        - --   - - -     - -
- - --- -- -    -   -- - - --  - -     - --  - - -      -   -  -  ---    -  - --   - -- -    -  -- -
-- --  - -- - - - -   ---- -- - - -      - ----    -- ----     --      -  ----   -- -  -  - --   - -
-   -  - --   --- ---- -     -  -  -- --     -        -  - --   - - -  -  - - --      --  -   -   --
---  -  --- - -  -      --     - -   - --- -      ---  -    --- --   - --     ---- - ----  -     - -
-  -  -- - ---- - -----  -  --  - --      - -  -  -   -----    -  - --  -    - - - -- -  - -   - - -
-      ---- --       -  ---      - --- ---   -- -- ----    - -  -    - - -  --   - -      - ---  ---
-  -- -   - -- - -     -   - ------  -     -      - -  - - - -  --   -        - -  - -- -- -  - -  -
-   -   -- - - ----- - --- -     - -   -  -   -  - -- -- -  -- - - -     -- -    -  - --  -- - -  --
-   - - -  - - -   - --  ---   - -  ---       - -- - -   ---    -  --- ---  -     --- - -     ---- -
-        - ---  -   --- -   - - -- -     - --     --  -   - --      -  -    --- --   --- -  - - -- -
-    - - -                --   --- --- --- --- - --   - -     ---  -  - --  - - -  ---  - ----- -- -
-   - -  -- -  -  - ----  - - -- - -      - -- -  - --   - -      -- -   - -  -- -       - ---- - --
-     - - - - - --      -- - - - - --          -- --    -        - -   --  --  -- -   -  - -  - -- -
- -   -  - -  --  -----  - ----  - -  - -  -- -   ---  -  - - - -- -  -  -   -  -   -  -  - -- - ---
-     - -  -  -  - -  -  - -   --  - - - -     --- -- - -     ---  - - -  --- -  -  ---  - - - -   -
- - -  -- -      --- -   ---- -   - --- -  -     -   -     -   - - -   -  --  -     -    -- -  -  --
-    -- -- -   -    - - --    - ----    -- - -  -   -- - --- -  -  - -- -   - -- ----- - --- -  -  -
- -   -  --- -    -- --   -   -- --  -  - -  - - -- --  -     - --- - -  ---- -- -  - -- -  -     --
-   -- ---- - - -  --    - ----  -   - - ---- - -  -   - --- - -    -- - -   - -  -- - --  -- -    -
-   -- -- -  --- -   --- --     -  ---  -  ----    ----   -     - -- -    -- -- - - -   --   - -----
--   --- - -   -  - -- - -  ----  -  - -  -- ---  -  - -- --   -   --- -  -  -  - --- - -- -  --  --
-- -- - -- -- -- -    -    --   -   -- -    - ---  -- -  - -          - -  ---  -- - - - - -- ---- -
- -     - - ---- - ---   -   ---      -    - - --- ------  -     --- --   - -   -- - --- --  -    --
- ---  -  - -     - ----- ---  -  - -- --- -- -   -  -  - - - - - -  -  ---  --- -  ---   --  - -  -
- - - -- --  -    -- - - -  ------ -   -    - -- --  -    --- - - --  -        --  -  -         - --
-   --- - -  - - -  -  - -- - -   ---   -- - - -   -  -   - -   -   ------ - -- ---  - -- ----- -  -
-  - - -- -- --  - --           ---  -   - - -  - -  ---- - - - - --   - - -   - -- -- - -    - - --
-- -  -   -- - -   --  - - --   -- --- - --- ----- - --- - --   -   ----    ---- -   -  -  --- - - -
---- --    -   --- -  -    ---  - - -  -  -- -  -    ---     -- ---    -   -    -    -  -- -   -  --
- - --- - ---  -   -  ----  - -  ----   -     -- -- -   --- -  - - - -- -    -- - --  -- -- --- -  -
-  - - --    -  --   -   -     --  - --    - -    --   -  --    --  --        -   ---     - -   -  -
- ---- - - --- - -  -   -- - ---    -- -   - -  -   --   -  ----  --    -- -- - -- -- --- --  -    -
- - -   -  - -   --   ----   -   ---      - - - -   -- -    -          --   -   -      -     - --  -
- -   - - - -    - -- -- -    --- ----  -- - -- - -  -  --    -- --    --  - -- ---   -    -- - ----
-  -- - --     -- - --   -  - - -  - ---- -- --   ---- - - -   -- ---   -   ----  --  - - -- - -   -
- -    -  - -    - -    -   -     --   - -   - --    --- - -           - ---    --  - - - - - -  ---
-  -- -  - -  ----- ---  -- - --  - --  -- - - -  -  - ---     --  --   - -- ---  -- - -   -- ---  -
-  - - --- -  --  -  - -- -  -     -  -- --  --  -  - -   --- -     - ---- -   --  -- -   --- -   --
-- -   -    -   -- -- -- -- -  -- --- --     - - --   ---  - - -- ----   - -  -   - - --    - -   --
-- - --- ---       - - - -   ---- -- -  - -      -  -     --  ---- -   --- --  -- -  --  - -  -  - -
-- - --- - - -   -- -----      -    -   -    -   - - - -      -  -  -  - -  --       -     -- ---- -
--     -   - - -  --  -  - --  - --    - - -- ---- --     -  -  - -    - -   - - -- -  -  -  -   - -
-- - --  -- ---  --  -  - - - - -  -   - --        --  --       - ----  -- - - --    --            -
-  --  --- --- -  -- - -- - - - --   - -      ----  - - -  ----- -  -  -   - -- --  - - - - ---    -
---- - -- --  ----   -    - - -  - - - - - --     - --   - -- - ---- -   --  -  -- ---  -     --   -
-   ---- -- --   - --- -------   --      -         -     -  - --  -- -     - --  ---   - --  --- - -
----    - -    --   -       -  -     - -  -  -- -   - - ---- -   - - - - -     --   --     -  - - --
- - ---- -    - -    -- - --- -   -   - --- -  - ---- --    - - -- - - - -- -   - -- -   - ----  - -
- - -   ----   --  - -   --  -        -- - -  -     -   -- -- - -  - -     - -   - - -    -    - - -
----------------------------------------------------------------------------------------------------
