100
100
----------------------------------------------------------------------------------------------------
-    -   -        -         -                 -     -    - - -       -        - -  - -             -
-       -  -        -   - -    -   -  -          -  -  - - -     -   -                       - -  --
--    - --  -                -   -            - - --        -   -       -   -    -  ---     -      -
-                -           -   --       --   -          -           -  -      -  --      -  -    -
-   -         -       --     -  -- --                -     -      -       -            -- - --    --
-      -  - -     - -      --     -  -  -           -   --  -  -            -  -       -    -      -
-        -            -- ----    -    -  -    - - --    --  -      -      --      -   -  -      -- -
--     - --   - - --            --   -     -    -  - -  ---              -  -     ----     --  -   -
- -  -   --  -   -    -  -         --        -   - - -    -   -  -                      -       ----
-          -   - -     - -      ---    -       -           - -  -    -  -    --               -    -
- - -       -   - --         -             -          -        -    ----     -  -         -   -- - -
---                -        -     - - -        -               - - --     -   -         -         --
-          - - -         -                       -    -    -           --    --  -  - -   -  -  -  -
- -           - -     -      -  -        -       ---      -            -  - -  -    - --         ---
- - -                           --                 -  -          - -          -  -           - -   -
-     -       -     -                -          --      -    - --    -      -   - - -   -       -  -
- -   -     -    - -          -         - -  -        - - - -    -      -    --  -  -  -   -    -  -
--  -  -  -             -   -               -      -          -       -- -         -           -   -
- -     -              -   -     ----             -  - -               -          -    -        -  -
--   --            - - - -     -        -  - -      --     -    - - -    -        -  --     -      -
-      -- - -   - -     - -      -- -- - -      -        -   -  -   -    - -   -  -    --       -  -
-    -      -         -   --   - -      --      -      -   -    - -        - - -    --    -       --
-        -     ----           -            - - --- -             -   -  -         -  -- --         -
-     -   -  -          -    -             - -         --        -   -  -   --     -    -          -
-       -- -- -       -    -           -          -  -             - -    -  - -     -             -
-   - -       -     -   ---  -    -       -      -     -  -              --       -  - - -    -    -
-   - -         -    -  -  -  - -           -    -  - -           - -  - - -                -     --
-  -            -     -        ---   -    --  --     --           -           -       -- -   -     -
-   -  -  -   -    -   -            -   -   -  ----- - - -     -     --     -       -             --
-           -       - -- -      - -    -      -          --       - -      --      -         - -   -
-    -    -  -        -   --   -  - --  -- --    - -   --     --       -     - -  -   ---    -   - -
-  -  -        -        -     ---            -       -           -   -    - - -                    -
--      -       - - ---      -      -    -- -   -        -  -  -         -         --         -    -
-        --  -    -   --         - -        -  -  -     -       -  -  - -     -      -  -   -     --
- - -   -  -      --- -   - -        -  - -        -  -     --   -     -        --         -   -   -
-           -        -  --         -     -   - -    -    - -        - -  -  - -       -   -- -    --
---   -       -  -  -        -   --    -  -    -        -    -----              -       -          -
--      -           --     -          -   -           -   -  -   -           -    - -          -   -
-         -      -                   -            -       - -          - - -   -       -     -   - -
-  -   - --      -  -- -  ---   -            - - - -   --   --- -     - -        -   - -   --  -   -
---  - -    -       -  -   -  -    -    ---      --      -         -       -  --    -         ---  -
-   -    - - -    -     -    - -       -   -       -        -       -        - -         - -    -- -
- --  -   ---  --        -     -         -  --        -       -  - - - --    -      - -        - - -
-   - -        - --- -              - ---   ---   -          -      -   -               -- -     - -
-     --  -   -  -   - --    -        -     -     --           -  -  -   -    -     -          -   -
-            -          -  - -        -    -  -   - --     -      -- -  --       -  - - -  -       -
--     -          -    -  - -            -       -   -   -      -      -         -    -            -
-  -   -     -            -      -            -  -  --  -         -  - - -  -       - -  -        --
-       ----           -      - ----   - - -           -   --    -         -      -    -  - -      -
- -  -                                  -      -      -     -          -  -           - - -    -  --
- --         -         --          -        -           -  -  -      -   -            --     -  -  -
-                                - -  -     --  -     - ---   -   -  -          -    -       -     -
-        - -                    --           - - -                               -        -   ---  -
- -      -  -       - -    -       -  -  -    --      -  -                      -     -            -
-  -    - -      -          -            -        ----      -    -  -         --     -          -  -
-          --    -       -      -        -    --      -           -  -- --    -               -    -
-  --  -         -  --     -  -    -   ----  -  -  --  -  ---   -  -       -              - -  -   -
-  -  - -    -   -           --            -  - --  --  -   - - -   -      -                       -
--                -  --   --        -          -          -          -   - -       -     -      -- -
-      -      -      -  -     -- -    -  - -                      -  -  - -       -          - -   -
-    -      -  --- --                        -        -    -                  -       - - -   -    -
--   -    -        - -      --                  -  -          -            -         -    -   -    -
-  --                  -       -    --         -      -             - --  -   -- -        -  - --  -
- -  -- -          - --    - -   -        -                 - -        - -  -   -    -  -  -   -  --
-  -   - --               -    -     --- - - -       -  ---              --   -  -                 -
-     --    -         -   - --            --   -                -   -   -      --   -- - -    -    -
-       -                  -    --    -    -   -        -         -          - - -       --    -   -
-  -----     -        --          -                 -  -               -                -       -- -
--       -        - - - -      -- --  -       -    -         -      -         -       - --    --   -
-- -- -  -            - -  -  - -  - -   - - -  -     ---     - -   - --       --  -- -     --     -
-   -     -      - -- -          -   -        -   -      -  -     -  - -   -           --  -       -
-    ---       -          -  - -       - -           -           - - - - -        -                -
-    --   --   - -   -      -           - -  - - - -           -          -        -   - -        --
-               -            -      -   -  ---   --   -       -  - -              - -  -  -  -  -  -
-- -  - -- -               -                -    - -  -        -   -    -      - -        -- -  -- -
-   - -       -       -   -             --- -       --           -- -     -    -          -   - - --
- -             -    - -  -                         - -    --      -   -   -       ---- -          -
-     -- -        --            -            -          -   - -  - -   -    --  -  --              -
-      -   - - -      -     --   -  - -               --    - - -              -     -   -         -
- -  -   -     - -  -      -       -         -  -                   - -        -          --     ---
-     -   -   - -    -       -   -     -      -        -    -  -       - -  --      -     -        -
--  -                   -          -     -         -  - - -       - - -- --       -                -
-       -           - -     -  -- -  - - -  - -   -- -         -- -    --       -     -  -     -   -
-     -                           -             -   --        --     --   - --                  -  -
--      -  -      -       - -       - - -  -  - --    -  - -      -            -    -              -
-       -     -  --            ----  -           - -     -  -       -  -     -  -   -            - -
-- ---  -     -  - -- -    - - -    - --   -  -   - ---   -      -           - -  - -       -  -  --
-     -  ----     -  -    --    --       --    -   -- - -                  -  - -  -   ---         -
-    -            -    -     -     -   - -  --  -  -      -      -        -       - --       -    --
-        -         -   -- -        -  - -      - --   -   - -             -  --    -  -  -  -  --  -
-                    -            --       - -         -    -    -- -      - --              -   - -
-              -   -      -- - - -       --      -  - -    --     -          -       -     - - - - -
-      --    -    - -   ---   -       -   -                           -  -      -     --   -    -- -
--    -             -   -   -     -     -  -    -  -        - - - -         - -  --          - -   -
-  -   - -      -   -      -   -  - -     - --    -   -  -    -     ----   -       -               -
-- - -   -    - -           -     -        -   -       -      -     -      - -   -       -     -   -
-        -       -            - -      ---               -         -                -   - --     - -
-    -    --          -         -   --       -                        --          -     - - -      -
----------------------------------------------------------------------------------------------------
