100
100
----------------------------------------------------------------------------------------------------
- - -    -- - -  -    -    - -  -   - -- -  -      - - - - - - -       -  -   -   -- -- -   - -    -
- -   --  - - -- - -   --  -- ---  - - -  --- -  -     - -   --  -- ---  -- -  ---   -  --  -   -- -
-   --  --  - - -  ----   --         - - -  -- -  - - - - -- -    --- --- -  -    - -     -   -- - -
-  -- -    ---   --   - -   ------ -  --  -    - - --------   -    -     --     - - -- ---     -   -
-- - - - -- - -    --  - - -       -   -  - -  -- --     -    --  - -- -   - -    -- -      - - -- -
-   -- ---   -- --   -   -  - -- - --   -   - -- -  ---    - -- -  --   - --- - --- - -- --- -    --
-  -  - - --   - - -    - -  - -   - -  - - - -  --- -     -   ----     -   - -         --- ------ -
-  - -    -- ---- -   -    -  -   - -- -   -     -- - -- -   --    - -- -      --  --   -  --  -----
- -      -  ----- --  - -- -- - --  - -- -   -    --- ----  -- ---         --- ---  ---         -  -
- - -  -   - -----  - - -      -   - - ---- -  -     -    --  -   - - - ---      -      -  -- -- - -
--    - -  -       -----   -     --  --  --  -   -   -  - -- - -  -   --  --- --- - -- --   --- ----
- -     - -   --- -  -  -    -- -  ------       -  - -       - --  - - -- -- ---- - ---   - -  --  -
- - - - - - -          ------- -- -     --  -- - -  ---  - --  -- - -   - -- -- - - - - - --  -- ---
-- -- -    - - --- - --   -  -  -  - -- -- --   - --    -  - --  --- ---   --    ---   -- ---- -  --
-     - -- - -  -- -  - ----  - ---- --   - -  - -    - --  -  --   - - -   -- --  --    -   -     -
-   -       - -      -       -- -  - - -- --   -- ---  -  -  -- - -   -   - - - --     -----  - ----
- -- - -- -  -  --- --  - --   -  -           --  - -- - -    - -                -- --- -     -- - -
-- -     -     -    --   - - ------   - --     --- --    - ---     -----  --   - --  --- ---       -
-- -  --  -- - ---   - - -- -    - ---  -- - - - --   -  -  - ----  --  -- - - -      - -   - -- ---
--   - - -   ---  ---      -  - - ---    - - -      -         ----       -   -  ----- - -----  --- -
-  - --    - -- ---  -- -- -- -- - - - -  - -    --- -- ----          - ----   - -- - -- -  -  --- -
--  - -- -       - -  -  -   - -     - -- -  -- --- -- -     - -  - -  -   ---  -  - -  -   --     -
-  - -   -- - -    ---  - - --- -  --  ----  - - -  - -- --      - -- ----           - -- -   --- --
- - ----- ---   -- - -  - ----  -- - -    --   - -      -  --    - -   -  - -  - -  -  -- - --     -
- - -- -  -   -    - - ---    -  -  --- -   -  - -     - --    -- -- - - -  -     -   -  ------    -
-    - - - -   --- -- --  --- - - -- -  -    --- - - --     - -  - -- -       - -    -  -       -- -
- - ---  - - - -   -  -- - --- -- - - ---- --      -- -  -   - --- - -- -  -  -  ----- - ------    -
-     - --  - - -- -   - -  - --  - - - - - ---- -- -  -   -   -  - ---- - --  -- -    -   -  ------
-- -- ---   -  -      ------ --  - - -   - ---- - - --- --   -     -      ----- - - - - ---  -  -- -
-   -  -   -  -      - -  -- -- --   -----  -   --- -- --   - - -- -----     -- - -- -- -- -  -  - -
---  -- - --    ---- -  --       -- -    -   -   -- -- - -  -       -   ---     --   - -     --   --
-      - -     -   - - -  - --- -      -  -- --    - -- --     - - - -- - ---    -   ---- ---  - - -
----      --  --- -  - --    -   - ---  - -- - - ---   -    -- - -- -  - -               - - --  - -
-  - -- -  - -   -    -    ---- -   ---   -   -  -  -   --      -  ----   --  -- -- -  -  -- --- - -
-   - - - -- - -     --  ---   --  -   - - --- -   - --  -- --    ----- -   -- --- -- - - - - ---- -
-   - -  - - -  -- -  -      --  - --  - --      - ----- -   -  -     -      --  -  -  --  - - - ---
---   - - - -  -   -   -  -   - -- - --   -- ---  -   -    --    --- -  -  -  -- -- ---   ---   -  -
--- -  -    ----  - ---   ------   - - ---   - -- --- -  -   -- --   - -  -- - -- -- -- -   -    ---
---  - - --  -   -  -           --     -   - -   - -  - -- --- - -    - --   - -- -      -  -   -- -
-    -  - --   --- --   --   - - - ----- -  -   -   ----   - - -- --   -  --    - - ----- -- - -  --
-   -  - - -----      -   - - - -  - -  -     -- - -    ---  -  -  - --  -  --   - -- -  -- -- --- -
--- --- -- --   - -  -   -      --  -  - - - -   -  - -- --  -- -   -- ---- -    - -- --   - -  -  -
-- -   ---- -- --- - -   --- --  -- - -     ---   -    - -  -   --   ---  -   -- -  -  - - - - -   -
- -----  - - -   -  --  -   -  --  --        - --  --- - --  --  - -    -- ---  -- - -    -  --  - -
- - -- - -   - -- -  --  -- --    -- ----- --- - -     - -- -  -   - - ---  - -- - - --- - -- - -  -
- - -   - -     -- - - - - -  ---- --   -  -  --      --    --    - -- -- -   -  -     - -  -  - - -
- -     - -  --  --   - -        - - - -      - --  -  -   --  -- - - -  - ------- -- --- -   --  --
-  - - - -- -  --  -- --  - - -- - ---   - ---  -  - - - ---   -     -   -- --    - - -  - -- - -- -
-- - -- - -  -  ---- -  -   - - -  -  ----  - - --  --     - - - -  --    - - --- - --  - - -      -
- -   - - - -  --   - - - -   -  -   -   -- -----      -- - -- ----      - - - -----  -    -     - -
-   - --- - - -  - -- - -- - -  - --- -    --   - ----     - - - -  ---- ----   - -    --- -   - ---
--   -  - - - - --     -  -- --- - - - -   - --------  - ---  - --    --     -- -   -  --- - ---- --
- ---- --- -  - - -- -   --    - - --- - -   --      -   -   --  -- - -    -  -  ----     -   - -  -
-- -   -  - --   -  - -  - -  - ---            - -     - - -   --  - -    -    -    ---   - -    - -
-    -- ---   ----  -  -  -  -  -  - -- -  -  - - - -----  ---   --  -- - - ---- -   ---  - ----   -
-   ---     -     - - -  - --     - -  - - -----         --  --     -  ---     -  -- - --- - --    -
-- -  -  - -- - -  -- - -   -- -   - -  - - -   ---  -- - ---  -   --   - -  -   - - -  --- -    ---
-- ---   --        -  - --   - -  ----    -- --- - - - -    -        -  ----   -  - - -- ---  --   -
-- -- - - --- -- -   --    -- - -     -- -  -  -  ---   --   -  ---- -      -     - -- -     - -   -
--- -   - -- - -        -      ---  -   - - -         --   -    --- --   ------ --     -  --- -  - -
-  --   - --       -- -  -- - -   -  ---- - - -      -  -- ----- - - --- -     -    -  -     ----  -
-           ----- - --- - -   --   -    - -- - - - -          -   ---  - - ---  - -     - -- --  - -
--- -- --  -  - - --  - --  - -  -    --   -     - - -   ---   ---    - -   --- -  ---- --- -  -- --
-   -- - -  -   --- -----  -     --       - -- ---- -      -- --- -  - -    -- --  -        -    ---
-              -  - --   - - ---- --- --  - -      -  - -   -   -      ----- - --   --- - -     -  -
-     - ----   ---   - --  --   - -  - - -- - - --- -- -        - - --    -- - -- - --     ---  - --
- -  ---      - - ---  - - --   -  - - --  ----    -   --- - - - -- - - - -  -  -   - --- -      - -
-    - -   - --  --  -  --- -   --     - -  -  -     - - - --  - -- -- -    --  -- --  - -  ---- - -
--- -    ---- - - ---- -  -  -   - --- ----    ---   --- - -- -- -- - - ---- --  - - --     -  - - -
-  -  - ---  -- --  - - --    - -  - - -  -  -- - --- - - -     --   - -   - - ---   -- -- -   -- --
-       - -     --   --  - --- -   -- - --   --   - -- -  --- --- - -  - --- - -  --  --   --  -   -
---  -   -    -  - -- --    --- - - - -- - --  --  ---- - ---- - --  - -   - - -- -  --    - --  - -
-   - ---- --  --   - --- ----   -  -   - -- --  - -- - - ----      --   -  -  ---  -     -   --   -
---  - -- --   ------- - -    -  - -  -    --  --   - -- -  -  - -  - - -- -   -  -- --      -   ---
- - - -- --   -  -    - --  -- - -  -  - - - - - - -   -      -- -- -- -- -  -- ---  - - -----     -
- - - -- - -  - - ----   - -   ---   --      -- - -- -        - -   -- --   - --     -   - -- - -- -
- -   -  - - ---   --  -   - - -   -- - - - -  -    --- --- -     -- - - - - -- ---- --- - -    -- -
-     -       - -- - -     - -  ---       - -   -- -    -  ----   - - -    - -    - - -  -- ----- --
- -          -- - -- -  -    ---       - -- - -    - - - --  -   --  ---- -  - --- --- ---   -   - -
- -  - -   - -  -  - --- -- --  -- - -- -   -  -    -- -    - -   -- - -  - - - -   -----  -  ---- -
- -  - --   -      - -- - --   --       ---  -- -  - -   -- - -   - --  -- ---  - --   -    --     -
-- -  -    -  - - --   -    - -   - --  -  --  -    - - - - -   - -       -- --  -  --  --   -   ---
---  - -      - -   --- - -     -  -  -    -   --    -- -  - --    - --- -  - - ---- --- - - -- -  -
- - -- -- - -       --      - -- -  -  --- --    - ----  -   --   --      --  - - ---    -  -- - - -
- -   - - - --- ----- --     - ----- -    - -  - --  -  -       -- -   - -  --- - -   -   -  --- - -
- - - ---   -  - - - - -  ---   - -  -  ---- --- - -  - --- ----- -  -  - - -  -- ---     ---  --  -
- -- - - --  -  --  --   - - -  - --    -     -  -  -  -  - - -  -   --  --   -- -- -  - --  --  - -
-   ---- -- - -       --  -- - -- -- --- -- - - -  -     -- --  -  -- - - -  -  ---- - - - -- - -  -
-  - - -    -  --- ---  - -    - -  - - - -   -  --- -  - - - ---    - --  - - -       ---- -    - -
-   - -  - -- - -   - --  -- - ------ --- ---     -   - - ---  -- --  -  - -  ---    -- -  - -- -- -
-   - ----- -  - -- -  -- -- - -        - - - -  --    - --   --  - - -     -    -  --  ---    - ---
--  - -  - - - - -- --- -    -  ---      - --  - -- --- -  -      - - - --- - -- - - - ---    -    -
- - -     -  --- -- -  -  --- -  - ---- -- --  - -   - ---  --  - - - -  ---   - -- -- -  - - -- - -
- -- - -   -  -   -    - -  - --  -   -  --- - -- ----   -  -  -  - -  --   ---  -  --      --  -- -
--  -    -  - - -- --   -- - - -  -- -       -- -  - -  -  - - - -    - --   -- -  --   -- -- --   -
-     --   --  - -- -   - -       - -  -  - - - -- - -  - ----   -    --    - -- --   - - -      - -
-- --- - -- -- -  - -   -- ---- -   --      -     -   -  - -   -- -- -- -- - ---- ---   - - - -- ---
- --  -   -   - -     -     --  -   -  -- --  - -  ---   --  -  - - -  -    -    -  - - - - --     -
----------------------------------------------------------------------------------------------------
