100
100
----------------------------------------------------------------------------------------------------
-  --     -        -        --      -      -  -   -     - -- -  -    -          -               -- -
-      --   - -   -      -  -   --     --                 -     --       -        -    -        -  -
-     --  -         -     -  -     -      - -    -   -     -   -     -      - -      - -           -
-      -  -   - -           --   -   -    -   -         -    -         -   -     --   -      - -   -
-    -- -   ---   -       - - --   -   --          -  -         -       -      -  --     -   -    --
-                -   --  -      -  -   -- -        -    - -   -        --    -      -         -    -
-      -    - -                     -           -     -  -       -    -              -   -         -
-   -    --        -    -              --          -            - -        - --      - -   -   -   -
-    -- -        -     - -       -           -       --     --    -     - -    -                   -
--- ---            -   --   -   -                -                       - -       -               -
-        ---     -      --     -  - -    --- -              --    -        -  -   -  - -       -   -
-       -       -    -- -   -    -   -    ---               -  -                    - -            -
--          -   -        -   -                            -     - --         -                 -   -
--      -   -    -   - -                         -      -       -      --                    --    -
-     -       -  --  - --     --    -            - ---- - - -    -      -      - - ---- -        - -
-           - ---  -               -   -            -      -       -  -     -   - -           - -  -
-    - -      -    -     -    - -               -   -  -     -   -    --     - -  --    -     -    -
-   -   -   -           - -   -   - - -        -     -        -  -        -  --    --            - -
-    -   --        - -      - --     -  --    -  -    - -                 -  - --    -    - -      -
-     -    -- -   -- --  - -                    - - -    -      -    -         -  -             -- -
- --                     -  -      -    -     - -- - -       -          - -        -   -     --    -
-        -    --- -   --       --   -  -  -          --    -     -  - -    -         - -    -      -
--                 -             -  -    -      - - -    - - - -     --   -          - --         --
- --       -      -- --   -   -    -                -  -  -       -   -   --     -  -  -       -   -
-     - -           -   -       -   -    -      -   -  - -           -              -  -           -
-           -    -  -                          ---                        -           -      -     -
-    ---- -           -  -      -            -- -        -     - -     --   -    - -               -
-                 --         -   --     -                 -     -      - -       -             -  --
--- - --   - -    -    - -        -         - -        -    -  -     -    -        -   -   -   -   -
-   -         - --              -            -              -      -    -  - -         -  -        -
-    -  -                 -   -  - -         -               -  --       --                   -    -
-    --           - - -     -     -                        -            - - -    -          -  -   -
- - -                  -  --      -  -    -    --        --                     -            - -   -
- -  -     -     -    -  -    -    -     -         -     -   -         -  --    -     -   - -   -  -
-                           -    - -        -    -    -                  -               --        -
-           -   -     -    -         - -   -         -    -      -   -  -    -  -         -  - --  -
-    - - -        -       -            -            -          - -   -  -     -        -     -   - -
-   -     -   -    -               --              - -     -   -                          - -      -
-  --     -         -  -      -        --  -  - ---    -         -                   -  -          -
--     -    - - --          -                      -               -    -     -  -   -     -      --
-      - -     -   -              -   -     -   ---      -    -       -    -       -  -       -   --
-    - --   -  --       -    -       --    -     -      -   -           -      - -   - -  - -      -
- -- -      -     -   -          ---         - ---   -       -    --  -  -  -        - -          --
-     -   -                -  --         -     - -   -   -        --   -      -    - -  -   -      -
-  -   --   -        -      -                  -          -                         -    -     -   -
- - - -   ---          - -  -                    --       - -  --     -- -   -     --  -    -      -
-   -     -      -   -  -        -- - -            -   -  -  -            -      --- --  -         -
-  -     -     -       -   -            -   - -          -      -  -  -  - - --       -      -     -
-      --    - -                -  -            --             -  -  -    -    -   - -   -        --
- --       -             -                -            --     - -      -              - - -        -
--         -          -  -      -     -       - -  --  --          - -        -  -  -       -      -
-    -                  -- -   -- -                    -  -   --     -     -       -     - - --    -
-  --  -     -  -  -         -   -               -  -      -        -             - -   -          -
-        -       --- -   -    - -              - -       -        - -  -    -  -     --     --     -
-              -                     --  - -    - -  -   -  -         --       -         --        -
- -  -  - - -       - - -     -      -     --           -     --   -             -   --     -      -
-       - -          -     - -  -  -         --   -  --     -      -- --  -       - -         -    -
- --          -       -     -    --        -  - - - -      -    -  -        -- - -   ---      -  - -
-                -      -                     -                           --- -    -   -     --  - -
-          --           -  -               - -     - -  - -               -       -     -   -     --
-  -   -            -     -          -    -  -  - -          -  -      --      -              -    -
-             -     -     -  ----  -        - -   -    -       -    -              -   -   -   - ---
- -   -- --                -           --     -   - -      -     --       -    -    -    -      -  -
-               -          -  - -        -           - -          -             - -  -            --
--            -     --    - --   -  - --   -        - -      -              -    -    -       - -  -
-       -    - -  --           -     -     --     -       -   - - -           -        -   --   -  -
--       -  -  -               -      --- - -   --     --        -      -  -   -     -    -        -
-   - -   -     -                   -   -  -- -   --           -     --      --         -  --      -
-  -  -      -  -                      -    -       -     -  --  -    -     - -           -      - -
--       -                -- ---   --       -         -         -                    -   -         -
-  -     ---         -          -           -    -    -                -       -      -     -      -
-      -      -- -       -   - -      --  --      - -       -   -   -                  -     -   - -
-        -  -     -    -            - -    -  -                 --          -          -           -
--    -- --    -      -     -    -    - -  --        -   - -        -        -   - - -       -    --
-   -  -  -  --           -        -    -    --    -        -   - -       -        -              --
-  -- -       --            - -      -      --            -  -      --                 --       -  -
-                -     -    - -         -             -      -    -  --       -  -               - -
-  -   -- -             --   --  - -   -   -- -  -  -    --- -    -    --         --       - -   - -
-      --            - -  -   -   -              -    -     -- -      -  -          -     - --     -
- -      - -           - --      -                 -    - ---    -   -              -    -     -   -
-      -     -                   -       -  -      -    -    -           - -         -     -       -
-   -  -      -          -     - -  -  -       -  -             -  -       ----   -   -            -
-    -      -    ----       -               -         --      -   -       -     -      -        -  -
- -          -   -    -   -                       - -             -  --           -          -     -
-  -   - -        --     -  - -   --            --  -     -  -- -             -          -    -    -
-  -                       -          - -            -  -     -      - -- -              ---       -
-         -             -        - -        - -   -                - -- -         -     --       - -
-     -          -                                    -  --                                 -      -
- -    -    --   -        -  -     - --   -          -              - -    -              -     - --
- -- -  -     --     -   -    -   -        -  -   -- -       -  -     -  -           -   -  --     -
-     -               -  --     -        -  -   -  --   -    --  -    -   -  -  - -      -         -
-  --    -              - -        -             -      -  -  -               -      -     -       -
-     - -               -   -      -     -    --               ----    --        - -          -   --
-              -  - -    -  --- -  -  -   -           -                            -       -    -  -
-  -      -         -                   -     -    - -    - --    -      --  --        -   -      --
-     - -     - -                  -         -        -        -   --          --   -   -  --      -
--          -        -   -  -  -     - - --  -       -     -  --                  --           -  --
-    -   -  -    -- -                 -       -          - --                    -        - -    - -
----------------------------------------------------------------------------------------------------