100
100
----------------------------------------------------------------------------------------------------
-               --   -                             -    -     -   - -              --     --       -
- -  ---  --  -     -  -     -   -   -         -  -    - -  ---      -                        - - --
--        -      -     -  -  -      -   -           -- - -  -   -- --      --     - -  -   -       -
-              - - -   -          - -    --   --  -           ---  -   -    -    -      --         -
--  -  -        -  -   -    -              -- -     - -    -            -   -    - -    --  -   -- -
--     - -  - --           --       -    --        --    -  -     -   --  --            -  -  -    -
-      --    -         -      -       - -  -         -              --      -   -   -   -         --
-            - - -- -     -    -      -     - -- -  -     --        -  --      -  -       --- -- - -
-  -   -  -      -   -       --  -                      -  -   -    -   --    -     -  -        -  -
- --  -- - -    - - -  -- -   -                -         --               -      - -    -- - -     -
-    --           - --       - -    -    -  -   -      -  -    -        -              -    -   -  -
--           -       - --- -   -     --      - - -      ---    -        -    - -   -   - -   -  -  -
-              -- --     -- -       -       -  -   - -       - -      -                      -     -
-          - -  -   -  -      - -  - -   -   --             -  - -   -- -    -   -          -      -
-   -          -  --     -- --      -   -   -              -   -      -        - -    -   -        -
-  -      -         ---    -     -    --     -  -   -    -    -                 -                  -
- -     -  -           ---   -        - --     -       -  -   - -- -  - -  -  --      -  -       - -
-    -   - -  -    -   -      - - -     -- -    -  - -   - - - -    --   - -        -  -    -  -   -
- - -     -          -     -      ---  -    -  -      -    -      - --      - --       -  - -    - -
-  --         --  - -   -     -    -        -                 -         -  -      -         -      -
-      - -         -        - - -   -  ----   -  - - - - -  -     -  -    - -           -    -     -
- -  -       -    -        -         -  ---      -  -    - -  -     -        --  -   -     -       -
-  -   -   - -    - - - -       --- - -          - -                 -      -   -      - - --      -
---     - - -             -          -     -  - - -            -   -            -- ---  --   -   - -
-    -     -  -  --    -        --   -  -       -          -       --  - - -             -   -     -
-            -  - -  -    -          -     -       ---     -    -  - -  -       - - - --   - -  -  -
-   -- -  --   ---    - - -        ----          -         -   -              -       -  --        -
-       -   - -  -  --         -   -     -   - -        -    -  --  - - ----   -  --               -
-  -     -    -        --- -  -  -      - --            -    --   -      -  -         -            -
-   --      - -     -    -    -    --  - -       --  - --- -     -   -   --      -   - - - -  --   -
- - - - -      -       -    -   -  ----   --    --          -       -    -        -    -     -     -
- -            - -    -     -  -    - -  -    - --    --   -                               -       -
-       -   -     --   --  -   -      -    -  -    ---     - -  -    -   -        --  --    --  ----
- -        -  -  - -   --  -   -    -       -       ----           -       --             -        -
-        -    - -    -   -  -        --  - -         -     -      -    -   -   -     - -- -- - -   -
-       - --   -                                 -  -  -   -   -    -     -  -       -         -   -
-   - -       --   -     -  - -   -   -                -   -     -           -   - -               -
-      -          - -      -       -     -    -  -        -     -            -   -   --     -      -
-  - - -   - - -  -  -    -     -         -    -        -   -                     - -            - -
- -   -     -- - - -     -              -                        ----  - - -   - -- --     ---     -
--    --  -- --    -    -   -          -  -   --     -    -  --    -   -  - ---    -   -      -    -
-  -       -- - -        -  - -         -    ---         -          - --   -    - -  -   -         -
--   -  -      -   - --  --      -       -        -    -  -  --   -       -                -       -
-  -          -            --   -      -- --    -- -  - -     -  -    - - -        -             - -
-        -  - - -       -          - -  - -            --            ---       -     -             -
-           -  -- -        --   -      -              -  -                      --         -       -
-      - -            -    -    -  -   -            -- -  -  -- - -     --  --     -        -      -
-  - - -  -  --        --    - -  -   -     --  -  -   -    -          -      -    -     ---     - -
-    -      -   - -      -  -  - -   -      -- -   --     -   - -     - -    -  -      -       - - -
-    -   - - -   -           -  -     - --     -      -     - -           - -   -   -    -       ---
--   - -   -  -  -    -    -         -    -   -  -     -      - -    -  -   -      -  -  - -   --  -
-   -     -   -          -  -  -  -    -                       -- - -  -      -              -    --
--    --    -          -      -    -              -  -    -                     -  -  -    --   -  -
-                - -      - -   -       - -  --  -             -  - -  -         -        - --     -
--          --      - -       -  - - --   -   -   -    -  -        -  --   -  -       -  - --    - -
-      -  -           -  -             - - --    --     -      --      -    -        -       -     -
--  -  -   -         -              - - -     -   ---  -     -  -    -     - --                    -
--       -                -  -     - --  - -           - - -  -   -          -  -    -- -   --  -  -
- ---  -  -     - --         -  --       - -     - -       --                    -  -      -      --
-      -     -   -     - -  -    -          -    -           - - - -  -       -    -    -      - - -
-       -     -          -                      -     - -    --       - -  -  --     - -  -   -    -
- -   -           - -  -       --    --         -    - - -   -     -    --           - -         - -
- -  --    - -  - --      --          -    -                -       - - -  -       -    -   -    - -
-          -  - -     -- -  -    -                   -   -     -        -     -                    -
-  -   -    -                     ----     -  -  --  - -  - -  -     -        ----    -  -- -   -  -
-  -      -   --        -       --        -  -    --                       -      -- -    -  -     -
-         -        -         - -   -    -   - -                 -  - -   -   -  -   --      --  -  -
-    --      -     -              -           -   -         -  -    -         - -  -   -      -    -
-   -                  -        -- -   -- --  -   -      -  - -  -    ---        -         -   -   -
-  -  ---   - -    -       - -        -          -          -   -  -         - -             -  -  -
- -     - -       -    --   -        - -   - -             -       -         -            -        -
-     -- -  --  -  -          -   -  -      -   -  - -            -    -    -  - -   -   -   - -   -
---      -          --      -   -  -   -   -   -   -  -    -  -            - --    -  -         -  -
-           -        -  - -     -        ---    -    -    -   - -     - - -           --   -       -
-  - -    -   - -    -      - -    -      -     --       - --     -     -    -  - -                -
-         --    -            -- --   -  -   --   -          -     -   -   - - - -   --    - -    - -
-- -  -    -     ----          -   -- -            - - -   -  -    - - --   -   -      - --   --   -
-- --     -- - -         - ----  -   -  -            -                   - - --  - - -    -  - -   -
-   - -    -   --            -         -    --  -    - -     -  -  -- -    - - -    -  - - -     - -
--   --                     -    -     -  -      --    -     -     --      -         --   -    --- -
-       -    -  -         -        -  -     -              -    -    -  ---       -   - -          -
-  -     - -        -   -         -  -   -       -- -  -  -   -- -            -   - -      -      --
-   -       - -      -          -   -         ---        - - -  -      -   -   -  - -      --  - - -
--        -  --       -     -  -   -    - -           --        -  -      -  -     -   -  --       -
-             -    --   -    -    - --    -   -          -- --      -       -    - -           -  --
- -  - -    -    -  -      --          --     -- -         -        -   -           -       -   -  -
- -   -       ---                  -- -      --             -    -      --        -   - -       - --
-        -  -   -               - -   - --  -   -     -      - -         -   -                     -
-  -                        -           -   --            - --  -        -                  --     -
-   - - -   -   -    -        -  -    -   --   -             - -   -    -- -   -     -   -     -  --
-        -     --      - -     -  - --- ---      - - - - - -   -                   - -       -     -
-  -   - -                -- --   - -  -     -   -  -      -    - ----  -      -    - -      -  -  -
-           -    -  - -  -  -   -  -       -            -    --         -          -            - --
-        -      -    -  -     - -   -       --    -     - - -        - -              -   --   --  -
--   -    --    -    -   -  -   -  - -         --     --      -    -    --    - -                - -
-     -     -                  --      -  -- -  -   -    ---         -      --  -   - -  -      - --
-            -   -   -       -  -   -    -      -           - -  - -     - -            -        - -
-  --- -     - -   --      -   -   -  - - - --   -   -  - -   -   ---- -  -   -     -        -     -
----------------------------------------------------------------------------------------------------
