100
100
----------------------------------------------------------------------------------------------------
-  --- -  -   -- - -      -  --  - -       -  - -   -  --       -- --   - -      -    -   -  -- -- -
-  --- -    -          - ---    -    --- - -  -   - - ---- -  --  -   -    -  ---  ---       -- -  -
- - -   -  - -  -   - - --   ---   --   --   -  - -    -   -- - -  -     -   -  -- --  -- - -  -  --
--    -   --- -- ----     ---  ----- - --- --  -  - -- -    - -  -- --  ---   ---  - -- -- -- - -- -
-   ---   -     - -     --   --   - ---   -  --     - -  --- -- -   - - -  ---- - -  -- --    -  - -
- --    -  --  --   - -  - ------- -    - --  - - -  -  -    -  --- -     --  - - -  - -   -- - -- -
--- --    -- -- --      --  -   - -   -  -   -       -   -  - - - ---  --  --- - - - -  --- - -- - -
-  -- -- -      -   - --     -- - ---- -     - --  -  - - - - - - - - --       - ---- -   -- -   ---
- - ---------    --     - --- - - - - - -    ---- - --- -    -- - -   - -     -- -  -   -   ----   -
-  -      ---- -       - -  - - --  - -  --- ---       -  --- ---- -   -  -     - --     -  -  - - -
- ---- ---    -----  ---- ----   -   ---   - -   --- -- -  - --  -   ----- --- - --- -- ----- - -- -
--     -   - - -- -  -  -      -- - -   - -    -         -   -  - - - - --  -   -       - -      - -
-  -   - - - -  -  -      ----- - -    --  -- -       -----  - - - --  - - - - -  ----- --  -- -- --
-     --   -  -- -  -  - -  -    -  --   -- -----  --- -   --- - --   -- ---  - -    ---  - --  -  -
- -      -      -  -- -  --- ----  - -  --  -  -  --   -   - -  -- -  ---   - - ---      -- - --- --
-  -- -    --- - -- - - - -   -  -  - --- - --  --   - -- - - - - - --  --  -   -     - - --  -    -
- -    ---       - -   --- -- -   -  ---  --   - ---- -  -     -  --   - -- - ---- -      -   - -  -
- -- -    - - - -   --    -  - - --     -  -  --    - ---  ----- - --- - -- ---   -- --  -  --  -  -
- ---   --    -   -  ---- -  -  - - -  -  --  -  ---  -   -- - - - -  - -   -  -- - -  -- -- - - - -
--       -- ---   - -  - -- --    - -- - -      --     -    - - - -- --  ---  -- -   -- --  -  - ---
--  --  - -   - - --    -- -- -   --  -  -   -- -  --       -- -- -   --- -  -    --       ---  -  -
- - - --- - -  --- -   -- -   - -   -     -    - --      -  --    ---    -- -          --  -  --- --
- - --  --       - - -   - -- - - - - - -  - - -- --- -     --  - -  --     --    ---- -   -      --
-  - ---  --- ---- - ------   -  - -- ---    - -   -  --          -    - --- -  --   --      - -  --
-- - -   -- - -     - - -  -- --  --     --     --  -- - ----  -- -- --- - --- -   - -- - -  - -   -
-     --  - - -       -- -   -     -  --   -  -     -   -   -    -  - -     - -  -  - -   -    - ---
--   - -  -  - -- ---  -   - - - -   --- ---  - -- - --  ---   ---    - ---- -   -- --  - - -- --  -
- - ---    -    -   -  -      - -- -  - -  --     -- ----   -- - -   -- -  ---  -   - -   - -- - - -
-- -   ----  --     --- -   ---- - --- - - - - --   -    --  --- -  -- - -    - ---  ---          --
- -   - --     -- -- - -- -  - - --   -- -- -- -  -   ----  -  -    - --   - -- -  -   - -- -  -   -
-         - --     -     --   --- -    -   - -  - -     -- -- -   -  -  -  -- - -- -- -  --   -   --
- -  - -    -  -    - --  - - --    ---  ------    -  - - -     -- -- --  -    --- - - -   - -  -  -
-  --- -  --   - - --  - --  -  ----   -    -- --- ----  -- -  -      --  -- -    -- -  - --  -  ---
- -    --- -   - - -    --  -      --  -- -   - - -  - - -    - -- - -  - - -- - - -- - --  -  -- --
-    -  -   - --  - - -- --- -  - -- ------ -- - -    -- ---     --  ----     -  --  -- ---     - --
---- -- - -     - - -     -  --- -  - -   - - -  -- -     -    - -  -  - - - -- - - -- - - - -- -- -
-  -  -   - ---     -----  ----  --- - - ----- -     -------- - -     - -- -   ---  -    - - -  - --
- - -     --  - -  -  - - -    --  --- --   -- -- -  - -      -- -   - -  -  -    -  ---- - - - ----
-   - -- - - -- -  --- ---  -    -    -- - -  -   - - - -  --- -  --  - - -    -----      - ----   -
-    - -   -- - - --  - - -    --  --   - - -  -   --  -  ----   - -- - - -- --   ---    - -   -   -
--  ---   - --     -- - - -- --- -   - --- -   -- -   -- -- -  -   -  ----   -  -- -- -- - -     - -
---   - - - - - --  --  - -   -- -   ---  - --   ----- -     - - -- -    - -  ---- -- - - -- -  -- -
--- -  --- --     -    -  ------   ---- --- -----   -  --    --    ---- - -  -    ---- --  -   - ---
- - ---    --  ---  -  - -      -    -          - --  - - -  - --     -   --- - -  -      ---  -   -
-   -  --- -  -  - ----   ---- -- - -  - - ----- -    -   -  - --    - ----     - -     -  - -- -- -
---- -- -- -- --    -   - - -   -- -  - -  --  --  - - ----      --  --  - -  -  --- -- --  - -    -
- - - -      -    ---  - - - -----  -  -   --  -   --  -   - -- --  -  -- -  - --   -  --   - - ----
- - - -     - -    -   --- --- -     -   - --- - -    -  - -   - -   - ---- -   ---      -  - -  - -
-   ---  - -     -  --  ---- -  --  ---- --  --  --  --   --  - - --       -    - --   ---  --    --
-  -  --   ----   --   -- -  --   -   --     - --   -           - --- - ---  -- -   - -- -- -  --- -
-- ---  - -    ---       --  - - - --- -   -  - ------   --  -- - -  -  -    - - ------- -   --  - -
--  -  -- --- -- - - --     --   - - -  - - - -     --  -  - - -- --- --  - -   -         --- -  - -
- -- -- - -    -- --  - -     -     -- - --- -- - --  --  -   - -    -  - -- - -  --   --- - -     -
- -- -     - - - - - --- - - -  -  --      -    -   -      ----- -  --   -  -- -       - --- -- -  -
--- --   -     -  --   - - - - - -- - -----  -  --- - - -    ------    -  -  - -  ---- -- --     - -
-- --   -     -- - -        - ---  -- -        - -   - -- ---  -     - - -- - --  -  -   -  --    --
- - - -  -- --    - - - - - --   - -  --  -  - - --  -- - -  --  - -        --  -   -   -- -    -  -
- - --- - - - -- -- --  --    - -  --   -  -   --  -  ---     -   -- -     - -   - -- - - - -  --- -
--  - - - -- --- - -- -- -----   - - --  -  ---  -- -       -    -   - --    --  -    -  - ----   --
-- - --  -  -     -  - -- -    -    --- -  ------    - -- -    - - - - -  - -      --   - - -- --- -
- -- -- ----    - - --  - --   -        -       - -- --  -----   --- -- ------  -- -  - -   -- -   -
-          - -  - -- - -- - - -- -- --    - ---   -  -  -     - -              -   - -  --- -  --- -
- - -  - - - - -  - -    ---  - -   - --  -    -   -  --  --   ------- ---- ---- --    -   --- --  -
- -- -     - - -     ---    - ---   -      -  -- -  --  --  --        - ---- -  -   --   ---- -  ---
-   ---   --- - -  -   -  -- - --     --  - -   --   --  - - -- - -        --    - -   -    - --   -
- - -  ---    - -- - - - - -- -   --     --   - --- --    -     --   --  -- - - - - -- -- ------ - -
- ---- - ----   - - --  -- - - - -- -- - - - -- -- - - - - - - - --  ---   ---- - -- -      --  -- -
-    -- -     --- -   -    -  -- -  - --   ---    -  --  -        -   - ---  --- --  --- -- -    - -
- -  - - -----  -   --  -- -    - - -      -  ---  --  - -   --    - --   --     ---    -  - --  - -
- -  --  - -  --- - -  - -   -  -  -  -  - ---      - - -   -  -  -- -- -- --- - -- -- ----   -    -
-      -    -    -- --  -- --     ---  - -    -   -  -  - -- - ---- - - -- - - -   --      ---- -- -
-  - - - --   ---- -    - - - - -      - -   -   - --  --  - -  --- ----- - --- --  - -- --- -  -- -
-  -   --    -- - --  -   - -  - - --- - --------  - -    --   -- - -  -  -   ---  - - -  -- -- -- -
-- - --- -  ---- --    - --  -- -- -  - -        -- - - - - --    --- - --  -- --- --    -  --  - --
- --      -  --      --   - --   -  ---   --     - - ---- -  - -   -- - - -- -     ----    - --- - -
--   ---- - --- --- -  -- - -  -- - -      -- -   -  - -    -  --- -   - -    -----     - --  - -  -
- --   -       -   ----  -   - -     -   - ---  -  -       ---  -  - -   - - -  - - ---        --  -
- - - -- -   -- -    - ------  -- - -- - --   ---  -- - -- - - -     -  --   -   - -  -  --  -     -
- -   -     -   --   - -  -   -- -  -- -- -  -- - -- - -  - -  ----   -    - - -  -----     -  -----
-  --- - - -    -    -- --  -     -  -   -- - -- - - -- - - - -- - - -    - -  -  --  - ---  -  -  -
- - - -   -  --- - - - - --- -   - -    - --    ---    -     - - -   --  - - -- --    --    -  - ---
- -- -  -  ----- - - -    - -     --   - -   ---  - -   - --  -  --   --   - -  - -- -  -- - --    -
-   -    ---  - -         -   --  --   - - --   -- --   - -  -  -- ---  ---  -- -- -  ----   -   ---
-   - -   -    - -    --- - -   -   --   - ---    - - - - - - -   -  -- -- -  - -  --     -- - -   -
- -  --  -       -        - - -  -- - - ---   --- - ---   - -   --- - --  - - - -    --   - ----  --
- ---   -- --   ---  -- --   -    - - ---   ---  ---   --- -- -    - -     -- -   --  - - - -    - -
- - - -- --  --  -  -- -- -  -- --       --    - -  ---  -      - - -   --- -- - -- ---   -- ---- --
- --  - -  - - - - -  - -   - -   - ---- -  ---- --   ---- --- -- - - --- -  - -- -  -   -        --
--  - - -- -   -- -  - -    --   -   -   - --    -   -   - ---     ---    - -      - -    - -- - - -
-- -- --- - - -- --      -- - -- - - -- -    ---  -- -- ---  - ----  - -  -  ----      -     - - - -
- - --   -  - -- -- - -- - -- - - - ---   - - --    -  - -     -   - -----  - -   -- - - - -- -  - -
- -----   - -  -- - - ---   -  -- --       --- - - -- - -  -- - - ---    ----  --   -     -   -  - -
- -  -  - -   --   -    -- --    -  -- -- -   -  - --  --  -  -  ---  - -        -  --- -   - - - --
-- -  --- - ---  -- - --      ---- -- - --  - -     --- --- -- - --- ------  -- ----   --        - -
--  - -   -- --   -   - --  ---     - - -   -  --   - -  --        ---     --- -   - - - - ----   --
- - - - -   - -  - - --- -  -- --- -  --   - -    -- -  -   ---- -   - -  -  - --- -   - - - -- ----
- - - --  - -  ----   -  --  --         -   -  -       --  - -    ---  -   - -  -- ----  -  -- -  --
- - -  - - -     - ----     -   --  -        -- - - -     -   ----      --- - -         -  -   - - -
----------------------------------------------------------------------------------------------------
