100
100
----------------------------------------------------------------------------------------------------
-  -   --     - - -               - - -- --   --  -   --- - --- -    -  - - -- - - --   -   -      -
--- -- - -  ---- - -   --   - -   -  -  --  --  --  --     -     --   - -  -- - - -  ----     ---  -
-   -   -  --  --    -     -  ---- - --   -- -----   ------- --- -- - - - -  ---- ---        - --  -
-  -   --- - -    -   --     -    -- -   -   -   -         -   -     - --  --  -    -----   ---  - -
-- - -- - -  --- -    -   --  --- - -- - --    --     ----- --- -----     - ---   -     ----     - -
- --   -    - - -   -- - --- --  -    -- -  --   ----    -   -   - - - -- - -  -- - - ------   --  -
--  ----- --  -     -     - -- -- -     ----  --     - -  ---- -  --    - -  -- -- -- -      -   - -
-  -   -- --- - -   -  - -     --     --  - -    - --   --     -  - -  --  -    - - -   ---   ------
-- -     - --  -  -- --      -    - --- -- - ---  -    -- - --  -  - - -- -  ---    --           - -
--  -  --    - --     - --   -- -- -  - -- - - -          - -   - -  - ----     ---   --   - --- - -
- -  - --- -- -   - --    -  -  - - --  -  -   - -     - - - --- - -  -      --   --  - -- --      -
- - -- --  --- -    - ----  --    -  - -   - - --- ---  - - -  - - - - --     -       -     -  -- --
-   -  - --  --    -    -    ---  -   --   - - --  -  -  -  ---- - --     ---- -- - ---       - -  -
--  ---    -- --- - - -     -   ---- - - - -- -  -  ----   -   - - - -  --  -- --  - -   - --    - -
- -    ---  -  -  -  - - -       -  - -- - - ----- -  - --   - -- - ---    - -     - ---      -- ---
-- -- -     - - -  - - - - --- -- -- - -  -   --  ---- - --    -----   -- - --  -   -  --      --- -
-  - - -- --     - - - - --  -- ---- - -- --  -   - - ---- -  -   - ----- - -  ---       -   -    --
--  - -       -      - -- --- -      - - -   -  -  -   -  -- ------- -      --      - --- - -- - - -
-- -- -   - -    -- - -- - -- -   - - --  -    - -   --  - --  --   - -  -  --    --  - -  - -    --
-    - - -- ----- - -   --- -   -  -    -    --  - - - --    - - --    - --  - -  -- - - -  - -  ---
-     -- --- -   - - -   -  ---- --        -      --- -- - --    - - ----  -   --- - - - -  - --  --
- -    --  - - --  -    - --    - -        -- - -        - -   -    --   -   ------   -  -      -  -
- --  -  -- - -- -    - --    - - -----     -   -   - --    - -- -- -      -- -   - -   - -- ---  --
-  - - - -  -    -- --   -- --        --  - -    - - - ----   --- - --   - ---  --   --     - - -  -
-    -     -    - -   - - -- - ---   --- - --  -     --     - - -   -- - - -   -- --  -   - - -  - -
- -  - ------   - - -  ---   -  --      - -  --  - -- -- ----- -      --  -- -  --      -- ---- -  -
-- --    ---  --  - - - ---- --   ----  - ----   --  -- - -   -  -   -   -   -  - --   - --   --  --
- --   -- - - - --- -  -    -   -     -      ---       --- --  - -     -    -   ---  - - - -  -    -
-- ---   -  -     - - - --- -- -  ---- ---    - ------ -- -  - - --   --       -    -  -  -- -- -- -
-      - - - --   -  - - - --    -  -- ---  -   - -- -- - ---- ---- --   -- --  ---  -- -   - - -- -
- - -  - -  -   -  --- - -  --  - --       -  - -    -     -   -  --    - ----     - - --   --     -
- - - --- -- --  -   -- -  - ---- ---  ---    --    ---  -- - - --    --- - -  - -    - -   ------ -
- - - -  -- -  - ----  ---   - - -        - - -- --   --  - -   -  --- - - - -- - - --   -    -  - -
-   - --    -  -    - - -  - -- -   - --   ---  - - -  - - - -- --     --  - -  - - - --  - -- -  --
- -  -   - -       -   ---   ------ -  - - -   -   - --     - -  -  -- - ---- - - -- - - - ---  - --
-  -  - -    --  - -   -   -   - - - - -     -- -- - -  - ---- -   -   --  -  -      ---  -    - ---
- - --- -- -    - -  ------   - -    ---     - -  --  -  -   - -- ---  - - - - -- --  -  -  -- --- -
- - - -   -  ---   --   - - --- - -      -  ---- -  - -- ---     - - - ---   -        -  - ----    -
-  -  -- -  -   - - ---        -- - -   - -   -- - --      --- - - --       -  ----  ---- -     - --
- -  -         - - - - --- --- -  -- ----  ---  ---  ---- -  -        - -- -            - ----  -  -
- -   ---  -- -- --  --  -- - ---      - --    --  ----     --    ----  - - --    -- - - - - --   --
--  -     -   -  -   - -- -- --  -- - - - -  - - -     - --  - -- - -     - -     -- -  --  -    - -
-  -  --  - -- -   --   -  --  -   -- - -- --  --- ---- --- --    - - - -- - -   -  -- -- -  ----  -
---  - - -- -- -- - - - -- --    -   - - ---  -        -     --  - --  - --  --   ----      - - -  -
-  -   -   -    -  -- - -  - ---- -    -- -    -- --  -  -  -  -- -    - - - - --     -  ---  - -- -
-- --      - - - -  - -    --   - -      -  ----  -   -- ------ -      - --- -  -- ---  -   -  -  --
-  - -  -  - -  - -  - ---  --    - - ---- - -   - -- - -- -   -- - -- --  - - -  -    - - ----  ---
-- -  --     --   -   -  ----    - -  -  -- -  -----  --   -    - - -- -   -   ----    --- - - -- --
- - - -  - --- ---- - --- ---   -  -  ---  ---   - -   --  --- -- ---  - - -   - - - --    -  --- --
- -  -- -  - -  - -  -- --   -    -  - - -- - -   --  --  -      --  -  -  - -  -  --- -- - --- -  -
- -    - - - - -      --   -- - - -  --  -- -- --  -   -----------  -    - - -- - - - - -  -     - -
-- - --  - -     - --- - --  - - ---   -- ---  - --- ----      --  -- --    -   --    --  ---      -
--  -  -- -  -   ---- -  ---- --- --  -- -   - -   --     -  - - - -  - -    --    -   -- --  -  - -
--    -- - - -  - -    -     - -  -  -  - -- -- --  -  ------ - --   ---  -   - -- - -  -  -- --   -
- -- -  -  -- --  - -- -  -- --- -  -- -       -  - -     -  -  -     ----  - -        ----  ---   -
-   ----    -- - - -  -       - -  - - --- - -  -     ---   - ----   -           -   -     -- --   -
- --   -    -  -- - --- -  ---    - ---  --  - - -    -    - - -   -- ---     --    -  -- - -- - - -
-------- -    --- --   -   --  - --  ----  -- -- - --- - --   -  --       -  - - ---      -- --  - -
--    - --- - -  - ---   -     - -  -  -       ----    -    - -  -  -- - - -  -    ---  -  - - -----
- -- - -  - - -  -       - --   -        - -      - ----- --   -   -- -  - --       --   ---- - -  -
-  - - ---  - -- -- - - -------- -- --   - -  -  - - - ---- -    ---  -- --  - -  --  -   - -  - ---
-- -     - -- - -- - ---   --- - --   -   ---    --- --  -- - --       -      - - - - -  --  -     -
- -     -  - - -  - -    -  -   - - - - --   -  - - -  --   ----- -- -- -- -- -  -  -- - -----   - -
- -      -   - -  - ---- - -- - - - - -  -- -  -   ---- - -    - - - - -  ---  - - -   -  - - ---- -
---   ----  --- - -     -- -- ---- -        -- -- -- --  -  --    -- - --- ----- - -- -- -- --     -
--    --  -  - - - --   -  - -   -- --    -   - -  - -  --    -    --- -         ---       -  ---  -
- - --  -- ---- - - - --- - ---   -    -    -- -  - -    -- - - -  -  - -    --- -  - - - -  - - - -
- --  - - - - - -- - - - - -- -- - --   ----    -   -    --    - -  - - ---     - --- - -  - - - - -
-- - -- - -  -   -       -- -  - --  - -      -    -    -- ----- -   ---  -- -- - -    - - - - - - -
- -       --  - -  -  -- - - - -- -- -  --  - - -    - -   - -    ---    - - - -   --  -  ---   -  -
- - -   -  - - -   -  - - -   - --   -        - -   -- -- -    --   -----  -   -- --- -- -   -  -  -
-  - --   -- -  - -  - ---    -   --   ------ -      - --  -- -- --- -- --  -- - -   -   - --   -  -
-    - ---  -- -   -- -   -- -  --  - - -    -   - -- - -- -- - - --   -- -  -- - ------- -  - --- -
-    --  - - -- - -  --  -   --- ----    -- ---    - -  --- --- -- --- -    -- -    -- - -- - - - --
-      --  -- -  - - - - -  -   - -  - -- --- - --   - - ---      -   --- - -  --- -  -  -- --- -  -
-----   -- - - -  --  - ---  ---- ----    -  - - - - ----- - -- -----     -- -- -- --  - --   --  --
--      -  -    -   -  -- -       - --  -    -- - - -   -- ---       - -- -  - -- -    - -  - - ----
- --  --  - ------  - -  -- ------   --  -    - -   - - -     - -- - -      -     ---- -- --- -- ---
-   -   ---  -       - --  - -- --  -  --- - --  --     -   --          -   -- --- - -- -     --  --
- -  -     - - -  ---- - --- - --     - - - -- -  - ---   - - - ---- --   -- --- -   -  --   -   ---
-   --  - ------ -    -   ---    - -- -  -   - ----        - - -- -  -  --    - -  -- - - -   --   -
---          -    --  - --   - -       - -  -- - -   --  ----  -- -  --- --    ---  -      - -  -- -
-    ---- -----   -  - - ---  -   - -  -         --- -- - - --  - - -- -- - ---  ---   --- -      --
-- -- ---   -         -  - -   -  - -   --    -- -         -  -   -            -- -     -    -  -- -
-     ---    -- -  -   - -    --- --        -- - ----- - -   -        -- --    -       -- -   -- - -
-  --    -  - - -   -  ---- --  -- --  ---  - - -  --   -  -  --     - -    --  ---- - - - - -  -  -
--   ---    -  -- -  --    -  -- - -  -   - ---   - - -  -     -    -- -  -   -     -     -- - -- --
- --   -- - --   -  -  --- -- - -    ---- --    - - - ---   -- - - ----  - ----- -  -- - -  - - -  -
-    --   --- -  - - - ---    - - - -  -    ----  --     - - - -  - --    ---   -  - -- --- --   - -
--- - - --    --  -   -   -- - -- - -  - ----   -       ---  -  --- - - -     ---  -- - - --- --  --
-      -   --     -    - - -- -    - - -   --- -- --  - -  - -  -  -     ---- -    -  --     -- -  -
-  - -   -- - ---  ---   -  ---  - - --     - -     - -  -   - -  --  ---- -- -  -- --    ---   -- -
-  -  --  -  -     - - ---- -    -  -- -  --- ----  -- -----  -   -  --  - - -  --     -- -- --    -
- -     - - -  -- -  - -  -   -- -  - -- -   - - - - - - - -   --   -- -- -- --  - -  - - -- -- ----
-- -- -- - -  -  - -  --    --- - --   - ------ -     -- -  - -   --  -- -  -- --  -- - - -  - -   -
- -  -      - --  --  --  -   - --    - -   - - --       - --  - - - - -     -   --    -- -  --- ---
-- - - - - --   -   -   - - -  -  --   - --   -- ---- -- -  -    -   -  - -    -   ----- ---    -  -
-  - - - -   --  -  ---    --   --     -    -   -  - - - -- -   -- ----     - - - -    - -   ----- -
----------------------------------------------------------------------------------------------------
