100
100
----------------------------------------------------------------------------------------------------
-    - - -  -     --  -     -  -- - - -- - -- --   --- - - ----- -- -- -   - -- -  - --   - --   - -
----- - - -- ------ -- ----- --- --- -- -- -- - --- - -- - -   - -- -- ---- - - --- -  ----- ---- --
---- -- -- --  -- - ---- - --- - -   - -- -  -- ----- - --- --- --- - - - - --- -- ----  -  -- -- --
-  - ----- ---- -- ---  --- --- --- - --  --- -- -  -- ---- - -- - - --- --- - -- ---- -  -----  - -
--- -   - -   --  - - ------ - --- --- - - -- - - -----    -- -- ---- -- --- - ---   ------ -- -----
- - -- -- ---- ---- --     -- --  -- -- -- - - ---- -  ---- - ----   - - -  -- -- ---  -  - - --   -
- - - -- -  - - -  -  --------  --  ---- - - -- - -- ------ --    ----------  --- -  -- --- - - ----
-- --- - ------ ------     -  ------ - - ------ -- - - ------ ---- - --  -  --   ------- - --- -   -
- ---------- - - -- ------- -- -  ---- -- -- - - - - - ---- - - -----  -- --- ---  -  - ---  - -----
-- -   -   - - - - -   ---- --- ---  - - -  ------ - - -   --- -- -- -- - - ---  ----- -  --- - - --
- - --- --- ----- -----   - -- -   --- ----- -    --- ----- -- -- - ------- -- ---  - - --- - -- - -
--- -- --  - -   - -- ----- - ----- - -- - -- ----  -- -- - -- - - ---    - - --- --- - -  -- - ----
-- -- - ----------- - - --- ---  - - - -- ----   ---- - -- -- -- ---  ----- ---- ------- --- ----  -
- - --- --  - - -  - ---  ---- --- - --  -   ------- --- -- --  --- -- - -- -  --   - ---  --    ---
- - -  -  -- - ------ ----  -- ------- ------ -    -- ---- -  -- - - ----  - --  ---- -  --- ---- --
- - ------ - -- -   --    --- ----   -- -  --- --- ---  - ---- --- - --  ----  -- - -- --   - - - --
- -- --  ---- - ----  ------- - - ---------  -- -- -- --- - --- -----  --    -- --- ---- ---- - - --
-----  -- -  ---  - -- --   - -- -   - - - ---- - -- - --- -  - -  - --- ---- --   -- - -- -- -- - -
- -- -- - ---- ---- -- - -----  ------- -- -  -- -- -- - - ----- -- - -- -- -- ---- - -- -- -- -----
-- - -- --   -- -  --- - - -  -- - -    - ---- -- - ----- --- - - --- - -- - --- --- -- - - - -    -
-- -- --- --- - ----  - - - ---- -- ---- ---  --- -- -   - - -- - - ---- - - - -- - -  -- - - ------
---  - -- - - --    --- ------ - - - -- --  --- --- - ---- -- --- - - - - ---- - - ---- - - ----- --
-- --- ---- - ------ - -   -  ---- - -- - -- - --- ---   - - - - - - - ---    ------ -- -- -    -- -
- -----   -  - -  - -- ---- --  - -- - - - ---- - - - -------- --- ---  ------  - --- - - -------- -
- --   --- -- - --- - --   ----- - --- - --- --- -- --- ---   --- -- ---  - ---- - - - ---    - - --
- - ---- - -  - -- -- ----- -- - --- - ---- -   -- -   -  ---- -- - - - --- - - ------ - ------ -- -
- ------ - -- ---- - -  - -- -- -  -- -  - ----- ----------  - - -- ---- - ---  - - -- --   -  -  --
- -- -  - -- -- - -- ---- - -- ----  ---- -- ---- - --- -  -- --- - -  -- --  --- - ---- --- -------
- - - --- - - -- --- - - - -- ---- -- - - ---  ----- - - ---- ------ --- -- -- - -- - - -- --     --
----- - --- - - -  -- -- - -- - - - - -- -   ---    - -- -- --    - --  -  --- - - - - -  -------- -
--   - -  ----- ------- ---- --- -- --- -----   ----- ---  -- ---- -  ----- ---- --- ----- - - --- -
- -----  --  ---  --   --- - ---- --  - -    ---    -- - -- - -  ----- - -- - ---  - - ----- -- - --
-----  --  -- - --- ---   ------ - ---- -----  ------ -- -- -- -- - -- - -- --   ---- --  -- -- - --
-    -- --- ----  - - ----  -   -- - - -   -----  - -------- -- -- - -- ----  --- -  -  --- --- ----
----- - - --  ------- -   ------ - - - ----   - -- -  -  - ---- ------ - -  --  -- ----- - - - --  -
-  -- - --  -- - --  ----- --- - - - - - - --- - - --- --- -  - - - - -- ------- --- -- - -- - - ---
---  -- - -- -- -- -- -  --  - - --- - -- - -- --- -  - - - ------ --- -- -   ---  - -- -- - - - - -
-- -- - -- - ---  - -- ------- --  -- -- -- - - -- ---- - - --  ---  -- -- ---- --- -- - - --- - - -
--   -- ---- -  --- --- -    --  -- -- - -- --- ---   -- ---- -- - -- ---- -   - - - - - --  -- -- -
-- --- - -- ---- - --- - ----- -- -- - -- - -- - - --- --   ----- - --- - - ---- --- --- ----  -  --
---  --- - -- ----- - -- - -  -- - - -- ------ - --  - - ---    - --   -----  -- - -- - -  - ----- -
-- --  - - - -   -- - - - ---- --- -- ---  - - ------- -- - ---- - -----  - -- -- -- -- -----   -- -
- -- --- --------  ------- - ---- - --   -- -- --  -- - ----- - -- - - --- - --- -- - - - -  --- ---
- - - - --     - --- -   -- -   - - - --- - ---  --- -- --  -- - - -- --- -- -  ----- - -- -- -- - -
- --- --- ----- ---- ---- - ----- --- ------- --- -- -- - --- -- --  --- - - ---  - - - -- --- -- --
- -  --- - --- -    --- -- --- - - - --   -- -- - ---- - - ---- - ----  -- -- - -- -- - - --- ---- -
-----  - --  - ----    -- - - -- - --  ---  ---- -   - - - - -----   ---- ------ - -- - ---  -    --
-- - --- - ---- -- ----- -- - - --- ----  -- -- ------ ---- -   - ---- - -  - -- -- - ---- -- --- --
- - - ------ - - - -   - --- ------- - --- - -- -    - - - -------    -- ---- --- --- -- -- --- -- -
- - --- - --- -- - ---- - --      --- --- --- -- ------ --- -- ------- - ---- - -- -- - ----   -- --
- -- - - -- ---   - -  --- - ----- -- -  ---- - -- - -- -  -- - -    -----   - - - -- -- -- ------ -
--- - --- - - --- -----  ---- -  - -- ---   --- - - - - ---  --- -----    ---- --- - ---- ----   - -
-  -- - -- ---   --    -- - -- --- ---  ------ - -- -----  --  - --   ----  ---  - ---   ---  ---- -
--- -- - - ------ ------ - - --- ---  -- -    --- - - - ---- ----- --- -  -- - ------ ----  -- - - -
- -- ------    - -  - - -- -- - --- -- - -----  - ---- -- ---    - --- --- - --- -   --   -- -- -- -
--  - -  ------- ---- - ------ -- - ---- - -  --- -   ----   ---- ----- -- -- - - ---- ---- - -- - -
- ---- -- --   ------- --- -  - - -- - ---- -- --- --- -  --- - -- -  - -- - - ---  - -- -- -- -----
-- -  ----  ---- -    - -- ----- ---- -- - - -- --- ------- - - - - --- - -- - -  -- - - - - --    -
-- ---  - -- --- -------  --  - -   -- - - -- --  --    - -- -- - -- - --- --- ------- - --- - -----
- --  ---- -- - - -- -  --  -------- -- -- - - --- ----- -- - - - -- -- - -- - -- -- --- - - - -   -
- ---- - - --- --- -- --- --      - -- - - - - -- -   ---- -- -- - -------  ---  -- - - - -- -- ----
--  -- -- --  -- - - - - - ---- --- -- - --- - -- ----  - - --- ---      --- - --  ---- - ------ - -
- --- -- - --- - --- --- --  --- -- -- - - ----- --  ---- -- - - - ------ - ---- --    -- -  - --  -
---  -- --- -- - - ---- -- --- - --- - - --   - - ---    - ----- -- -- ---- - - -- ---- -- -- -- ---
-- --- - -- - - - --   - --   -- -  ---- - --- -- -  ------ - - ----  -  -- - -- --  - - - --- --- -
-- -  --- - ------- ---- ------- --- -  ---- - -- ------ -- - - -  ------- - - -- ---- - --  --  - -
-- --- -- - -    -- -  --  -  - ---- --- - -- ---- -    -- - --- ---  --  -- - - -  ---- -------- --
-- ----- --- ---- -- --- -- ----  - - - - - --   -- ----- ------ -  -- ---   --- ---   --   --  -- -
---   - -- - - -- --- - - - - ------- --  --- --- -- -  ---  -  - --- --- --- - - -  -- ----  -- - -
-- ----- - - - ---  - - - -- -- -  - -  -- --- ---  - ---- -- --- - - -- - - ---- --- -- -  -- - - -
- ---   --- - - ------- - ---  - ------- ---  - - ----   - ---  - -- - --- -- -- -  - ------ - - - -
-- - ----- -- -- -- -  -- -  ---- - - -- -- --- - - ------ -  ---- - - - - - - - --- -    ------ ---
---- ---  -- - - -- ---- ----  - - -- --- - -- - - - -- - -- - - - - -- ---- --- - -  ----  - - - --
- - - - -- - - -- - - - -- ----- -- -- ------- - ---- - ----- - ----- --   --  - -- -  -- -- -- -- -
-- -- - -- - -- -- --- - - -  --- --  --    - -- - -- --    ----   --- ----- --- - ---- - -- ----- -
-- -- ---- - -- - - ----- - --- --- --  ----- --- - --  ----- - --- ---  ------- --   - ---- -- ----
- - -- -  -- -- ---- - ----- - - -- ---- - - -  - ------ - --- - - -  ---  -   -------- -   - - -  -
- - -------- - - --- - -- - ----- --   - -- ------ - -  --- - -- ----- ---- --- -  -- ------- -- ---
- - - --- -- --- -  - - - - --- --  ---- - -  --  --- -- - -- - - -   - ----  -- --  --  - - -  -  -
--- --  -- -- -- ---- -- ---  -- --- -- -- ---- -- -- - - - --- --------  - -- - - --  -- -- -------
-  -- -- --  -- -- - ----  ---- --- -- - - -- ---- - ---- - -  --  - - ---- -- ---- --- ----- -    -
------- -  -- - - - -   ---   -- - --- - --- -  -- -- - - -----  -- - -- -- ---   --  --   - - -----
---    ------ ----- ---- ----- -- - -- - -  ---- --- --- -   - -- ---- -- - -  ---- ---------- - - -
-  ----- -   --- - - -----   ---- - - --- --  - - ----  ----------  ---- -- ---  - -   - -- - - - --
------- - --- - - -- -    ----  - ----- -- ---- -- -  -- - -      --  -   - - ---- ---- -- -- - -- -
- -   --- --- - --- - ----  - ----- -- -- --   --- ----- - ------- --- -- -- -  - ---- -  -  -- -- -
-- --- ---  - - -- -- --- -- ---   -- -- - ----  ------ - -- - - - -  - - -- ---- - - ----- - -- ---
- -- --  -------- - -- - ----   --- - -----   ---- ---- -- - -- -- ---- - --- - ---- - --- - ----  -
--  -----  -  - - - -- - --  --- --- - - - ---  - --   -- - -  - ------ - - - --  ---- --- - - - ---
- --- -  -- -- - -------- ----- -  - -- -- -  -- ------ - - ---       - ---- ----- -  -  - -- ---  -
-- - - --- -- ---   -- --- - - ----- - -- ---- -- -  - ---- -  -------- -  - --   -------- - -  ----
- -- - - - -- -- ---  --  -- - - - - --- --   -- - ---- -  ---- - -- --- --- - --- --- - - - --- - -
--- -- -- - -- -- - --- ----- --- - - - - ---- - - ---- --- - - -- - -- -- - - -- - - -- - -- ---- -
-- - -- --- -- -- --- - -   -- - -- - - -- - - --- -  - --- - - - ---  - - -- -- --- -- --- -- -  --
- -- - - - - -- - - - -- --- - -- - - - - - --- - - ---- - - -- -- ------ -- - --  --  -- - - - -- -
-- --- --- -- ---- - - - -- --- --- - --- -- - -- - -  - - -- --- - -   - -- -- ---- -- -- -- --- --
- --- -- - - - - - - ---- --  - -- --- ---- ----- -- --- ---- -  --- ---- -- - --  ---- - -- -  ----
- -  -- - -- -- -- -- -  -- --- -- --- -   - -   -- -  - -   - --  - ---- -- --  --   - - - ----   -
----------------------------------------------------------------------------------------------------
