100
100
----------------------------------------------------------------------------------------------------
-       - -                - --  -                -    -     - --   - --- -   -            -  - -  -
-           -         --   -   - -        -    -      -  -   - -       -      -     --    -  -  - --
-      - -      --- -      --    -  -         - -  -- -     - --  --    - -             ---        -
-- --         - -      -     -     -  - -             -  -     -  --                        --    --
- -        -   -  --               ---   -  -     -   --        -            --    -   -    -  -   -
-     -        -    -      -  -   -  - --      ---  -         -    --        -          -  -    - --
-     -- -          -  -- -           - -   -     -            -       ---        - -       -  -   -
-           --- - - -  -   --    -    -      -       -             -         -   - -   -   --      -
-                  -- -     --                 -   -                   -  --    -      -           -
- --- - -      --- ---    --   -        --     -   -    -   --     -  ---              -   -       -
-  -   -    --   - -        -              -                     -    --          - - - -  -- -    -
-     -   -      --  -  -- -           -  - - -  -           --    --    -   --- -                 -
- -   -          -  - -    -  -   -     -         -    -     -       -      --       -  -- -       -
-- -     -        -  -     - -     --     -   --  - --   -    --  -       -        - -          -  -
-                   -             --  -                   -     -          -   --      -   -      --
- -  -  -- -       --  -   -                  -     -  -   - - - -      -       -  -       - -   - -
- -   -   - -        -  -  -      -     -   - -     - -   -   --   -    -  - -         -       -  --
-  --    -      --      -          --   -  -     --  -  -                 -   -  -        -        -
-   -     -              - -  -  -             -     -       --        -     -  -  -    -   -    - -
-     ---   -        -   -  -  -      - --   - --                -  -          -  -  -     -- - -  -
-  -- - -          -  --     -   -       -    - -  --   -    - ---  --         -    -   -          -
---    -  -      -   -  -   - - -      -      - - - -     -    -    -         -    - - ---         -
-       -        -               --    -        -    --     -     -  --     --   - --    -   -   - -
--  -     -      -  -  -             -  -   --  -   - -   --  -    -  -     - - -     --    -- -   -
-              -       -    -  -        -     -  -         -        --    -       - --    -     -  -
-   - -    -         -     - -  - - - -     - -- ---        -      -         -               -     -
--         - -  --   --  -  -- -      -- - -         --   - -  -- -    --   -    - -            -  -
- -  -      -  -      - --         - -       -   -         -       - -       -                    --
-   --      - -    -     -  -           -    -     -    - -    -     - -      -          -  --    --
-  -  -   -   -  - -     --    -- -      -                -      -  -    -  -     -  -         -   -
-      -    -             -  --     -   -        -  -      -        -  -        -    -         --  -
-            -   - -  -- -  - - --           - -   --            -    - -         --        -    - -
-                 -        -   -   -      -         -        --   - -          - -      -  -  -    -
-      -       -      - -      -         -        -   -      -    -        -            -  -      --
- --   -        --    -  -          -    -   -    -    -      -        -   ---  -   --   -      -  -
-      -             -     -        -    -- --- -     -  -  -                -        -   ---      -
-      -     -         -- -    - ----        -        -   -  --        -          - --             -
-           -    -      -       -  -    -       -          - - --       -         -    -   -       -
--      -            -           -       -        --           - -  -          -  - -  - -     - - -
-    - - -  --  -      - -           -         -      -   -  -  -  --      -       - -     -       -
- - -   - -    -   -- - - - -- -       - --  - -  --         - --       - -     -            -    --
-   -  -- -   -  -       -   - -   ---   --  -        -  -            -    -          -    - -  -  -
-   --  -        -      -    --  -     -   - - -   -   --             - -   -    -       ---   -   -
- -     -    -   -    - ---       -   ----     -   - --   - - -  - -  -              -            --
-     -      -        - -   -   ---   -        -- - -    -    -     --    -    ---  - -- -- - ---  -
-        -    -  - - -          -               -                -   -     -  -   -   --           -
-     -    -  -    --  -             -   ---      -      -               -          --             -
-                -   ---       - - -  - -     --     --     -          - ---             -      -  -
- -     -  -         -    -        --- -  -    - -      - -     - -      -  --  -   ---            -
- -     -             -  -  -  -      -  -  --   -     - -   -  -     - -  -     -     -    -    - -
-       - --       -   - - --        -                       -     -  -     -  -             -  -  -
-     - -    --                   -   -   -           -  -  -       -  --- -- -             -      -
-    - -  -     -   --  -    -    - -   -  -         -    -  -  --  --                        ---  -
-      -   -                 -- -  -  -   -     -  -  - -         -        - --  - -  -     - -  ---
-   --     - - -     - -        -               -   ---- -  -  -- -  -        -      -  -   - -    -
-  -     -    -     -- -      - - - --      - -                        -     -   -  --    -  -   - -
-  -     -- -   -    -        -    -  - -   -         -  -   -- -       -   - -   - -  -     - -  --
-             -     --       --  -     -   - -     -  -  -   -    -      -        - -  -   -       -
- --      -  -    -                -    --               -         -- ----             -   -      --
-- -   -  --                      -  -     - -   - -  --  - -   - -  -   -     - -              -  -
-     -   -     - -    - -     -- --      -    -  - -    --  -     -- -  -   --   -     -         --
- -     -  -   -    ---          -   -                   -               - --       -          -   -
-        -      -       -     --    -         - -                - -       -- -     - --- --  --   -
-   -  --                -       -     - -     -          -         --          ----         - --- -
- -- -                   --     -      - -   --      -             -   -    -          -    -      -
--   - - --   -    -  - -   - -  -  -  --        -     -   -     -  -             -   -       -    -
-     -    --   -        -      ---  -   -   -       - -      -  -  - -- -  -- -                 - -
-     - - --     -  -          -  --  -   -   -    - - --         -   - -      ---     - -   -    --
- -  -        -     -  -    - - -  -- -  -  -  -   -  -              -    - - -    -        - -    -
--    -       -           -    -    -          -     -      --     -         -       --  - -       -
-  -- ----      --  - -       -       -   - -   - -              -            -   --     - -       -
-            -     -              -      --       ----    -    -  -          -                     -
-  -             --- -- -      -    -      -               -     -- -   -      -- --  -    -  -  ---
-             --    -- -   -         - -        - --     --                    -     -     ---     -
-  -    - -  -  --  -      ---- --     -          -   -      - -   -   ---  - -    - -  -   -    - -
-      -    -  -    -   -  -    -  ---  -        - -           -  - -              -- -    - --    -
-  -        --------   -            --        -            -                     --  - -- - -  --- -
-       -           -    --      -           -  -  -         -                      ---   - -      -
-       - -       ---         -       -      -  -     -   -   - - -  -   --   ---        -- --  -  -
-                        -     -    -        -    -  - --           -- -     -  - - -  -       -- --
-   -    --  - -    -            -     -  - -     -    -   -  -              -       --            -
- - -        -  --  -  - -       -           ----   - -                 -         --        -   -  -
- --   --   - - -   ---           -   - --  -              -   --     -        -    -    -  - -   --
---        -         -        -        -          -      -    - -           -  -          -  -     -
-                 -     --        ---            -              ---  -   --   - -    - - - -   - - -
--     -   -    -     -       -                -        -   --   - - -    --         ---      -    -
--     -      -           -    --         -  -              -      --  -   --    - - -- --       - -
-   -    --     -                - -    -         -    -   -        -- -----        -              -
-         -   -                - - -              -   -      --  --  --  -             -   -    -- -
--      -   - -  -     -    --   - -    -   - - -     -  -          -           -    ----      -  --
-  -      -        -     --      -      -                -  -    -    -     -- -      -- -       ---
-  --    -   - -                       -                   -                   -       --     -   --
-        ----       --    -  -  - -     --  -   - -             - --      -  -  -    -  -     -    -
-  -   -     - -         --           -  - ----   - -  -             -- - --   - --   -     - -    -
--  -        -        -  --  - --      -  - ---  -          -           - -         -          -   -
-                   --    -      -            - ---        -        -        -    - -   -     -    -
-     - -- -  -      - ----   --     -  - --      - -     -- -       -       -  -    -- -   -      -
-       -   - - -     -     -           -     -  -     --  -          -  -  -                    - -
----------------------------------------------------------------------------------------------------
