100
100
----------------------------------------------------------------------------------------------------
- - -  - -  -   --    ----- -   - - -- -        --  - -- ---   - --- ----- --  ---     -    ---    -
- -- ---- -- ---  -----  - - ---- -- -- --------  ---- - -  -----  - -    -- --  ------ ----   -----
- -- --  -- - - ------ --- --- - -- - - -      ----  - - --- - ---- - ----  ------  - - -  ----- - -
- -- - -- - - ----   -- -- -- -- - --- - ------------ ---  - -- -  -- - ---- -  - ---- - --   - -- -
--  - ----------  ----- - -- -- - - - --- - -       - -- --- --- -- -- - - -- --- ---- -- ---- --- -
- ---- -   -   --- - - - - - -- - --- - - -- ------- --- -- -   - -- - - - - --- -    -- - -----  --
- - --- --- ----  - - -- --- -- - - --- --  --  - - - -- - ------- ------- ---- ------ --- --- --- -
- -- - --  - -  --- - - --- -  ---- -  ----- --- -----  - -------- - - -  - -- ---    - - -  - -  --
----- - ----- --  - - -- - ----   -- --    -- - - -  ---- -     - -- -- ----  - - ----- - ----- ----
-   - -- - - - ---- -- - - - - ---  - ------ - --- ---   - -------- -- - - ---- - - ---------  -- --
---- ---- -- - - --- ---- -- - - ---- - -- - - ----  ------    -  -- - - - - ------ -   -    -- - --
-   -  --------- - --- - - - -- - -- - -  ---- --- --     ----- -- -- ----- --  - -- --- ------- ---
------- --      - -  - --- -- - - -- - ---  - - - -- ----- -  - ---- --  - -- --- - -----   - ---  -
-   -- -  ----------- --  -- -- - - --- ------- -- --   -- --- -  - -- -- --- ---- -  - ------  ----
----  ----   - -  ---- ---  -- ----- -- - - - ---- ----- --- ----- -  ---- -- --- ------   -  ---  -
- - -- ------ - --   - -- -- -- -- - ----- - - -- - - --- - -- - - ---  ---  -  -- --   --- ---- ---
-- -- - - --- ----------- - - - - ---- -  -- --- -- -- --- -- --- - ---- - ------ -  ---  --    -- -
-- -- -- --  - - --     --- ---- -- -- --- --- -- - -- -  - - -- ---   - -- -   - --- ---- -----  --
------ -- ----- -  -----  - -  -- - - --- -  - ----- - ------ -- -  ---- - - ----- -- - --- -  -----
--    --- - -  ---- - - --- --- --- - -- ---- - -- -- - -    - - --- - - - - -  - - --- -  - --  - -
- ---- ----- -- - - - - -  - - -   --- --   ----- -- --- ------- - - - ------ --- - -- ------ ---- -
-- --- - - --- - --- -------- ----- -- - ----    ----- - -  - - -- --- - -   - - -- - --  - - -  - -
- - - - ---   ---  - -  --  - - - --  - ---- ----- - - -- --- ----- - -- ------ - -- - --- -- --- --
- --- -- ----- - --- --- --- --- -- ---- -  -     --- ---- - -  - - -- --  - - -- -- --   - - -- - -
- -- -- - - - ---  - -- - --- - -  --- -- -------- - - -  - ----- - - -  -- -- -- ------------- ----
-- --- --- ---  ----- - --- - ----- - -- - --- - --- - ------ -  - - ---- --- --- -  -  - - - - -- -
- - -- -  --  -- -   - -- - --- ---- -- --- - -- -- ---  -   - ----- ---- -  -  -- -- --- - -- -  --
---- - --- --- - ------ -- -  -- -  - - -  - ----  - ---- ------ -  --  - ------- - -- --- - - -----
-   -- -  -  - - - - - - - --- - ------ ---- - - --- -- --- - -- --- --- -     -- ---- -- --- ---  -
---- - ------- --- - - -- --  - ---   - - - - - - - -  -- -- -- -  ---  ------- ---  -- - - --   ---
--- --- - --  --- - ----- - ----   ----- ---- - - - ---  -- -  ----- --- ---- - -  --- - -- - ---  -
-  --- - - --- - ---- -  --- -- ---  - -- - ------- -- -- - ---     -- --  - --- -- ----- - - -- ---
----- -- ---- - --- - --- - - - -  -- --- --     --- -- -- - -------- ----- - - ----   --- --- --- -
- -  -- - - - --   -- --- - ------- -- - -  ----- - - --- -- -    -  --   - - - -   --- - -- -- - --
- ---- --- --- ---- --   ----     ---- - --- -  - - --  -- -- ---- --- ------ - ---- -- -- -- ---- -
--    --- - -- -  --- --- -  -----   - - - - --- -- ------- --   ---- -   - --- -- - - - - - -  - --
- ---- - -- -- ---   --- - -- - - ---- -- -- - - - -  - -- ------- - ----- -  --  -- - - --- ---- --
--   ---- - ---- -----  -- -- -- ---  - ----- ---- ---- - - -    - - -- -- ---- -- - - --  - --- ---
- ---- ---- -  - - - --- - -- - --- ----    --- -- - --- --- ---- - -- - - -  -- ----- ---- -   -  -
-- - - -   - -- -- -- - -- -- --- ----  ---- -- -- --  - - - -- - --- -- -- -- ---  - - - - --------
- -- -- ----- -----  - --- --- -- -- --- - -- - - -  --- - --- - --  ---------- - ----- - - -- -- --
-----  --- - - - - --- - --  -- - -- - - - - --- -----  - --- ---  --- -- - - -- --  - - -- -- - - -
-    -- - - -- -- --- - -- -- -- - - -- --- - - - - ------  -- - -- - -  - -- - - --- -- ---  - -- -
----- - ---- - --- - --- - - - - -- ---- -- --- -- -  --  -- - -- - - ------ ---- - -- --  ---- ----
-- - --- -- --- - ---  - --- - --- -  -- - -  --- ---- --- - -- ---- -- - --- -- -- ------- -  -   -
- - -  -- - - - - -  --- -- --- - ---- - - ----  -- - - - ------ -  - -- -  - - -- -- - - - --------
- - ----- -- -------- -- -- - - - - -- - -------- -- -- - - --  ------ - ---- - - ---- -- - -  - - -
--- -- ---- -    ---- - ---- ----- - -----      - --- ---- - ----  -- - -- - ---- --  - - ----- -- -
-- -- -   - ----- -  ---   --  --- --   - ------- -- -- - -- --  --  -- - - - -  -- ----- - ---- - -
- -- ----- -    ----- - --- ---  -------- -- - - - - - - - - - --- -- -- -------- - - -- --- - - - -
-- -- -- - -----  - - - -  -  ---   --   - -- ---- --- - ----- - - -- - - -  --  - -- - - -- -- -- -
-- ---- - - -   -- -- - ------ - ---  -----  - - --- - - - - ---- -- -- -- --- ----  -- - -- - -- --
- - - --- - ----- -- -- - ------ - --- -  ---- --  -- --- -- -  --- --- -- - - - ----  -- - -- - - -
------ -- -- - - -- --- --  -  ---- -- --- - - - -- - -  - -- --- -- - - - -- --- ----- - -- -- ----
- -  --  --- - ---- -- -  -- ---   -  ----- --- - --- -----  - -- -- - - --  -   - -  --- ---  --- -
-- --  --  -- - - -- ----- --  -------  -  --- ---  -- - - --- --- - ---- --------- --  --   --  - -
-- - --- -- - -- ----   - - --- -- -  -- --  - -- -- -- -- - - -- - --- - -- -- -  - --- ---- --- --
-- --- - -- -----  - ---- - - - - ---- -- ----- - - - -- - - --- ---   ---  - - -----  - - - --  ---
- --- - - --   ----- -  - -- -- --  - --- -  -- - ------ ----   --  ----  ---- --    --- - --- -- --
- -- -- --- ---- - -- ---- - -- - ----  -- --- ---- -  --  ------ -- -- -- -  - ----- - ---  --- - -
- - - -- -- - - -- - - ------- - --  --- ---- -  - - --- -- - -  -- - - -- ---- -- - --- - --- -----
--- - - -- --- --- - -- - - - ---  --  - - - ---- ----- --- - ---- -- - - -- -- - --- - - -  -- -  -
-- -- --- --  -  -- -- - - ----  --- --- -- - - --   -- -- - --  ---- - -- - - - --  -- - ---  - ---
- -----  - ------  -- -- ---   -- ----  - ---- -- --- -- - --  -- - - - - - -- -- --- - - -- --- - -
- -    --- - --  ----- - -  ----- -  ---- -  - ---- - -- ------ - -- ------ -- - - -- - -- - - - - -
- ----- -- -- --- -- --- ---- -- - --  ------ -  - --- --- - ------ - -- --- ----- - -- - --- ---- -
-- - - - - - --- -  - - - -- - - -- ---    - ----- ----- -- -- - -- -- - - - -   - -------  - -   --
- -- - ----- - - ---- ----  ----- - - ------ - - - -  - -- -  - -- -- - - --- ---- -- --  ---- --- -
-- -- - - - - -- -- -- -- ---    ---- -    - -- -- --- --- ----- --- -- ---  - -- -  -- --  - -- ---
-- - ---- ----  -  - -- -- ------ -- - ------- -  --- -- - -- ---  ---- - ---- -- ------ ------ -- -
-- ---   -  - ------ --- - --   - - ------ -  ---- - - -- --- - ----  -- --  - - ----  --   -  -- --
- -  ------- -  -----  ----  ----- -     -- -- -  - ---- - - --- -  -----  --- ---   -- ---- --- - -
- ---  -  -- --- -   ---   -- -  - ------  -- ------ -- -- - - - --- - - -- --- - --- - -- -- - ----
-- - -----  --- ----- - ---- - ----  --  -- -- - - - - - --- - - - -- --- ---  - --- --- - ---- -- -
- ------- ---- ------ ---  - -- - ---- --- - - - - -- ---   -- - - - --  - - ---- -- -  - - -  - - -
- --     --   -- -  -- ---- -- - -  -- - - - -- -- - --- ---  - --- - ---- -- - - ------- -- --- - -
- - ------ ---  - ----- --- -- - --- ---- -- - - -- -  ---- ---- - ---- - - - -- - --    - -- --- --
---- - - - -- ----   - --  -- -- -- - -- - - - - - ----   -- -  - - -- -- - - ---- - ------ - -- - -
- - -- -- -- -- - ----- ----- --- ---- - ------- - --- ----- ---- --- - - - ---  --- - -- - - -- - -
-- - -- ---- - -- -  - -  -- - --- - - --    - - - -  -  -- -  - -- - ----- -- --  --- -- - ---- ---
- -- - -  - - --- --- ---- --- - --- --- ---- -- --------- ------ - - --  --- -----   - -- -  - - --
- -- - --- -- -  -  --------  - --  -  --   - --- -  ---  -- -   - - -  -- - -- -  ------ ----- -- -
- -- --- - ---------     -- ----  ------ ----- - - ---  -- - ----- ----- -- - - --- -- -- -   - -- -
--- --- - -  -- --  ----- --  - -- -- - - -  - ----  ---- - -- -- - --- -- -- --  -- - --- ------ --
- -- -- - ---  -- -- -  -- ---- -- - - --- ----   --- - - -- --  -- -  --- ---- --- - - - - --- -- -
-- - -- - -  -- - -- --- -- - - - ---- - - -   ---- -- -- -- - -- - --- - - -- - -- - --- -- - - - -
-- - ---- --- --- - - -- -- - - - -  -- ------- -  -- --- -- - -- --  - --- - --- - -- ---- - ------
- - -  -- ----- - - --- - ---- -- --- - --- -- - -- - -  --- - - - ---- -- - - ----- - -  - --  - --
- - ---- - - - ---- - - --  - -- -   --- - -- --- ------- -- - - --   -- - ----   - --- --- - -- - -
- -- - - - - - -- - -- ------ - ----- - - - - - -- -- - -- ------- --- ---- - ------  -- -- - - ----
---- -- --- - -- - - - -  - - - - - --- ------ --- -- - - --   -  - ---   - -- --   -- - -- --- -- -
- -- -- ----- -- - -- - --- - -- -- -- - --  --  - --- -------- ----  ------  - ---- ---- -- - - - -
-- - -- -   - -- -- - ---- - ------- --- - --- ----   -  -- -- - -- ----   ---- -   - --- ---- -- --
- - - -- ---- - ----- -- - -- -    --   - - -- - -------- --  --- -- -- ---  - ------- - --- --- - -
--- -- - --  -----  - -- - - - ----- ---- -- - --    -  --- --  - -- - - ------  - --- --   -  - ---
-  ------ ---- -- -- -  -- ---- -  - --  - ----- ---- -- - -- --- - - -- -   - -- --  - ---------  -
---  -   -    - --- ---- - -   - ----- ---- --  - ---- ---- - -- -- ---- ---- - -- -----   --  -----
-  ------------ -  -   - - ----- -    - -  -  ----   - -   --- - - -  - - -  -- -- -    ---  --    -
----------------------------------------------------------------------------------------------------
