100
100
----------------------------------------------------------------------------------------------------
- - - -   -          -    - --     --    -    - - -   - - -  - ---     - - - -       --   - - --   -
- -    --   --   -- -        - -  -- ---   - -  -  --  --   -- - -  -    -   -  --- -  ---  - --   -
- - -- - --- -- --- - - -- -   - -- --   - -   -  -       --- - - -  - - -- -  -   ---    - -    ---
-   -   -- --- -  - ---  -  - - --  - -- - - - - ----   -    - -   --  -- --  -  -     - --  --  ---
-   ---- - -  ------ -  -  -- -   - - -  -  -         --   - -  - -     --         --- - -- -  -   -
- -  -- -   --- -         -- --- ---   -- -  -  -- - --- -  - - -   - - ---  -  ---  - -  -  --- ---
-  -- -    ---  -  --    -    -   - --  -   ----- ---  --      -    --   ---       ---- -   - - -  -
- -- - --- -  --- -  -      --- -- - --- - -   ---  --      -     --  -- -- -  ---- - --  - - - ----
-- --- --   --   -  - --- - -  - - --       -- -   -    ---   ---     --      -    -  - --  --  - --
--       -------  --     - - --    -  --- --- - ---- --  - ---    --         - ----  ---  -   --   -
--   - -        ---  -  -- -   -  - - -   - ---     -  --- - -      -- - ----  --  --     -----    -
-  -   - ----     - - - -  -   -   --  -  --     --- -- -- --     ---   --  - -  -- ---   -  - - - -
-   - - - -     -  -   - - --   ---  --- -  ---   - --- --   ---- -  ---  -- ------   - -- -- --- --
-- - -- --    - --   -- - --    -  -   --  - -- -          -    -- --  - - --   -   - -     ----   -
-    ---  - ---        - - - --  - -  - -- --  - -- --  -- - --- - -  --  -- --- -- - - ----  --- --
--  -   -           ----- -     -   ---      - - - -     -- -- --- --   -  -   - --       - -  - - -
- -- - - - - --- -     - - -  - ----   -  --   -  -- - --  - -- - - -   -  - - -    - -    -   - - -
-- --  -    - -  - --   --  --   -- -  --- - --  -  - - --    - - -- -   --   ------  ----- -  -   -
- -       -    -- -   --  -  ---- -   -     - --- - --  - -- -  -  -   - --  -       - - -   -   - -
-  -  ----        -- -        -       - - ----    --  -  --- - - -     - - - - -  -  -- -  --  - ---
---   -   - --  --    - -  --  -   - -  -- --  ----    -   -  -- -  -   - -   - --  - -     - -- - -
-  -- -   - - - -   - - --- - -  - -  --  -- -    -    - -  --- -    -   -  - -   -- -  - --- - -  -
- ---- - - - -- -- - -  -   --    --- - --    - --- ---- -- - - ---  - -- --      - ----- - - - -- -
--  - ---   -- -- ---   - -  -- - -  -  --- - -  -     - - - - -      -     -   ---- -      - - - --
- --  - --  - -  -  - -   ---- -   -- - -  -- -   -  - --- - - --- -  -- - -   -   -  ---  -- -  - -
-  --- - - -    - --- -----   --    - ----- -     - - -- --- --  -  -   - - -- - -  - - -   - --  --
-- -   --   -   -  - - -    -     -- -       - -  -  - --    - -   - - -  -- -- - - - -     - -  - -
- - -- - -- -     -      -  -- --  -  - -- --   --   --   -      --  -  -   --  - - - - - -- - - - -
-  --   - - -   - - - - --   -   -  -      - --  -  --- -   -  -  - ----    - -- - -    -- - - - ---
--   -  -   -    -  --    -- -  - --   -- -- -       -   - - - --   -   - -   - -  -- -  - -- - -  -
-  -- - - - -        --  --  -  --  --   -   ---- ---  --  -- -   -    -   --- -   - --- - -    ----
- -    --       ---- - -  - - ----     --  -  --   --   - -- - ---- -------   ----     - -  -  - - -
-- ---  -     --    - -- -     -    -  - -- -   ---- - -- -  --   -   ---  --  -   - -- -    - -- --
-    - ---   -   -- --    -  --   -  -  -   -  - - - - - -- -  --  -     -    -- -  ----   ----  ---
-   -- - -    --   - - - ---- - - ---   -  ---  - -----    ------  --- -- - -   -- - - -   --  --- -
-- - --   - -    - - -   - -- -- -- ------  --    -- - -- --      -  --  --  - --  - - -   - - --  -
-- - -  --   --  ---  - -  - -      -  -   - ---- -- -   -   - -       -- -  -    -  -   - - - -  --
- -- - - -- - -  -           - -   - -- ---     -- -  - - --- -    -- - -- - - -- -   --     --  ---
-     --  - -  -- -- -  - --        - - -- --- -  - -   -   --  --   --  --  -   --  ---  - -    - -
-  -- -  - -- -- -     --- ----  - - --    --   --  --  -  -- -  - -- -- ---- - -   -      -  -- - -
- -  -   - -- ---- --  -  --   - --- - ---   -   -     -- -  -- - - ---    ----  -  ---  --     -- -
- -- - - - - -  - - -  ---   ---- -    -- - - --- - -- -   -  - -  -  - --    ---   -   -  -   --- -
- --- --   - ---- -- -    --     -- --- ---  -  -- --  -  -- -      - - -- ---   - -  -  -- -     --
--   - -   -- ---   -    -  --- -     -      - - --         -  ---- -  -    - ----   -    -   -- - -
-  -    - - -   --  ---  -  -- -- -  --  ---- ---  - -     --- --     - -  --- - -- - ---  --- -  --
-    -- - - --- -  --   - - - ---  --- --  -     -   - -- - - - - - --- --- ---     --    - - - -  -
-- -  -- - -     -- -- -  - - -   -   - -      -----  --  -- -- - -  -- --- -- --  -   - -  -  --- -
-   -    ---- --- - - -- - --   - -- -- -   -   --   -  ---   -  -    -- - - -   -   --  - --- --  -
------      -   -  - -- ----- - - -    -- - ---    - -   - --   -  - -- -- - -- -     -  - -    - --
- -   - -  - -  --- - --     - - - ----  --- -  -- - - -- -  ---       - ---    -- --- - - --  - - -
-  - -  - -  ---- --     - - --- --   --  -- -   - -  - --    -  -- - --  -   -       -- ---  -- ---
--     --   -   - -   ---  -        --  ---- -----    -- - -- - - --- ----  -  ---  --  - - -  - - -
-  - --  - ----   - --   - --- - -  - --     - -    --      - --     -- -  - -     ---     --- -- --
--- -  --   --- -  -   --    -   -- --   ---  - -   - -     -- -   -- -     - - ---      --     -- -
-  - -  --      - -  -  - ---   --  ----- - - -   - - ------- - --  --- - - - --     --   --  - -- -
- -  --    ---- -  -- - --- - -    - --   - -   -       -  - -- -  -   -- --     - -- - -        ---
- - -- --  -  -  - - -    -- --  - --  -   - - - -    - --- -- - - - --- -  -  --- - -  -   -----  -
-    -    - ----- ---  ---  --   -- -- -- -   - -  -    -  ---  -  ---   ---     -  -    -- -  -  --
-   - - - -- -  --   --  - -  -- -        ---  ---- ---  - -  -- - -  - --   - -- --   - -   --    -
- -     -   - --- ---   - -    - - --   - - --   -- - -- - --  -    ----    -- --    -- -  - - - - -
-    --    --  --  --  - - -  - -  -  -  - -    --  -   - --   -- - - - --- -- -   -- -  --   ---- -
-  -   -   --      - --  - ----  - --- ---  --   -- -- -       -  - --  - ---- -     - -- - -- - - -
- - --- -  - - -----     --  -   --  -     -   ---  - -  ---- -  --- - - -   -- --- -    -    - -  -
-  - --  -- - -   - -   --- -   -  -    -------   --   - --   - -- -- -- ---  - -   - -- ----  - - -
----- --  - -  - - ---        -   -    -  -    -- - ---   -- - --    -   ---    - -  -  --     -- --
-- -  ---  -  - --   -     ---    - -      - -  --  - --    -  -- - --      -- -    - -   ------ - -
-     -  -  -  -  - -  - --- - -   --- - -  - -   -  - - -- -- - -  --  ----  - ---    --   -   -- -
-  --       --- -- - -     -- -- -   -  -  --    ---- -- ---  --  -   - -   - -    - - -    - -    -
- - - -  -- -  -       -- - - -  --- -  -     -  -   -- -    - --- -   -- -    -    --  - ----     -
-- - - -   ---- --  -- -   - -- - - -- - - --     --    ----    -    - -  -   -  -      --- ---- - -
--        - -  -   -  -  - --   -- -- -     - ---   -- -   -  -  -- - - - - --  -   --  -   --  -  -
--  -- -    ---  ---- -   - -  - -  - - - --- - - -- -   - - --- -- - --  -   - ---   ---  - - - - -
- - - --- -- ---  --    - -      --   - - --  -  --      - - -        - -  --      -  -  ---    - --
-- -      - - - --  -- -     -   - -  --- ---   -- --    - -  --  ---- --      --  - - --  - --   --
-  - - -- -  - - ---   -- ---   --  - -  -    --    - -- --  -  --    - - -  --  ------ --- -  - ---
-  -- - - -- - -  ----- -  - -  - - -  - - --   -- - - - - -  - -  - - -    -  ----    - - - -    --
-- - ---  - -- - -    -  -- -  ---   -- - - - -    --- -  --  - - ---   --  -        --  ---   -- --
--    -  - - -  - --  -  -  -  -   -  -   ---   -- -   -   -- -       --- -    -  ---  -- - ---- ---
-   - - - -- --   - ---  - - -   -  --  --  - -  - ---  --   -     ---  -  ---  --   -  -- -   --  -
- - -  - -- - -   - -  - -  --      -- --   - --  --    - -  -     - ---  -   --    - -- -   -- ----
- - -    ---  -- - --   -          - - ------     - -   --   --     -      ---   --  -  -- -       -
-   --- -    - -   - -   -  -  -   - -       ---- -   - -- -- -  --   -       -- - - - -  -      ---
-- - -  - ---- -- - -  --  - - --   -- --- -    - ---- - -- - --  - --- -   - ---  - -- --  ---- - -
- --   --     --- - - - - -     - --      ------ - -- ----- -- -   -  -   - --   -  -     -      - -
-- --    -- - - -    -- -- --  -   -  --   - -  ---  -    - -- ---   - -  -  --- - - - --  - --- - -
-- -  - --   -        - -        -    -- --    - -  -- -   - - - -   -   -  -  -  --   -- - -  --- -
- -    - -  - -  --- --   ---- -  - --   -- ---   - - -  - - ---  -  -  - -  -- -   ---  -  --  -  -
--    -   - - --    --- ---  -    -  -     - - --  -  - -- --   -     -  -  - --- - -     -   -   --
- - -   - -  -  --        - -  -- - -  ---  - -  -  -- - - - --- -  -----    -  ---  - -    -   ----
- - --- --  ---  --- -  -- - -    ------ -   -    - -  - ---      - -     ---   -   --   --     - --
-  -   -   --  ---  --  -- --  -        -- -  --    -- -    - --- -- - - - -   - -  - - - ---- - - -
- -  --  -- ---  - - - - - - -- - ------  - -  ---- -   ------   - -   - - -   - -        -  -  -- -
-         ---  -- - -  -   --   --  -   -- -    -     - -  --      -- - - -   --   - - --  - - - - -
-     -   -  -- ---   -- - - ---  -- -- -- ----- ---- ----   -      - - - --     -  --    -     -  -
- - - - - --  -  - -- -- -      -   - -   -    --   -    - --- --- - -    - ---- -      -- -  - ----
- -        -- -  - - - - -    -- -- - - - -----  -   ---  -- ----  --- - ---  - -  -  ---- - -  - --
-   ---   -  -- --   -   - -   - -- - - - ----  -   - - - -- --    - -  -  - - -- - - -   --- ---  -
-     - -  -    -  - -   --   -   -     - ----- -  - - -  - -  --   -     -   -       -----  -   - -
----------------------------------------------------------------------------------------------------
