100
100
----------------------------------------------------------------------------------------------------
-     -    --    --         -    - - -             - -                      - -         -        - -
- -  -      -   - --    -  -             -  --       -     -    - ---  -    -       -     -  -  -  -
-     -         ---              -   -         ---           -    - -  - -   -  -- -   -           -
-- -   -      -                -   - -- --    -   --      -- -  -       - -    --     -       --   -
-       -      --  -- -  -             -   -      -  -     - -                   ----   -     -    -
- -         -         --    -                   -            --                -               - - -
- -            -    -    ---                  -       --       -          -  -    - -  -   ---  -  -
-     - -    - -        -   -  - -                -                      --  --   -    ---    -  - -
-  -   -  -   - - -      - -       -           -     -   -   -          -  -                   -   -
-   -  -  -             -         -   - -   -        - -      -  -   -  -               -  -       -
-           -    -  -  -- --  - -    - --   ---      -                    -     -             - -  -
--       -- - -    - -     - - - -                -       - -    - -    - - -     -- -  - -   -    -
-  -   -  -       -      -   -    -   -  -  -            -                  -          - -     --- -
-    -     -        -   -     -  - - - -  -  -  -   - -                 - -      -    - -          -
-     --     -     -    - -   -  -          - -                   ---         - --  -  -  -      - -
-   -      -          -               -    --               -        - - -  - -     -   -          -
-           -  -   -   ---     -- -         -- -       -    -       -    -                         -
-                  -     - --          -   -       -  - -   - - -     -         -    -   -   --  - -
-  -    -  --        -   --  -    - - -  -  - - -        - -  -      -    --     --  -         -   -
-    -- -  -      - -                          -   -    -   -      -           -   -   -           -
- -                  -           - -          -             - -     -- --            -   -    -    -
-  -        -  - - -                  - - -   --- -               -             -            -  -- -
-            - -   ---  -  -     -   - -  -       --  --       -- - -    - -  -- --           -    -
-   --    - -                -     -    -       -     -     -      ---       -- -     -  - -- - - --
- -  -                   --          - --    -     - --      -            -   --   -          --   -
-      -  --  -    --               -  -      -   - --      - -- -  -      - -      - --   -       -
- -   -      -  -      ---  -     -   -  -    -- -    --  -    --         - -        -             -
-   -   -          --            -         -            -   -  --     -  - --  -          - -      -
-  -  -     --                  -     -     --       - -      --      -      -  ---    -    -      -
-- - - -           --   -  -    -   - --        - -  - -      --- -     - -         --  -   - ---  -
--   - -         -   -  -   -  -- -  -         --  - -  - -             --      -           - -    -
-    -     ---      --      -  -   - --  -         -         -          -     --              -    -
--           -             -   --- -       --           - --   --         -  -          -        - -
-  -                 -  -     -         -- -  -   -     -     -    -     -      - - - -    -   -- --
- -    -        -   -  -    -                 --        -    - - -      -         -   -   -     -- -
-              -     -    -  --       -          -   --   -      -                            -    -
---   -   - -           -   -    -   -  -       - -     - -- --       -       --        -   - ---- -
-   -        -       -    -       - -- - - --   -           -     -   - -  -                       -
-          - -             ----- -   -        -  -   -  -   --     -          -                  - -
-  - - -                -          - -       -           - -  --  -   -   - -     -              - -
-   -   -  - -  --   -     ---    -         -  - --    - - --      - -        -   -          - -   -
-- -            -   ---   -    -     -   -    -         -     --    --   -      -   -  -      -    -
-  - -  -  -    - -    -            - --  -    -    -  --       -        -     --     --  - ---  - -
-    -    -              -            - - --  -    - -   -     -   - -    -  -   -- -          -   -
-    -      -    -   -          --     -   -           -     - -         -       -      -    -  - --
- -    -   --- -          ----           -                   -   - -   -          - - -            -
-    -   -           -       -   -       - -  -       - - -                             -  -  -    -
-               -     -    -   -          -    -  -  -- -              - ---   --       -     -- - -
-  -- -     -    -   --   -         --   -    - -           -- --       -      -  -     -          -
-- -- ---   --  - - -    -  -- -        -   -   --    - --        --       --    -      -          -
-- -   -        -           -     -       -    -  -  -     -     - -  -     -  - - -         --    -
- -   -    -        -               - -  -   -        -- -              -  --    -   -  -    -     -
-       -       -        - -                --            - -       -  -  -               -   --   -
-  -       -----               -- -            -      -      ---        -        -   --       -    -
- --     -   -- -  - -   - -       - - -         -- -- -  - -   --    -   ---  -                   -
- -       --- -             -     -  --     -    -  -   -        - -  - -       - -   - -  - --  - -
--                - --  --  -           --  -       ---- -         -          -  -       ----  -   -
-  - -  -                 --  -   -  -   -   -   -       --    -     -   --      - -  - -    -- -  -
- -  -                -          -           -    -   -       -   --            --- -     -    -   -
- -  --    -  --      - --       - -            -       -                - -     -               - -
-  ---  -          -     - -         -     - -    -       - - - - -       --                       -
-    --   -  -     -       --          -   - -    - -   -  -     -   -      -          -----  -    -
---  -  -  -     - - -                -    -      -      -  -   - --   -    - -                 -  -
-     - -   -  -              -  -    --    - -  - -        -  -      - ---   - - -   -          - -
--   -    - -        -  -    -            -   -  -  -   --   - - --    - --           -   -   --   -
--    -  -    - -        - -- --  -- -           -   -   -- -  -       --   ----   --     --   - - -
--  -  -    -     -  -      -   -     -     - -- -      -     -    - -    -      -       -- -    - -
-- - -        -    -   -     --   --        - ---   -       -- - - -     -   --  -  -       -     --
--- -   -  -   -- -- -     - -            - -    --       -     -           - --    -  -  -        -
-  -  -        --       ---      - -      - -    -     ---   -   - - -    -       - - -    -       -
-           -     -  -       -           -  -   -   - -        -       -      -       ---       -  -
- - -    -         -     -        --   -       - -  -  -     -- --   -  - - ---               -    -
-- - - - --            --          -  -   - -     --      -    -   -  --    -  -  -      --    -  --
-      -        -  --          -       --        -  --      -       -  -            -     - - -    -
- -   -      -    - -          -         -      --- -      -  -     -      -  --            - -    -
-     --     - --           --     -  -  -   - -          -     -      --     -  -    -    -    -- -
---      --    -  - - - -   -    -  -      - -- -             -- - -  -  -      - --     -   - -   -
-        -      -    - -- -      ----   -  -   -      --   -  -                     -   -        - -
-        - -       --          -       -  -       -       -                    -       -  -        -
-     -         --  -      --    --  -     --- --    --  -    -  --  -   - -    -      -           -
--- - - -  -    -     -       -      --       - - -  - -             - -       -     - - -        --
-  - -    - -    --    -   - - -   -   - -   -  --      -  - --  -  - -  -   ---      --  -       --
---  -          - ---     -     -   -  --                            -        -   -             -  -
- -       -        --- -    -   -             -  -           -  ----- - -     --     -       -     -
-   - -  --                                              -        - -      -   -                 - -
--   ---      -  ---- -        -  - --  -    -          -          -       -         -  - -  -     -
-    ---- -           -           -- -     - -   -  -     -                 - -- -    -     -      -
-              -               -           -                       -      - --         -   -  -  ---
-                -               -     -  --        -   -                    -  -                  -
-            -    -  -     -  - -   - -   -    -  -           -  ----- -  -  - -       -        -  -
-     -  -         -  - -  -    -    -  -                 - -         -  - - -  --     - - -       -
--          --   -        -    -  - - ---        --       -    -      - -  -                -      -
-       -        -  -   --   --    -    -- --   -    - - -    -  - - -   -   -     - --   --       -
-  - -  -   ---     --   -     - -   -           -    -         - -               - -    -     -   -
-- -      - -          -   --  --  -    -   -    -   -      -   - -  - -       - -     --          -
- -   -      - -    - ---    - -        -       -      - -- - ----  --  -   - -        - -   -     -
--  -  --- --  -- -          -        --   - -   -      - -        - -           --      - - -     -
-  -    -     - - --  --          - -   -     -        -            -   -    ---     -    -     -- -
----------------------------------------------------------------------------------------------------
