100
100
----------------------------------------------------------------------------------------------------
-    - - - -              -  -       - -    -              -           - -                   -  -  -
-   -     - -    -          - -         -  -- --      -- -   -         -    --  -      -  -        -
-     -         -           -          -  -  -        - -    -  -  -     - -     -      -          -
- -            -      -   - --   -              -      -   -   -            -        -     -       -
-      -   - -      -    -  -           -    -         -         --      -  - -  - -    --         -
-        -   -      -          -    -  -    -   -   -    -     -  -     --      -- -   -           -
-      -  -          -   --   -    -       -- - -  - --                     -                    - -
-   -       -  - -    - -          -    -   - - -   -- -        -         -        -        --  -  -
-      -    -   -    -       --  -                            -   -    - -   -- -   -         -   --
- -       -   -      -- -             -      - -     -  -       -      -    -  -   -        --     -
-      -   -           -            -    -           - --                - - -   -    - - -        -
- -    -                           -  ---         -    -  -        - -   -       -   -  -          -
-         -    - - -         -   -  -      --    -      -         -   -          -    -            -
-        -  -     --      -    -   --         -    - --  -         -   -     -    -   -        -   -
--      -      - - -   -              --  -         -           -   - -   - - -      -    - - -   --
--      -     --   -   -   - - -              ---      -  -      -   - -                       --  -
-  ----   -  --  --     -   -        - -              -         -  -          -             -    - -
-         -        -    -     --    - -  -    -     - --   -  -   - - -  - -      -  -             -
-           - -     -     -  -    -     -   - -      -       -  -           -        - --     -    -
-  -   -           -      -    - -  -     -            ---       -     -    --   -             - - -
-  -    -          -         -              - -       -            -    -  -       -               -
-     -    -  -     -     -  - -    - - --  -        -  -      -  -        -     - -      -       --
-  -    -     -       -      -  -- -  -     -              ---   -    - - -     -                 --
-   -    -  -    --      -      -  -    -    -                     -     - -  -  -           -  -  -
-                    --  -                -   - --  -                  -     -                 -   -
-  -   -         --- - -        --    -           -               - - - -       -       -    -    --
-             - -          -           -   -  -   --     -           -    -        - -   - -  -    -
-   -     - -  -  -               -   -    ---  - - -         -          -     ---      - -    -   -
-     -   -   -     -           -     -       -            -           -    -     -         ----   -
-    -  -   -  -  -                     --              -   -              -       -  -      - --  -
- -                                - -             -  -   -              -        --     -  -      -
--   -       -  -  -     -          -         - -    ---   -          -    ---  -      -  - -  -   -
-   -  -        -               - ---    -      -                      - --    -  -  - -     -  -  -
-    -  -  -  -             ---      -       -           - -   - -   - ---  -       -      - --    -
--- -  --             -    - - - -  -  -  -  -    -        -    -             -- - - -             -
-      -    -     -  - --                 -   -     -   -   -   -          -    - -    -      -- - -
-     --        ---       - -  - -    -       -     --  -          -     --     -     - -  -       -
-           -  -      -      -                 -                -   - -         -  -           -   -
-     -                -- -         -                    --       --         -        -      --    -
-     -      -       -    ---     - -  -  - --        -             - - -      -   -      -     - --
-         -        - -     -   -     -        -    -       -  - --   -          -               -- -
- -   --             -             -      - --                   --  -   - -     - -     - --      -
- -       -- -               --      -      - - -   -      -     -                -  --       -  - -
-   -       -           -  -                    -  --         -              -  --  --- -      -   -
-    -    -    -                 -   -  -  -      -   -              -  -   -   --  -   - --  -- - -
-     -          -   --     -    - -    - -    -  --                -    -         -               -
--       -  --    -      --            -        - -   --             -   -     -    --    -   -  ---
-     -  --              -      -       --        - -   -        -   -        -  -        -   -    -
--       --       -       -               - - -  -    -   -        -           -  -     -  -    -- -
-                --                  -             -        - -    -     --        - -  - -  -     -
-          - -               -  -       -  -  -     -    - -   ---           -            -  -   - -
-  -   - -             -         --      -  -        -              --     -                  --   -
-   -      -  - -    -      -       -       - -        -   -    -             -    -               -
- -     ---      -  -                 -    - -        - --  --              -          ---   -   - -
-         -    -   -- -             -            -         -    -  -   - -         -  -  - -       -
-            -  - --      -  -  -    -        -   - --   -- -  ---   -       -     -   -     -     -
-   -   -        - -       -  -   -    ---          - - -     - - -            -      -     -  - ---
-         -         -          --         --   -  - -     -        ---                      - -    -
-  --    -         -  -   ---       ---                   -   -   -             -             -   --
-            -- -  -    -            -  -              -      -    -                 -- - -     - --
-                  - -                          -   -    -             --  --    -   -    - - -    -
- -  -     -   -         -        -     --      -               --  -    -               -- -      -
- - -    -        -       -     -  ---  - -         -     ---    - --       - - - -   -      --    -
-         -           --  -        -                   - -        - -     -                        -
- -  -          -- -     -   - --         - -   -            -            -                  -  -  -
-        -- --       -  --           - -  -  --  --- -   - -    -      - -                      -  -
-  -     -    -       -       -        - -             -    -        --      -- -  -               -
--     - -   -  --            -     -   -   -     --    -              - -  -     -  -  -- - -     -
-     -             -    -   --    - -  -   -  - -       - -                       - -   --        -
--                    - -           - -          -    --      -         -  -       -     -       - -
- -   -  -  -- -- -  -                             -     -  -       - -  - -    -- -       -       -
-         -    -      -        - -  -   -      -    - - -            --  -    -   -    -        -  -
-   -         -      - -      -  -    -   -      -        - - -              -                     -
-       -           -      - - -  - -  -                  -       --          -     --    -   -    -
-- -     -   -         -  -  -              -  -       ---  --     -    -  -  -  -    -            -
-   - -     -   -   -           -  -  -    ---   -   -- -       -      -   - - -     -      -    - -
-  -    -                                    -        -   -        -      -      -       -  -      -
-       -               -     --         -   -   -      -  -    -      -        -              -   -
- -     -    -     -   - --                -     -   -   -       -    -        -       -       - - -
-- - --     -   - -   -   --   - -   - -           -       -  - -                    -  - -       --
-               -  -  -- -            -             - -          -  -  -  -               -  -  -  -
-  -         -   -    -               -   - -               -     -        -   -  -   -  -         -
-     --   -                -   -          -          - -    -    -  --  -      -      -      -    -
-    -    -  - -     -    -    - -    -  -             -  -        -- -   -         -    -         -
-   - -         -    -                       -       -    - - -  -   -- -         -                -
-           -  --        -    -      -   --    -      -          -    -      -   -    -  -   - -   -
-   -     -    --  -                   -        -      --  -                    - -       -        -
--               -      -       -   -       - -      - -            -   - - - --- -    -     -     -
-      -         -     -          -  - -  -   - -                       -  -    --  -  -           -
-    -          - -   ---    -     - -  -    - - -      -          -               -- -    --      -
-           -   -                -          -   -     -     -      -      -           -        -   -
-   -    -    -    -   -  --  -                -     -    -   -     -                  -       -   -
-    -     --          - -      -       --       -      ---       --- -   -          -  -    -     -
--               - -    -  - -        - -            -  --      --   -    -       -     -        - -
-   -               -  --                   -   -          --   -  - -       -     -      -   --  --
-  - -       -       -     - -    - -    -        - --   -      -           --  -                  -
-     - -       -  -     -  -      -    ---         -          -              -      -   -        --
- -         -       --    -      --      --  -  -       -  -  - -  -     -           -      - -    -
----------------------------------------------------------------------------------------------------