100
100
----------------------------------------------------------------------------------------------------
-                           -   -            - - -           -  -     -   -         - --         - -
- -          -       - --  -  -  -                  -             --          -   -       -  -     -
-  -                      - -  - -                    -      - - -   - -         -        -    -- --
-        --     -                   - - -- -             - -   -   -   ---    -  -      -   ---    -
- -  -             -      - -              - -- -    -- - -       -        ---      - -          ---
-   --   -   --  -    - - -    --        -          - -         -     -       - --- -     -    -   -
-      -       - -   -     -  -  -     -          -            -       --      -                  --
-             -  -   - - - -  - --    -   -  --      -- -                -      -    -       -     -
-         - --     -       -            -       -    --            -               -    --    -  - -
-              --    --- -- - ---     - -      -  -   - -    ---     -  -  -  -   - - -          - -
-    -   --    -  -          -           --      -- - -            -         - -      -    - -   - -
-   -    - --    -   -  --          - -        -        -  -  --            --  - --          --   -
-  -   -      -    - - -  - -      -       -  -     --    -      - -         -         -  -  - -   -
-   --  --  -   -  -    -           -      - -            -           -   - -  --      -    - -  - -
-  - -    -    --  -   -       -    -             - - -  -  -         -            -      - -    - -
--         -           -    - --           -   - -  -      -        -   -                      -   -
-     -             -  -     -       --   -   -    -   -  -  -   -    -  -  -      -        -      -
--  - -            -     --         - --     - ---       - --     -- -   -  -    - -   -           -
--   -             -        --    - -     -      - - -     -    -   -      -        -       - -    -
-  - -  -- -   -   -   -         - -       -       - --     -   -     - -   -- -    -     - - ---  -
-       -      -       -   -   -     -       -  -       -  - - --  -    -   -     -   -   - --     -
- -    -            -- -  -     - -             -   -   -   - -              -  -   --  --        --
- -  --  -          -            -- -       -- -           -       -      --     -- -      -       -
-  - -     -          -  -     -     -        -  -        -  --  -  -  --  -  -         --   -     -
-  -  - -                            -        -    -       -    -    -     -            -  -  -  - -
- -  - -      -   - -  -     - -  - ---  -   - -         --         - -   -  -   -      -  -       -
- -                  -  -  -      -     -   -         -   -  - - - - -         -   -       - -   - -
- -   -     -     - -   -   -             -     -           -          -               -  - -   -  -
-   -    -          -        -  - -    - - -    -         - -- --   --   -    -     -  -     - -   -
-      -   - -    -          - -   -   -      -   -    -- -       -  ---           - -  -  --      -
- - -   -     --   -  --           -    - -     - -      - ---      -  -  -           -          - -
-        -  - - -  --    --- -      -         -- - ---  -          -            -      -   -   -- --
--       - --   -            -     --    -  - -          - -  --         --  - --          -      --
-  - -   --   -           --   --         -     --          -     -- -               --          - -
-        - -  --    - -  -        -       -        -       - -    -            -    -         --   -
---  -  -  -   - -     -   - -   -    -     - -   -   - -   -  - -       -   -          - -      - -
--    -       -             -    -   -   - --- -          -    -    -    -      -  -               -
-   --    -        - -        -- -   -               --    -   -  ---   -   - -     -          -   -
- -      - -  -  -     - ---     -    --        - -    -        -  -      -          -   -  -   -  -
-    -    --          -   -      -  - -    -    -- --   -     --- -     -  -       --     -        -
-    -        -    -                     -   -      -            -     -   - -   -   -         --  -
-   - --   -   - -   -   - - -      - --    -   ---              -           -  -                - -
-     --   -  -  -  -  -         - ----  -   - -   --    ---      -  --      -        -   - ------ -
-  -     - -    -     -----   -    --     -   -      - -       -            -          -- -  - - - -
-     -     -      - -     -       -       -   -     -    -      -    -   - ---      -  -    -     -
-   -     -  -         - -       -  -  - --     -           -          -  -        -  - -   -      -
-                 -              -   -- -         -   -     -    -                        -        -
-   -            - -    - -    -  -                       --  -          -          -     -  -     -
-         - - -     - -            --   -   - -   -     -          --    -  -   -        -  -      -
-     - -      -    --    -      --     -  -              -         -      -  --    - --      -   --
-        -          -      -   -    -    -    --  ---              -    --  -         - -   -      -
--  -     -      -              -   -      - --- -    - -   -  -   -  - --- - -- -  - - -     -- - -
-  -- --    -   - -        -  --       - --        -       -   -          -  -            --       -
-         -       -         -          - -   -  -  -     -        ---     -          - -     --- ---
-  -  --      -          -    -  -  -      - -      -    -  -               -     -                -
-  -                  -  --  --        -   --  -  -    -          - -- -                -          -
--      -                        - --       ---    - -         -              --  --   -     -     -
--  - -   -  -        -   -  -   -       -                -        -     --   -   -    -  - -      -
-- -        --              -     -   - - -              - - -       -         -     -    --- --   -
- -   -   -   -        ---     -  -         -   --       -  -            -   --       -  -  -  - - -
-             -      -    - -   -     -      -           -             -  ---          - - -   -   -
-  - -     -          --            - -     -    -         -    -           --    --  -     -  --  -
-  -    -      --          -              -     -            -              -      --        --- - -
- --         -   -  -   - -  -     -                  --   ---         -     -               - -   -
-       -        -  -     - -  - - -           ----   -      -   -   - -  -           -   -    -   -
-    -      -      -    -     -     --  -          -    -          -        -   -     -     - -  - -
--      -- - -       -       -- - -    --           -- -        -       ---   --    -   -      -   -
- -      -       -             -  --  -- -      -   -              -          -  --    -      -    -
-      - --    - -       -  -- -- - -    - --   --   -         --- -           - - -  -            -
-  -        -         -       -     - -  --     -     -      -  -    -- - --      -- --   -        -
-  --             --          - -     ---   - -  -  -   --          -     -     -              -   -
- -  - -          -   -              -      - -  --     -  -    -   - -    -          -- --        -
-  -  - - -     - -                  -                   -    --      -        -    -   -   -      -
-- -    ---   - - -   - -    --   -      - -  - -   -    -  -      - -  -   --   -   -   -  -  -   -
-   -   -  -  -  -   -    - --     -             -        - - -    -       --  - -      -     --- --
-                 -            -            -  -       --      -  -   -            -    -- -       -
-  - - -        -   -   - - -                  -  -      - -  --           - - -       -- -        -
-         -       -       -   -      - --  -        -   - -        --      -                   -   -
--  -      -- -        -  - -   --   - -                -        - -    -                -   --  - -
---     -      -   - -     - - -   -      - - -  -     -  -  -   -   ---     -   -    - - - -      -
-  --   -       -         --     -           - -   -       -    ---         - -        -- -     -  -
-    -    -     - -           -      -  -           --     - --       ---  -               -       -
--     -  -                 -   -       -       --    -     -    -                      -- -  --   -
-  -- -  --              -    - -- -                                 --       -          -   -     -
-    - --   -        - -        -     -  - -    -  --  --  -         ---   -                 -   - -
-       - --     -  -  -  - ---  -- -     - -      -  -          --    -- -    -   - -      -   -  -
--    -  -      -    --          -  -- -     -       -     -                -    --         -   - --
- -   -  -           ---   - -- - -        - -     -             -    --      -    --- -   - - -- --
-   - -   -- -             -   -                     --         -- --     -                   -    -
- -    --    -   - ---  -   -    --   - -----     --    --   -    -         - -- -  --   --- -     -
-       - -         --         -    --   - -         -         - -   -     -  - - -   --    ---   --
- -  --  -       -                               -  -  - --  --     -  - -       - -   - -   - -   -
--   -    -      -   - --    -   - -       -       -   --         -- -   -  - ---   -              -
-     -     - -  - -  -     -    - ----  -   --    --      -  -    - ---  -      -        -   -- ---
- -    -      -  -  - -       - - -  --  - -    - -   ---   -           - -      --      - - -     -
-  - -  - -  -     -     - -               - - -    -  -  - -         -  -    --   - -    -- - --  -
-- -- -  -           -    -   - -  -  -   -  -  -  -   -   -     --        -    -      ---     - - -
-                   -  -               -   -                    -   --   -   -   -  --      -      -
----------------------------------------------------------------------------------------------------
