100
100
----------------------------------------------------------------------------------------------------
-  -   -- -  -   -  ---- -    - ---  -   -   -  -      --    -  -       -     --  -  -  - -        -
- -  --    - -      -  -  - -  -    - -   - - -- ---    - - ---- - --- -- -  -  -----   -  - - - - -
-  ---    --  -  ----    -    ---- --- - -    - -- - - - -      -  - -      -- -      -   - -    - -
-           -  --     - -   - -     -- - ------ - -        --- ---     --- -   -- -- - --   --- -- -
- -  --- --- -- - --  -- - -- - -    -  --  - -  --- - -- -- -- -  --- -- - --      -- - - - - -   -
-  -- - --  - -- --- - -    - - - ---  --  --  -  -  -- -- - - -- - -- -- - -- ---- ---- -  -    - -
-- ---     -  ---- - -- ---- - -- - -  -    - - --- -  - -    -  -     - --     -     -- --- -   - -
-- -  ---- -   -  -- -       - - -   -   -   - -   -   -- -   -------  - - -- -  - - --    -  -    -
- --   - - - -- ------ - --   --     --   -- -  - ---  - ----     -  -    -            ----  --- - -
-- - -  ---        -   -  -  - -  -- -   --  -  -     -- --   -    -    - - -- - - -  - -  --   ----
- -  - ---  -  -- - -- --- -   ------  -- - -  - - -- --  - -   -- - - - -  -- ------      - -- -- -
- --   --        --   ----  -- -   - -- -  -  - -       -  -  -- - - -  -  -- --    - - -  --   - --
-  - - -- -- - -  -  -  - -     - - -    - -  - -- -- --       -    - - --   -- -- - - -- - -    - -
--  --- - - - --   -   -  --   -  -    - -  --- - --     ------ -  - -- - - -  --- - --      -    --
-  -  - - - -- ----    -  -- - ----  - -  --  --     --     - - ------- - ----- - ----   --- - -   -
- - ---    - --   -  -  --   --   -  -- -    -   ----  - - -- -- -     - --  -- - -   --- --   -- --
- --   - -    --- -   -  ---------        - -  - -       -   -- - ----  - - --   -  --   - -- -- - -
-   -- -    -  -- --  - -   -  - - -  --     - -- - -- --  --  -      - -  -    -  - - --  - ---   -
- - -   ---  --   - ------ -  - -  --   -   --- -   -   --  -  -   ---  -- ---  - -  - -    - -  - -
-  -  -    -  -          -- - --  - --   --  -- -- -    - --      --  -    ----- -      - ---    ---
- - --  - - -    - --- --    -  -- - - -- - - -    ----   -   - --    ---- -   --  --  - -   -- -  -
----  --- -  -- ---  -  - --     - -- -   ---- -     - ---  -  -   --  -    -- - -- - - - -   -  ---
-       -  -   -  --    --   -- ----- -  - -- -- -- -- -       - -       --- - -   - - ------      -
- - - ---            - -  -   --    - ---  -  -  -    -  --  - -  -    --  -     ----   -     -  - -
- ----   - --  - --     ---  - --  --     - - -- -  - - -   -- - ----- - ---- -   - ---- - -  --- --
--   - -----     ---- ---   --  ---   ---- - ---  -  -- - - - -    ----- - -   --  -     -  - -    -
- - -      -----    -- - -- -  -  --   ----- -  ----- -    - ------   ----- ---- -  --  -  -       -
-  -    -    -     -  - -    --  -   - -  - ---- -  -  -      -     -         - -----     - - - -  -
- -- -    ---  - - -  -  - --  - --- -- -   --  - -    -   ---- -----  ---- -- -    -- --- - -  - --
- - -- --  - -- -  - -  -  - -   - -- -   -- - - -- -- -  - --   - -  --  --  -- ---  -   -  -   - -
-   -  -        -  --  - --      - --- - -   --   --  -   -  - -  -     --    ---   ----   ---   - -
---- - --   -- --  - - -- - -- - --  - -  -   -   -  -  -- --  - -- ---   -   -   -     -     - -- -
- - --  -- - -    --- - -    - - - - -  -   -    - -- -  -  - ---  ---- --    - --     --       - --
- - -  -  -- ------  - --   -  -      --  --    --- ----- - --  -- -    -- -- -- ----   -     --   -
- -   -    - -      - - ---  -- - ----   - - - - -- -   - --   - -- --      - - --  - ---    - - ---
-         - -   ----  - -    -- - -   -- -   -   - -  - ---   - -   - - -          -  -  -  --  -  -
-   -   - - ---- --  --  ---  - -  ---- - --- -  - - -     - - -       -  - -   -- -    -   -  -   -
--  - --  --    -  -  -- -       -  -- --- -- - -- -  - ---   - -  -  -- - - - - -   -  - - - - - --
-   -      -- --- -  - - - - --  - - - -    - - -- -  -  - -- -   --  - - -  --- --- --  - -  - -- -
-     --- -    --   - --  -  -   --  - ---- - -  --- - - - - --- -- -  -  --         - - - ---   ---
- -- -  - ---   -   -    -   - - -    -     - ---     - - -- --       -  --    -- - -     - - -- - -
-  - --  --   - --   - - --   -   ----- ---- - - ---- -  -  -  -- ------ - ---     - - --   -  - - -
--- -   - - -   -- - -    --  -    -      -- - ---   -    -  -- - - - --   -  - ----- -- ---   --  -
-- --  -- -  - - - - -  --  -  --  --  ---- -- - - -  -- ------ --   -   -  - - - - -       - -- - -
-  - --  -  -------  --  - -  -- - - --   --   -  ---   -    - -  - - -- --   - -- -  - -  --- - - -
- --   --  - -- -  --  -  -     - -  --   - --- -- - ----- --- -  --    -    --    --   --  -     --
--  ---- -- -- -  - -    ---  --    -  -    -  - - - - -   -  -       --  --  -- - -      --  --  --
-    -  -  -  - -      - - ---  - -- -  - ---  - - --    -------- -- - --   --  -     - - -    - - -
--   ----   -      --  -       - -       -  - --- -       -  - -- -  -   --  ---- ---- ---  --  -- -
-- --   - -   ---  - - --  --  --   -------  -   -   -     -- -- - -- - -  - - - ----    - - - -  --
- -- - -  --    -    ---    - -   -- - -   - ----  --  --  -  -- - -  -  --- --        ----  -   - -
-  - -  - -- ---  -  - --     - - - - - -  --   - -- -- -  - -- -- --      -    -  --   - --   -- --
---  - - -            -     - -     -  -- - - ---     --  -    - -     --  -- -- -  -- - - -    - --
--   -   ----   -  --- - ----   - --- - - - -   -    --- -----  --  - -   -- -  -          --   -- -
- -  -  --    - -     --    - -- - - -   - -  ---   - -    - -  - -  - ---  -   -  -  -      ---- --
---   ---  --     -  -   - -- -  -   - - -  ---   -  - -----     --   --- -- -  -  --    - -    - --
-  - - -      -  -  -----  - - -   - -    -- - - - - - -  - -  -- --      -- -- -    -- -  - --    -
-  -- --   -- ---  -    -  - -   - - -   -    ----- ---  - ---- - -    -    -  -- --   -    --     -
-       ---- -  - - --   --- - - - - - ---  -- -  - -  -- - --- -   -  -  -- -- --- ---   ---  --  -
--  -----    -- - - --     - --  --   -       - - -  - -- - - ------- - ---       - -    -    --  --
- --     -- - -  ---   -- -- - -    - ------ - -  -- --- --    - -   -- --  --- -  --   - -- -  - --
-- - --- - --  -    -- - - -  -  -- -    -  -  - - -  - -  -    -   - ---   - - -   - - -- --  - - -
- -   -   - - -- ---  --   -- - -          -- --   --- -- -    -- -   -   -  - -- - -    - - --  - -
-  --- - ---- -  -     - - -- ---  - -- - -   - -- --           ---   -   --- -  -- - --- -   -  ---
--  - - - - - -- --  -----   ---   --      - -    -  --- -  -  -  - - --  -  --- - -  - -   -- -- --
- -   - - --    --             -- -- - -  -  - -  ---  - - -- --      -       -  --   -  - -    - --
--    - - --     - - ------ -- -- ---   --- -- - -    - ---- --- --  - - -   -     -  - - -- -- -- -
- - -  -    -      -  -    -     --  ---  --  -  ---- - -       ---  - - -     -- - -  - -  -  -----
-  - -    -  - --- -   - -- - --- --  - -  --     - ---   - ---    - - -  -  --- -- -- ------   -- -
--  -- --- - - -    --  -   ---  - -    -   ---  - - -   -    -  -- -  -----   -    -     -  -     -
- - - --  --    - -    -- ----  -    -- --   --    -  -- - - -  -       - --- - ---- -      -  --  -
-- ---     --  --  -- - -   - ---  -  --  --    - ----    -   -   --- -   - - - - -  --  ----  - - -
- -     - -     - -   - -- --  - ----  - - --   -- -    -- -- - -          ----- - --   -- -  -  ---
--   - - - - -   - ---- - ---- - -   --  --  - --- - --- --       - -  - ----  --    -        - -  -
-- - --    -    - -  -- - -     -------  - - --  ---  -  -   - - -    ---     -    -- -----      - -
-    -  - - - -  - -   - - ---- -   -  -- --    - -      - - --   ---- - --   -   - - -      - -   -
----- - - - - -  -   -  --  -  - --   ---  -- -- -    ---    ---     -     -   --   -- - --- - - ---
-   - -     -- - -- -  - --  --- ---     -  - - - -    - ----    ---- -- --  -  --  - -       ---  -
- - - -- -     -       - - -    - -- ---  --- --    - -  -   -- -  --  -  -     -   -   --- - - - --
-  -   -   --  --    - - - -- -    --- --    - --  ---  -  -      -  - --    -   - - -  -- - - - - -
- -  -    --  - - --- -- -  --  -- -   -   ----   --  - -     -- ---  -  ---- - --    -- -         -
-  -  - -  ---  --  --   - - -- -- -- - -    ---   - --- --     -   - - -   -      - ---      -- - -
-   -         - - -- --  -  --  -- - - - - -- - - -   - -  - - -  ---  - --  - -  -- -  -   ---- - -
-  ---   -  --  - - - --- --   -- -      -- - -   ---   -- -        --  -   - -       - ----     - -
-- -- --   - -  -    - - - --     - ---    - -  -- - - -- -- - --      - -- -- - -- -    -  --  - --
-      ---  -    -  -    -    - -  -  ---    -- -- - - - - -- -   -  - -        -  --- --     -    -
- - -- - - --  -  -      -  - - -- --    --  -- -     - -- ---      --- ---- - -   --    --------- -
- ---- -   -    -  -   - -- -   -- -  ----   - -  -- - -- -  -  -- -  -  --    ----   - -   - - -- -
-     --- -- --- -  --    -----   - --    -- ---   - - ----- - --   - --   ----      ---- -  --    -
- ----   -  -   -    - ---     -  -  -  - - - -  --- --       - --- -- ----  - ---  --   --  -  ----
-  -- --  -   -   - -  --   --  -  --  - ---- -   - -    --- --  -   - -   -   - - -  --    ---   --
- - - -  -- ---     - --   -- -     - ---     - - - - - -- - -  - - -- --    -- ---- - ---- -- -- --
-   -- - -   - - - - -  - - - -   --  - -- ---  - --- -  -  -- ---  -         -- --  --  - - - -  --
- -- - --- - -       -- -    - -        ---  -  -- -    -  --      - - - -     -  --   ---   - - - -
--  - -  - -  - --   -  --   - -     - - -  - --  -  --  - - --- --- -  - - --    - ---   -- -- - --
--    -- - -- - --  - -- -- -  --  -- -- - ---- -- --   - -   -    - ---- -   - - -    ---     -   -
-- -     - - -- -  --  --  -- -    - -  - -   -  ---  -- --  - ----           -      -- - --- - -- -
-   --  -    -  -   - -   -  - -  - -- - ----- --  -       - --  - -- -   -  - - -   - --   -  - - -
----------------------------------------------------------------------------------------------------
