100
100
----------------------------------------------------------------------------------------------------
- - --       - -    -   -   --  -        -  -     --- -   - -   -      -   - -    - -  -    -  --  -
-     --- ---   ----  - --    -  ----  --  -    --   - --  - ---- -- -  ---   -   -  -    -  --  - -
--  --   --   --     -- - -   - -   -  -       -   -   -- --   -- - -  -        -- - - - - -    - --
- --  ---     - - - -- - -  - - ----     -   - ---  ---- - -- -  -  - - -   -- -  - --  -   - -  - -
- --- -  - - ---  -- - - --    - - - -- - --- --  ----  -- - -- -   -  ---  -   -- -   --     -  - -
--   - -- - --  --- -     - -  -- - -  - -   -- --    -- --- --  - - -- -    - -  - - -  -- -   -  -
-   ---    --      --- -- -- -    -     -- --       --- -  - - --    - - - --    -  - --   --    - -
- -  - -- -   - - -  --- --- -------  --- --- --      ------ - -  -  -   ----  - ---- --    --  -  -
- - -- -   - - --  - - -     - - -  - -       -- - --- -  - -   -- -  -        - --  -- - -- - --- -
--  -  -  -   -   - -  - --    - --      -  -- - --  - --- --    --   - - ---   -- ---- --  - - - --
- - - - --  - - - - - --    --      -    - -    --  -       -        --  - -  -   --  - - --  ---  -
-  - - - -  --   -      - -- - - ------ - -- -   --  --  - -      -- -   -- - --- - -- ---        --
-   -  ---- - - -- --- - - -- - -- --     - -- -   -           -- -  -  - - -- --- - - - - - ---   -
-- - ---   - -  -  - - ---  - --  -   ---  -   -   - - --- -- -  -  -  -   -- - -     - -         --
- -    ----- --- - - -      - ------  - -   - -     - -  --- -- -  -  -   -   -- -  ---- -- - -    -
--      -  -     -  -      ---  -        -       - --  -- --- --  -  -- -- -- - - -- - --- - -  -  -
-  -    - - --- --  - - --       ---     --- --- -    -- --  -- -  -  --  -  -   - ---   --  - -   -
- - ---- - - --- -    -     - -  -   --     --    -    -   -- -   - - ----- -    - - -  - - - - - --
- -- - --  --  --- --- -  -   - - -   - - - - -    - -    -  - -- ---- -   -- --    -  -    --     -
- - -     - --   --   - -- -- -  ----  -   - - -     -    --  -   -- --  --    -         - -- -- ---
-   -  -  ---    - --- -- - ---  - - -   -- --  - -   -- -- -- -- -     -  ---  --- -- - -- -- -  --
--  --- -- --  -   -  -   - - --   - - -  - ---   - - - - ---   - -   -----  - - --   -  ---- - -- -
- ---  -        --  - --        - --       -- -- --   - --   ----   --      -  - -  -- -     --   --
- -   -- -- -  - - ---   --   -- -- - ---- -    --  -     --- - -- -  - -    -   - - -   -- - -   --
- ---        - --  - -- -  - -  - - --    -- -   ----   - -  -    - -   - ---   ----  -   - --- -  -
-- -    --- -  --  -  ---   - --  - -  -   - -  -      - - - -   - - -      ----     -  - - -  -   -
-   -   --       - -- -  -   -       -- - -  -- ----  - -       - -   -  -      -- --     -  -   - -
---  - -- -- --      -    ----- -- -  -- ---  - - -- --  --- - -  - -  - --- - -    ---     ---    -
-  -  -- - -    -  --  - - - - - - --   --- --- -- - - --  - -  -- -     - - --    -- - -- -- -  ---
- ---  --   ---  --  ----- -          - - --  -   - --   - --  -----   -       -   --  ---   --    -
- -  --- --     -  -  --- - --- ---   -- -- - ---- -   -- -         -  - --- -  --   --     -  -   -
--    - -   - - --   -  ----   - - -   --    -      --- - -- - --- - ---    --- -  --   --- -  -- --
-   - - -  - --   -   --     -   - - - - - --   - -    -         - - --  ---    - -----   -      ---
- -   - - - - - --  -  -- - -    --  --  -  ---        ---- ---    ---  --  --  -      - -  - - -  -
-  - --   - - - - --- - ----   --   --  --  -  -- -       --   -- - -- -  --   -  ---- - --   -  - -
-   ---  -   --  - --  -   -  -- -- -  - - -     -  --- --  - - -  -    ---  -- ----  -- - - -  -  -
- -    -  - - -- - - -- -- -    --  -- - - - - --  -      - -   - --  - -  - --   - --     - --- ---
-    - - -- -  -- - -  - - -  --   ---    -  -   ---     - - --- -   - - --  -  - --       -- - - --
- -   -    -    --  - --     -   -  - - -   - - --    -- --   --- --   -   - --- -- ----- -    - - -
-   -- ---- - -- - -- - --- -    -     -   -  -- --- --  - -    - -- --  - ----         - -- - - - -
- - -- -  -  -  -   - - - - - - -- ----  -  - - -    - --  --  - - -- - -       - - - --     -  -  -
-  -- - - - - - ----  - -- -- -   -  -   --- -  ---- -    -  - - --- -- - -- ----- -   -  -   -  ---
- -- --  -      --  -- -  -   --   --    -    -  -     ---  -- -    --- - - -  - -  -  --  - ---- --
- -- ----  -    --- -    - ---- --  - --- --- --   ---  - --- - ---    -  -  --  -  -- --- - -- -- -
-- - -- --    --  -- --  --     -   ---  - - - -- - -     - --  -   -- - - -  - -- -  -   - -   - --
----   -  -     -- -- - -  -----  ---- -  - -        -- -  - - - -  - - -  --- - -  --- -    - - - -
--   -- -   --- -- -  --         -- - - - - - --      -     -      -   -- - -- -   -    ---    - - -
- ----   - -- - -- ----- - -- -  -    -- --- - -- -- -  -     - -  - -- - --- -   -   --  - ---   --
-  -- -- -- - -- -- -  - - - -- -  -  --      --  -    - ---- -   --- - --  -   -    - - -  - - -- -
- -- --- -   - --   --- -  --     - - ---   -    - -    - ---  - -    - ------  -  -  -- ----    - -
-  --  --    - -       -     -  - -       --- -  - - -  -  -----  --    -    -- -- -  -- -- --  -  -
--      -    -- - -   --  - - - - - --   - --     --- ----   -  -  - --  --- -- ---  - ----   -  ---
- --- - --  - -- -     -  -  -  - --        - -- -      - --- -  --     --  - -- - - -      -  - - -
-- - -  -- --  - - ---- --        - --      -        ---  -     --    -   - -     ---  -  - --   - -
- -  -- -     - - - ---   -- ---  -  - ---     ----- -- -  --  - - -    -- -  - -- - --- --- - - - -
--- -   -- ---  -- -   --  - - - - --    --   -  -- -   --       -   --- -- --  -- - - --     - -- -
-  --  --  -  -   -  -- --   -  - -- -- - --  - - - - - - --   --      - - -  - --- --   ---- -  - -
- -- -   - -   ----   --  -   - -  - - -- -  -- - -  --     --      -  -  - -- -  -    -  -- - --- -
- -  - - -  - --  -- -  --    -  -- - - - -- -- --  - --   --  -----   --     -- -  -- - - - --   --
- -      - -        -- -- -     -   - ----- -  -     - -    - -   - -   - - --   --  -    -    -----
-    ----- - -- -    -- - ----- --      -  - -  -   --   --     - -  --  -  -- -- --- -- - ----    -
- - -    --- -- - - --  - - -    -- -- ---- -  - --- - -   -- --  ----  - -  -   -     - -  -     --
- - ----- -   -- - -  - - - -  -  ---- - - -- - -   --  -- - --       -   - - - -- -   -- --  -   --
-      ---- -     - -   -  --  -  - - - -- - - -  -- -    -  - -  ---- - -  ---    ----- -- -  - - -
--- - --  - -   - - -   ---  - -- -   -- -    - -- ---  - -    ----  - -   --   --     -   - ---   -
-   --  --  - -- -   -- - --  --   - --  -  - - - -  - - -- - --  - --   --   -  -- - -   - -- -   -
--- - -     ---  --  -   --   ---- -----  --  - - -    -----    - -- -  - ---  -   - -  -    - --  -
-- -      - -      - - - -  -   - -  -   -  --  --  -         -  -      -- -     -  - -     -- -  --
- - - - - -  ----- -   -- -  - - ---- - -- -  - -  - - --- --  -     - -- - - -- --  --- -   - --- -
---- -   -- -  -    --- -   ---- - -- -     -   - - -  - -  -  - - -  --  -  - --   -  -   -   - - -
-   -----  - -    - - - --  -  -   - -  - - - -- -  -  -  - -  - -- - --  -- - -      - - -  - -   -
-  -    - - -- -     ----     - - - -- - -- --   -  -  - -    --  - -  - -- --  - -   -   - -- - - -
- - - -   --        -  -    -  -  -  - --- --- ----   -- --    -- - --  --- -  -- - - -   -- - --- -
-  - -- - ----   -- ---  --  ---  --   -  -      -  -  -  --        - - -    - - -  -  -    -  -   -
----- - -- -  - -- -  --   - -- --  - - ---  ----     - -   - -  -- -- -----  - - - - --    --   ---
---  ---   --   -  - --- -  - -   -- ---  ----- - -     - ----  -- -- -  -   -- - - -- - -- -   - --
-  -- - --- - --   -  -- -    -----             - --  --- -    - -- -   - -- - -    -    - -   --- -
---- --  ---  -- -- -    - -  -          --- ---  -  - -- - ---      --  - --  - - -  --- - -      -
- - - - --- - - --    --- - - --- - -- -- -  - - --     --- -    - ---- -   --          --   - --- -
-  - ---  - - - --   --   - -             ---  -- - - -  - - ---  -  -  - -  - --- -    -- -  --- --
- -     ----- -   - - - -    -   --   -- - -  -- --- --   --- - - ----   --  -  -   -  -    -  --  -
-  --- -   - - - --  -   - -- -- -  - -   - --- ---         - --  -  --- -   - -  -  -  - -       --
---  - -- -  -    -    -- --  -   --- - --    -    -    -- --  --   -  - -   - -   - -- -- --- --  -
- -  - -   ------   -  - - --  -- -- - -  ---- - - - -   - -     --    - - - -- --  -   -  -   - ---
- -   -  -- -  -  --  - --      - -  - --  -- -- -- -   --- -     - --  -  - -  -    -  - - --   - -
- - -- - --      - -- --  -  - -  -  -- ---   -   - ---- -  -    --  --   - - ---  ----         - --
- - -- --- - -- -- ----    -  - -   - -   - - - -  -    - -- -      - --  - --  --      ---  ---  --
- -   - - -  - ---  -- - -    - ---   ---    - -- ------- --- --- - ---  - -  - - - ---     -- -- --
-- - -    -  -- -  -  -   - -   ---   -   -  -   -  - -  -- --   -  -  - - --- - -    -- - - -   - -
- -    - -  - - ---   --      ---  --   -----  -- -  -- - --  ----   -- -- --  - - ----   -- -- -- -
-  -  -- -  -    ---   --- - --  --   -  -----   -- -    -- --      --  ---   -- --   - --     -- --
-  -   -   -  - --    -  -   - --   -  -     - --   - --- --  --  -  --     --- -  -    - --    -- -
----  --   - -  -   -  -- - --       ---  --   - - - -   --  -   -  -  - --     - - -----     - -  -
-- -- -  --   - --   -    -- - -- ---     -- --   -----  - -  -- -  --- -  - -- - -    -  --   - ---
-- - -- -   -  --  - -- -- ---        -   -   - - -  -  --   - --- -- -----  - --- - - - -  -- --  -
- -   - -    -    -- -- - -    - --  -    -    - - -- --  - -      - -  -- --    -  -- - --  --   --
-   -  --  - --      -  -   - - -    -- - ---    --- -- --- --   -- -- - --  - --   --    --- --   -
-  --    -   - -   -      -      ---     --  -- - - -   -  -   - -  -   - -----   -   - --  -  --  -
----------------------------------------------------------------------------------------------------
