100
100
----------------------------------------------------------------------------------------------------
-   ----       -           -                 -        -      -   -    -      ----         - -  -   -
- -        -    -  -  -     -             - -   -  -  -   --          -   -  ----       -   -      -
-    -    ---- -   -       - --    -  -   -- -    -     --    -    ----        -      -            -
- --       -     -        -     - -         -      -    -              -  -  -      -             --
-    - -  -    -   -                 - -        -  --   -  -       -   -      -         -  -    ----
--   - -         --      - -  -  -- -            -  -   --    -   -       - -       -           -  -
-     - - -       -  -  -         - - -   --        -              -    -               -   - -    -
- -      -  --    -     -       -     -      -   -    -- -           - - - -      -   -            -
-      -    -    - --       -- -   - -      -            --     - -      -  -- -   -          -    -
- --      -    -  -                      ---    -   - -    -           -  -   -     ------        --
-   -            - -  --          --  --     -  -  -       -    -   -       -   -                 --
-  -              -      -- --  -         --                 --            -    -  -  -   -     -  -
- -    -  -    - - -             -       -   -   -     -        -  - -       -   -        --  -    -
-       -              -     -       -  --      -       -   -          -  -   - --         -       -
- -    -- -    -         --   -     -     -        ----  - -      - -    - -       -   - -  ---    -
-   - -   --    -   -            -      --    -        -  -   --  -    -      ----   -       - --  -
-        -          -             -        -  -  -  --- -   -           -   -             -        -
-- -        -- -  -  -     - -   -     --     -   -      -      -  -   -             -    --  -    -
-  --  -   -    -  --            -       -     -   -   -    -       ---       -     -   -- --      -
-     ---   - --  -   --         -   --     -   -          -    --     - -    - -  -        -     --
-   - -   -    - -  -                - -    -   -  -          --      - -         -      -      -  -
-         -    -    --   -   - -          --              -           -     -  -       -      --- --
-     -     -          --             -          -      -    -   - -  -  - -      --     -  -      -
- -   -       -   -  -   -   --      -- --    -      -  -     -  -     -    - -  -     --    -     -
- -  - -  --     -         -      -   -    -   - -- - -             -  - - -           - -    --   -
-  -  --       - -  - --   -    -   -   -    -  - ---   ---             - --  -  -- -         -    -
-    -        - - -   -          -   - - -  -              -                   --         -   -    -
-    --   --      -  -          - - -      - -        - - - --        -        -       --      -   -
--   -   --  -    -   --     -   -     - - -    - - -   --            -      -         --   -    - -
- -   - -         - --    -          -      --         -       -  --  -        -      -    -       -
- -      -- - -  --    ----    - -    - --  -  - -     -     -        -  -      - - -  --   -      -
-              -    -- -   -  -            -- -  -    --           - -    -  - -    --   -     -   -
-    -                    -     - -         -           --     -    - - -                          -
-     -  - - -    --  -  -     -  -       -         -                -   -  -       - -           --
-    -    -- -      - -      -     -    - -        -      ---       -    - -         -   -   -- -  -
-                  -   - -   - -  -  --  -      -    -      ---       --    -  ----    -     --    -
- - - -        ---  -  -- -  -           -        -- -          -       ---          ---   -   -  --
- - -   -    -           - -- --    -    - -  - -     -     -  -        -      --     - -  --    - -
-  --    -   -    -    -    -   - -   -     -  - -  -  -   -   -           -  -  -       -    -    -
- - -    -  -         --    -       - --        - -          --   -     -    -       -     -  - -  -
-      -      ---    -  -     -     - - -   -             --   -   - -       -        -       -    -
-   -             - -   - -          - -  -                  -  --        -- --  -      - -- -     -
--    -                -  -             ---- -        -          -   -         -    ---   - - - - --
-           -   -- -  -     - -      -   -   -      -    - --          -  -  -   -     - --    --  -
-        - -              -   - --    -     -         -  --   --    -     -   -    -   -           -
- --   --   -   -  -  -    -      -        - -- -   -           -  -   - - -   -   -    -     -   --
-   -       -          -      --  - -  --  -   --     -- -   --       -     -                 - - --
-  -        - -    -             -       -     - -- -      -    -                  -              --
-       -     -  -            -  -  - -  -     -        -      -      - -    ----  --     ---      -
- -  -  ---   --  -   - -   -     -- -    --        -  -         --        --       -     -    -   -
-   - -      --- --    - -   - --   -     -      -- -   -  -   -  - -       -    - -   -   -  - -- -
-              -   -   -          ---   - -    - - -        ---  -   --  -      - -  -- --     - - -
-     --       - - -           -- -         -    --     -      -       --           -              -
-  - - ---         --  -         -  - -   - - -  -  -     - -     -    --      -  -  -   -     -   -
-    -   -              -  -               -    -  --   -     --   - - -    -         - -      -   -
-          - -   -  --    -   -          -   - -         -  -- -         - -  -   -- -- -          -
- -  -    -  - -    -     --     - -   -   -          --  --    -- -  -   ---     --    -     - -  -
--   -  --        -   -  -            - -- -   -      -         -         -  -    --  -        --- -
-     - -  -       - -           -  - --  - -      - - --     -  - - --- - -            -  --      -
- - - -       -  -   -   - --    -  -       - --    - -     -  -    -                --    -       -
-      - -       -   -  - -        -   ---     -   -      -       -                 -           -  -
-          - -  -   -   -    -               --         - -   -  -  - -        -    -     - -    - -
-   -     - -          -   - -          -  -   -         --     - -          -   - -         -     -
-     -         - -      -        -        --       -       -       -            -    -    -    -  -
-   -   -       -      -  -   -        - --        -  -          -     ---  -       -    - - -     -
-           - - -                - --        -  -                    -     -       -    -    - --  -
--      -  --   -     -      -    -        --    -    - -         -                   -       -    -
-   -   - -  --        -     -      -         -        -     - -    -- -  -        - -  --   - -   -
- - -   -  -  -   -  -      -   -    --    -        --- -        - -        -- -    - -         -- -
-     -    -     -              -  -        - ---   - --   -    -   - -   -   - -       - -      ---
-  -  --     --    -  -   -   - --       -          -      -       --  -         -                 -
-       -  - -     ---  -   -    - - --       ----  - --   - -        -    -  -         -   - -    -
-         -  -         -- -  - --    -  -         --        -    -  -   -     - -               -  -
-   -       -       -     - - -                              - -      - - -        - -   -    -  - -
--- -    -   -     -       -  -     -    -  --      --- --        - -     -    -               -   -
-  --               -     -      -       -      --   -     - -     -    - -  -  -- -   -    -   -  -
- --      -     -    -   - -   -   -               -  ---    -     -       -      -      -    -   --
--    --        -             -    -   -  -   - -    - ---    -     -     -        ---   - --    - -
-  -    - --  -     -  -  -                -  -        -    -    -     - -    -    --   -  -- -   --
-                 - -- -        -   -        - -  -                              - -          - - --
-   -  -  -     --              -              -  -         -               -             --  -    -
-- -   -    -  -        -   -      -      --   - -    -  --    - -       - --  -  -            -   -
-     -  -        -           --  - -     -                  ---- -       -- --  -         -- -  - -
-  -             -       -   -     --- - - -           -                    -  -      -   --       -
-   - -       - -   --                -            --        -          -         --     --    -  --
- -        --  -  --  -    - -    -   -   - -      - -    - -           --  -           -   -      -
- -      -         --  -  -        -           -          -      --  -       --      -  - --- -   --
--    --   - -  -    -   -          --      -    - -    -   -  -    -    - -          -  - -       -
-              -  -     -       -                  -   -   -   -   --         --             -   - -
-  - - -               -    -     --           - -  -  -     --          -                -        -
-     - -           -  - -   -      -             -   -      -   - - -    -       -  - --      -   -
--       -  ---     -  - -        -               -                                   -    -       -
-      --  ---    -           -     -   -                 - -      --    --  - -     -  - ---   -  -
--    --       -  -     --    - -   -    -    -      -    -     -      -         --       -   --   -
-           -     -  -- -      -                - - -     - -            -       -  -   - ----  -  -
- -   -  -     --- --         -    -                  -           - -    -  -    -    -           --
-   -     -       -    - - -           ----    -   --  -  -     - -     --     -     -       -   - -
-           -       -        -          -    -        -       -               - -                  -
----------------------------------------------------------------------------------------------------
