100
100
++++++++++++++++++++++++++++++++++++++++++++++++++++++++++++++++++++++++++++++++++++++++++++++++++++
+                                                             -                        -    -   -  +
+                                                             D                        -    -   -  +
+                                                             -                        -    -   D  +
+---------D------------------------------D---D----------------D                        D    -   -  +
+                                     -                       -                        -    -   -  +
+                                     D                       -                        -    -   -  +
+                                     D                       -------D-----D-----D------    -   -  +
+                                     -                       D               -        -    -   -  +
+------DD------------D-----------------                       -               D        D    -   -  +
+             -                       -                       D               -----DD---    -   -  +
+             D                       D------------D--D--------               -        D    -   -  +
+             --D---D------------------                       -               -        D    -   -  +
+---D-D--------                       -                       D-D----D---------        -    -   -  +
+             D                       D                       -               D        -    -   -  +
+             D                       -                       D               D        -    -   D  +
+             -                       -                       -               -        -    D   -  +
+-D-----D---------D--------D--------------D--------D------------D---D-----------DD--D---    -   -  +
+           -                 -               -                                -  -    -    -   -  +
+           D                 D               D                                D  -    -    -   -  +
+           -                 -               -------D-------------D------D-----  -    -    -   -  +
+-------D--------------D-D-----               D              -                 -  -    -    D   -  +
+           -                 -               D              D                 -  -    -    -   -  +
+           -                 -               -              -                 -  -    -    -   -  +
+           D                 D-D---------DD---              D                 -  -    --D----D--  +
+           -                 -        -      ----DD----------                 -  D    -    -   -  +
+           -                 D        D      -              -                 -  -    -    -   -  +
+           -                 -        -      -              -                 -  -    -    D   -  +
+-D----D-----D------D------D---        D      -              -                 -  -    D    -   -  +
+      -          -    -      -        -      D              D                 D  -    -    -   -  +
+      -          -    -      ---DD-----      -              -                 -  -    -    D   -  +
+      D          D    -      D        -      -              -                 -  -    -    -   D  +
+      D          -    -      -        D      -              ------------D-D----  -    -    -   -  +
+      -          -    -      -        -      -              -                 D  -    -    -   -  +
+      --DD--------    -      -        -      D              D                 -  -    --D-D--D--DD+
+      -          -    -      D        -      -              -                 D  D    -      -    +
+      -          D    -      -        -      -              -                 -  -    -      -    +
+      -          -    D      -        -      -              -                 -  -    -      -    +
+      D          -    -      ----D--------D------D----D----------D----D-----D--  -    -      -    +
+      -          -    -      -                               -      -     -   -  -    -      -    +
+      -       T  -    -      D                               D      -     -   -  -    -      -    +
+--DD-----D--D-----    -      -                               -      -     -   -  -    -      -    +
+        -        -    -      -                               -      -     -   -  -    -      -    +
+        -        -    -      ---D---D-------------------------      D     -   -  -    -      -    +
+        -        -    -      -                               -      -     -   -  -    -      -    +
+        -        -    D      D                               D      -     -   -  -    -      -    +
+        -        -    -      -                               -      -     -   -  -    -      -    +
+        -        -    -      -                               -      -     -   -  -    D      -    +
+        -        -    -      ------D---------D-----------------D----D     -   -  -    -      -    +
+        -        -    -      -                           -          -     -   D  -    -      -    +
+        D        D    -      D                           -          -     -   -  -    -      -    +
+        -        -    -      -                           D          -     -   --D--D---      -    +
+        -        D    -      -                           -          -     -   -  -    -      -    +
+        -        -    -      -                           -          -     D   -  -    -      -    +
+        -        -    -      -                           -          -     -   -  -    -      -    +
+        -        -    -      -                           -          -     -   -  -    -      D    +
+        -        -    -      -                           -          -     -   -  D    -      -    +
+        -        -    -      -                           -          -     D   -  -    -      -    +
+        -        -    -      -                           -          -     -   -  -    -      -    +
+        -        -    -      -                           D          -     -   -  -    -      -    +
+        -        -    -      -                           -          -     -   -  -    -      -    +
+        -        -    -      -                           -          -     -   -  -    -      -    +
+        -        -    -      -                           -          -     -   -  -    -      -    +
+        -        -    -      ---------------DD------------          -     -   -  -    -      -    +
+        -        --D----D-D---                           -          -     -   -  -    -      -    +
+        -        -      -    -                           -          -     -   -  -    -      -    +
+        D        -      -    -                           -          -     -   -  -    -      -    +
+        -        -      -    -                           -          -     -   -  -    -      -    +
+        -        -      -    -                           -          -     -   -  -    -      -    +
+        ---D--D---      -    D                           -          -     -   -  -    -      -    +
+        -        -      -    -                           -          -     -   -  -    -      -    +
+        -        -      -    -                           -          -     -   -  -    D      -    +
+        -        -      -    -                           -          -     -   -  -    -      -    +
+        D        -      -    -                           -          -     -   -  -    -      -    +
+        -        -      -    -                           -          D     -   -  -    -      -    +
+        -        -      -    -                           -          -     -   -  -    -      -    +
+        -        -      -    -                           -          -     -   -  -    -      -    +
+        -        -      -    -                           D          -     -   D  -    -      -    +
+        -        D      -    -                           -          -     -   -  -    -      -    +
+        -        -      -    -                           -          -     -   -  -    -      -    +
+----DD---        -      D    -                           -          -     -   -  -    -      -    +
+        -        -      -    -                           --D-----D---     -   -  -    -      -    +
+        D        -      -    -                           -          -     -   -  -    -      -    +
+        -        -      -    -                           D          D--D--D-D--  D    -      -    +
+        -        D      D    -                           -          -         -  -    -      -    +
+        -        -      -    -                           -          D         D  -    -      -    +
+        -        -      -    -                           -          -         -  -    -      -    +
+--DD--------D--------D-D--D----------------D----------------D------------D-D---  -    -      -    +
+                -                                                 -           -  -    -      -    +
+                D                                                 D           D  -    -      -    +
+                -                                                 -           -  -    D      -    +
+-----D-D-----D---                                                 --DD---------  -    -      -    +
+           -    -------------------D---------------D---------------           -  -    -      -    +
+           D    D                                                 D           D  -    -      -    +
+           -    D                                                 D           -  -    -      -    +
+           -    -                                                 -           -  -    -      D    +
+-D--D-------    ---------------------------D-------------------------DD--------  -    -      -    +
+           D    -                                                             -  -    -      -    +
+           D    D                                                             D  -    -      -    +
++++++++++++++++++++++++++++++++++++++++++++++++++++++++++++++++++++++++++++++++++++++++++++++++++++
