100
100
++++++++++++++++++++++++++++++++++++++++++++++++++++++++++++++++++++++++++++++++++++++++++++++++++++
+                                                                                                  +
+                                                                                                  +
+                                                                                                  +
+                                                                                                  +
+                                 -----------------------                                          +
+              -------            -                     -                  -                       +
+              -                  -                                                                +
+              -                  -                   ---------------------  -              -      +
+              -            -     -     -                                    -              -      +
+              -    ------- - --  -     -    --------- --------------------- -              -      +
+              -            -  -  -     -              -                     -              -      +
+                           -  -  -     -             ---------------------- - --           -      +
+    ------------------     -  -        -              -                     -  -           -      +
+    -                -     -  - ------ - ----------   -          -  -    -                 -      +
+    -                -     -           -   -      -   -          -  -    - -----------     -      +
+    -           -- - - - - - -----     -          -   -          -       - -         -     -      +
+    -            -   -   - -     ----- - -------  -   -        - - ----- - -   -     -     -      +
+    -            -   -   - -  -  - -   -                       - -       - -   -  -- - -   -      +
+    -            -   -   - -           - -------------                     -   -  -  -     -      +
+    -            - - - - - -           -             - - ----------------- -   -  -  -     -      +
+    -            - - -   - -------------   ------ -  -                     -   -  -  -     -      +
+    -            -   -  --    -                   - --     ------------  - -         -     -      +
+    -            -   -   -    -  - -  -        -  -  -     -             - - ------- - -----      +
+    -            --- - ---    -  - -  -           -  -   - -     -       - -         -            +
+    -                -           - -  - --------- -  -  -- - --  -  ---- - - - - -   -            +
+    -    -----                   - -  -           -  - -   -  -  -       -   - - -                +
+               ---------------   - -  - --------- -  -     -  -  -       --  --- -                +
+    ---------- -             -   - -  -           -  -   - - --  - -------   - - -                +
+         -     -             -   - -  -        -  -  -     -                 - -                  +
+    -    -     -     -       -   - -  -   -          ----- ----------------  - --                 +
+         -     -             -        -  -------------     -          -      - -                  +
+         -     -             -  ----- -                    - -  -            - -                  +
+    ------     ------------- -        -   -           -- - ------------      - -                  +
+               -             -        -               -                 ---- - - --               +
+          -    -      -      - -      -  -          - -    -- -     -                             +
+          -    -      -      -        -  -          - -     -   -   -   ---------------           +
+          -    -         --- - -   -- -  -  ------- - -     - ----- - -                           +
+      --  - -- - -       -   -        -  -          - -     - -     - -      -  -                 +
+      -   -    -   ----- - - - --------  -          - -     - - -   - -      -  -                 +
+      -   -    -         -   -           -          - -     - - -   - -      -  -                 +
+      -   -    -      -  -   - -   -     -            -     - -     - -         -                 +
+      -   -           -  -         -     - ---------------  -   -   - - -- -- - -                 +
+      -   -              --- - -         -                  --------- -  -    - -                 +
+      --  -             -    -   - ----- - ----------                 -  -    - - ----------      +
+      -   -             -    -           -          -      -  - -     -  - -- - -                 +
+      -   -                - -  -        -          -      -    -        -    - -                 +
+      -   - ---------------- -  - -      -   ---- - - ---- -             - ---- -                 +
+      -                         - -      -        --       - ---------   -      -                 +
+      -- --------------    -    - -   -- - -- --- - ------ - -           -      -                 +
+      -                 -  -    - -  -   -                 - -       -   -      -                 +
+      -                 -  -    - -  -   --------   -      - -  ---- - --- ------                 +
+      -                 -                -        -        - -       -                            +
+      -                 - -  --------- - -------- - -------- -  - -  - ----                       +
+      -                              -            -          -            -                       +
+      -                 ------    -  -     - - -  - -     -  --------     -                       +
+      -                 -    -    -  -     -   -  - -     -               -                       +
+      -                 - -  -    -  -     -----  - -     -    --    -                            +
+      -                 -    -    -  -         -  - -    --     ---- ----------                   +
+      -              -- - -- - -- -  - -     - -  - -      -         -          ------------      +
+      -              -  -            -       -    - - -------------- -          -                 +
+      -                      -     -     --- - -- - -  -             -    - -   -                 +
+      ------------- --------------------          -   --  -    -     -    - -   -                 +
+                           -           - ----------    -             -    - -   -                 +
+       -                               -       -    -- - ----------- -    - -   -                 +
+       -----------------   -        -  -     - -       -             -    -                       +
+                           -        -  -     - -  ---- -  - -- - --- -    -  ------------         +
+                     -                    -            -  -    -     -    -  -         -          +
+                     -     -------------------------   -  -    -     -    -  -   -     -          +
+                     -     -                                         -    -  -   -     -          +
+                     -     -        -  -  -  ---------------------   -    -  -   - --- -  --      +
+   ------            -     -        -  -  -             -T       -   -  ---  -   -     -          +
+   -                 -     -        -  -  -   ------------------ - ---       -   -     -          +
+   -                 -     -        -  -  -        -             -           -   ----- -          +
+   -                 -     -        -  -  -  - -   -  -   -      -           -         -          +
+   -                 -     - ------ -  -  -  - - - - ---- - ---- -    -      -         -          +
+   ------            -     -           -  -    -   -             -           -        -- ----     +
+                     ----- - ------- - -  -    -                --     -----                -     +
+                           -         - - -------------  -------- - ---                -     -     +
+                           -         - -                         -   -                            +
+                           -           -  -------- -          -  -   -               ---------    +
+                    ------ - -----------  -      - -          -  - - -               -            +
+                           -              -    - - -  -          -   -               -      -     +
+                           -           -  -    - -               -   -               -            +
+                           -           -  -    - - ------------- - - -               -            +
+                           -           -  - --   -               -   -               -            +
+                           -           -  -    - - -             -   -               -            +
+                           -           -  -    - - -             -   -           --- -            +
+                           -           -       -   -             -   -           -   ---------    +
+                           -           -  -                      -   -           -                +
+                           -           -  -  ---------------------   -           -                +
+                           -                            -          ---           -                +
+                           ------------------------- -                           -                +
+                                                                -                -------          +
+                                               ------------------                                 +
+                                                                                                  +
+                                                                                                  +
+                                                                                                  +
+                                                                                                  +
++++++++++++++++++++++++++++++++++++++++++++++++++++++++++++++++++++++++++++++++++++++++++++++++++++
